review,ManualLabelling,date,year,clean_review,before_cleaning,after_cleaning,normalized_review,before_normalizing,after_normalizing,tokenize_review,standardlized_review,before_stopwords,after_stopwords,stopwords_removed_count,stemmed_review,before_stemming,after_stemming
"Tolong di bantu permasalahan nya min, Pas klik tampilkan semua postingan dalam profil saya, ada muncul 4 bar di atas POSTING, KOMENTAR, GAMBAR, REAKSI, ke tiga nya saya klik muncul posting, komentar, gambar itu muncul, kecuali pas saya klik reaksi kok ga muncul min, trs ada notif tertulis HASIL TIDAK DITEMUKAN (kami sedang mengalami gangguan. Sepertinya terjadi kesalahan) COBA LAGI. itu kndala yg saya alami min mohon dibantu, dari segi internet sya bagus kok lancar, buka aplikasi lain lancar.",negatif,2024-08-03,2024,tolong di bantu permasalahan nya min pas klik tampilkan semua postingan dalam profil saya ada muncul bar di atas posting komentar gambar reaksi ke tiga nya saya klik muncul posting komentar gambar itu muncul kecuali pas saya klik reaksi kok ga muncul min trs ada notif tertulis hasil tidak ditemukan kami sedang mengalami gangguan sepertinya terjadi kesalahan coba lagi itu kndala yg saya alami min mohon dibantu dari segi internet sya bagus kok lancar buka aplikasi lain lancar,79,78,tolong di bantu permasalahan nya minimal pas klik tampilkan semua postingan dalam profil saya ada muncul bar di atas posting komentar gambar reaksi ke tiga nya saya klik muncul posting komentar gambar itu muncul kecuali pas saya klik reaksi kok tidak muncul minimal terus ada notif tertulis hasil tidak ditemukan kami sedang mengalami gangguan sepertinya terjadi kesalahan coba lagi itu kendala yang saya alami minimal mohon dibantu dari segi internet saya bagus kok lancar buka aplikasi lain lancar,78,78,"['tolong', 'di', 'bantu', 'permasalahan', 'nya', 'minimal', 'pas', 'klik', 'tampilkan', 'semua', 'postingan', 'dalam', 'profil', 'saya', 'ada', 'muncul', 'bar', 'di', 'atas', 'posting', 'komentar', 'gambar', 'reaksi', 'ke', 'tiga', 'nya', 'saya', 'klik', 'muncul', 'posting', 'komentar', 'gambar', 'itu', 'muncul', 'kecuali', 'pas', 'saya', 'klik', 'reaksi', 'kok', 'tidak', 'muncul', 'minimal', 'terus', 'ada', 'notif', 'tertulis', 'hasil', 'tidak', 'ditemukan', 'kami', 'sedang', 'mengalami', 'gangguan', 'sepertinya', 'terjadi', 'kesalahan', 'coba', 'lagi', 'itu', 'kendala', 'yang', 'saya', 'alami', 'minimal', 'mohon', 'dibantu', 'dari', 'segi', 'internet', 'saya', 'bagus', 'kok', 'lancar', 'buka', 'aplikasi', 'lain', 'lancar']","['tolong', 'bantu', 'permasalahan', 'nya', 'minimal', 'pas', 'klik', 'tampilkan', 'postingan', 'profil', 'muncul', 'bar', 'posting', 'komentar', 'gambar', 'reaksi', 'nya', 'klik', 'muncul', 'posting', 'komentar', 'gambar', 'muncul', 'kecuali', 'pas', 'klik', 'reaksi', 'tidak', 'muncul', 'minimal', 'notif', 'tertulis', 'hasil', 'tidak', 'ditemukan', 'mengalami', 'gangguan', 'kesalahan', 'coba', 'kendala', 'alami', 'minimal', 'mohon', 'dibantu', 'segi', 'internet', 'bagus', 'lancar', 'buka', 'aplikasi', 'lancar']",78,51,27,tolong bantu masalah nya minimal pas klik tampil postingan profil muncul bar posting komentar gambar reaksi nya klik muncul posting komentar gambar muncul kecuali pas klik reaksi tidak muncul minimal notif tulis hasil tidak temu alami ganggu salah coba kendala alami minimal mohon bantu segi internet bagus lancar buka aplikasi lancar,51,51
"Gua udah punya akun 2 kali dan tiba2 ilang semua suruh login lagi, udah di coba kaga bisa2 semakin di update semakin kaga jelas dan tiba2 waktu bisa beberapa waktu lalu akun gua bahasa Mandarin semua-_ gua ngga tau lagi lah jadi takut data gua diambil nih",negatif,2024-08-19,2024,gua udah punya akun kali dan tiba ilang semua suruh login lagi udah di coba kaga bisa semakin di update semakin kaga jelas dan tiba waktu bisa beberapa waktu lalu akun gua bahasa mandarin semua gua ngga tau lagi lah jadi takut data gua diambil nih,47,46,saya sudah punya akun kali dan tiba hilang semua suruh login lagi sudah di coba tidak bisa semakin di diperbarui semakin tidak jelas dan tiba waktu bisa beberapa waktu lalu akun saya bahasa mandarin semua saya tidak tahu lagi lah jadi takut data saya diambil nih,46,46,"['saya', 'sudah', 'punya', 'akun', 'kali', 'dan', 'tiba', 'hilang', 'semua', 'suruh', 'login', 'lagi', 'sudah', 'di', 'coba', 'tidak', 'bisa', 'semakin', 'di', 'diperbarui', 'semakin', 'tidak', 'jelas', 'dan', 'tiba', 'waktu', 'bisa', 'beberapa', 'waktu', 'lalu', 'akun', 'saya', 'bahasa', 'mandarin', 'semua', 'saya', 'tidak', 'tahu', 'lagi', 'lah', 'jadi', 'takut', 'data', 'saya', 'diambil', 'nih']","['akun', 'kali', 'hilang', 'suruh', 'login', 'coba', 'tidak', 'diperbarui', 'tidak', 'akun', 'bahasa', 'mandarin', 'tidak', 'takut', 'data', 'diambil', 'nih']",46,17,29,akun kali hilang suruh login coba tidak baru tidak akun bahasa mandarin tidak takut data ambil nih,17,17
"Saya tidak login sekitar 1 bulan lebih, dan ketika saya mau login harus verifikasi terlebih dahulu. Setelah saya memasukkan password untuk verifikasi email, email dari linkedin tidak ada. Jadi bagaimana caranya saya masuk sementara email dari linkedin tidak dikirim?",negatif,2024-08-16,2024,saya tidak login sekitar bulan lebih dan ketika saya mau login harus verifikasi terlebih dahulu setelah saya memasukkan password untuk verifikasi email email dari linkedin tidak ada jadi bagaimana caranya saya masuk sementara email dari linkedin tidak dikirim,39,38,saya tidak login sekitar bulan lebih dan ketika saya mau login harus verifikasi terlebih dahulu setelah saya memasukkan password untuk verifikasi email email dari linkedin tidak ada jadi bagaimana caranya saya masuk sementara email dari linkedin tidak dikirim,38,38,"['saya', 'tidak', 'login', 'sekitar', 'bulan', 'lebih', 'dan', 'ketika', 'saya', 'mau', 'login', 'harus', 'verifikasi', 'terlebih', 'dahulu', 'setelah', 'saya', 'memasukkan', 'password', 'untuk', 'verifikasi', 'email', 'email', 'dari', 'linkedin', 'tidak', 'ada', 'jadi', 'bagaimana', 'caranya', 'saya', 'masuk', 'sementara', 'email', 'dari', 'linkedin', 'tidak', 'dikirim']","['tidak', 'login', 'login', 'verifikasi', 'memasukkan', 'password', 'verifikasi', 'email', 'email', 'linkedin', 'tidak', 'masuk', 'email', 'linkedin', 'tidak', 'dikirim']",38,16,22,tidak login login verifikasi masuk password verifikasi email email linkedin tidak masuk email linkedin tidak kirim,16,16
"Sesuai arahan banyak info loker disini, dan untungnya belum pernah ada trouble untuk interviewnya, cara masuk ke linknya juga lumayan mudah, kecuali saat menunggu info pemberitahuan sangat lama.",positif,2024-08-26,2024,sesuai arahan banyak info loker disini dan untungnya belum pernah ada trouble untuk interviewnya cara masuk ke linknya juga lumayan mudah kecuali saat menunggu info pemberitahuan sangat lama,28,28,sesuai arahan banyak informasi loker disini dan untungnya belum pernah ada trouble untuk interviewnya cara masuk ke linknya juga lumayan mudah kecuali saat menunggu informasi pemberitahuan sangat lama,28,28,"['sesuai', 'arahan', 'banyak', 'informasi', 'loker', 'disini', 'dan', 'untungnya', 'belum', 'pernah', 'ada', 'trouble', 'untuk', 'interviewnya', 'cara', 'masuk', 'ke', 'linknya', 'juga', 'lumayan', 'mudah', 'kecuali', 'saat', 'menunggu', 'informasi', 'pemberitahuan', 'sangat', 'lama']","['sesuai', 'arahan', 'informasi', 'loker', 'untungnya', 'trouble', 'interviewnya', 'masuk', 'linknya', 'lumayan', 'mudah', 'kecuali', 'menunggu', 'informasi', 'pemberitahuan']",28,15,13,sesuai arah informasi loker untung trouble interviewnya masuk linknya lumayan mudah kecuali tunggu informasi pemberitahuan,15,15
"Suruh verifikasi dengan gambar yang tak jelas,, kenapa tidak menggunakan kode verifikasi aja langsung.. aneh... Ini mah bukan hanya orang lain yang sulit masuk, pemilik akunnya aja kesulitan... Sama aja dengan nyuruh buang akun..",negatif,2024-08-04,2024,suruh verifikasi dengan gambar yang tak jelas kenapa tidak menggunakan kode verifikasi aja langsung aneh ini mah bukan hanya orang lain yang sulit masuk pemilik akunnya aja kesulitan sama aja dengan nyuruh buang akun,34,34,suruh verifikasi dengan gambar yang tidak jelas kenapa tidak menggunakan kode verifikasi saja langsung aneh ini mah bukan hanya orang lain yang sulit masuk pemilik akunnya saja kesulitan sama saja dengan nyuruh buang akun,34,34,"['suruh', 'verifikasi', 'dengan', 'gambar', 'yang', 'tidak', 'jelas', 'kenapa', 'tidak', 'menggunakan', 'kode', 'verifikasi', 'saja', 'langsung', 'aneh', 'ini', 'mah', 'bukan', 'hanya', 'orang', 'lain', 'yang', 'sulit', 'masuk', 'pemilik', 'akunnya', 'saja', 'kesulitan', 'sama', 'saja', 'dengan', 'nyuruh', 'buang', 'akun']","['suruh', 'verifikasi', 'gambar', 'tidak', 'tidak', 'kode', 'verifikasi', 'langsung', 'aneh', 'mah', 'orang', 'sulit', 'masuk', 'pemilik', 'akunnya', 'kesulitan', 'nyuruh', 'buang', 'akun']",34,19,15,suruh verifikasi gambar tidak tidak kode verifikasi langsung aneh mah orang sulit masuk milik akun sulit nyuruh buang akun,19,19
"Menyusahkan. Perkara lupa nulis password, akun baru bikin kena suspend. Opsi login pakai akun google juga tidak bisa. Ketika mau ganti password prosesnya ribet pakai KTP, walau sudah dijalani masih saja tidak bisa reset password. RIP akun universitas, bagus ! Tugas saya tersendat.",negatif,2024-07-31,2024,menyusahkan perkara lupa nulis password akun baru bikin kena suspend opsi login pakai akun google juga tidak bisa ketika mau ganti password prosesnya ribet pakai ktp walau sudah dijalani masih saja tidak bisa reset password rip akun universitas bagus tugas saya tersendat,43,42,menyusahkan perkara lupa nulis password akun baru bikin kena suspend opsi login pakai akun google juga tidak bisa ketika mau ganti password prosesnya rumit pakai ktp walau sudah dijalani masih saja tidak bisa reset password rip akun universitas bagus tugas saya tersendat,42,42,"['menyusahkan', 'perkara', 'lupa', 'nulis', 'password', 'akun', 'baru', 'bikin', 'kena', 'suspend', 'opsi', 'login', 'pakai', 'akun', 'google', 'juga', 'tidak', 'bisa', 'ketika', 'mau', 'ganti', 'password', 'prosesnya', 'rumit', 'pakai', 'ktp', 'walau', 'sudah', 'dijalani', 'masih', 'saja', 'tidak', 'bisa', 'reset', 'password', 'rip', 'akun', 'universitas', 'bagus', 'tugas', 'saya', 'tersendat']","['menyusahkan', 'perkara', 'lupa', 'nulis', 'password', 'akun', 'bikin', 'kena', 'suspend', 'opsi', 'login', 'pakai', 'akun', 'google', 'tidak', 'ganti', 'password', 'prosesnya', 'rumit', 'pakai', 'ktp', 'dijalani', 'tidak', 'reset', 'password', 'rip', 'akun', 'universitas', 'bagus', 'tugas', 'tersendat']",42,31,11,susah perkara lupa nulis password akun bikin kena suspend opsi login pakai akun google tidak ganti password proses rumit pakai ktp jalan tidak reset password rip akun universitas bagus tugas sendat,31,31
"Aplikasi ga jeelassss,.makin lama makin ngebug,.masa mau login suruh verifikasi bagian keamanan,.sudah jelass gambar pilihanya benar,..tetep salah tidak bisa masuk",negatif,2024-06-25,2024,aplikasi ga jeelassss makin lama makin ngebug masa mau login suruh verifikasi bagian keamanan sudah jelass gambar pilihanya benar tetep salah tidak bisa masuk,20,24,aplikasi tidak jeelassss makin lama makin nge bug masa mau login suruh verifikasi bagian keamanan sudah jelass gambar pilihanya benar tetap salah tidak bisa masuk,24,25,"['aplikasi', 'tidak', 'jeelassss', 'makin', 'lama', 'makin', 'nge', 'bug', 'masa', 'mau', 'login', 'suruh', 'verifikasi', 'bagian', 'keamanan', 'sudah', 'jelass', 'gambar', 'pilihanya', 'benar', 'tetap', 'salah', 'tidak', 'bisa', 'masuk']","['aplikasi', 'tidak', 'jeelassss', 'nge', 'bug', 'login', 'suruh', 'verifikasi', 'keamanan', 'jelass', 'gambar', 'pilihanya', 'salah', 'tidak', 'masuk']",25,15,10,aplikasi tidak jeelassss nge bug login suruh verifikasi aman jelass gambar pilihanya salah tidak masuk,15,15
"aplikasi yang top untuk melihat jaringan karier yg lebih luas! appsnya juga semakin bagus, tampilannya oke, ngga ada bug. semoga ada peningkatan di aplikasinya 👍🏻",positif,2024-07-18,2024,aplikasi yang top untuk melihat jaringan karier yg lebih luas appsnya juga semakin bagus tampilannya oke ngga ada bug semoga ada peningkatan di aplikasinya,25,24,aplikasi yang top untuk melihat jaringan karier yang lebih luas aplikasinya juga semakin bagus tampilannya oke tidak ada bug semoga ada peningkatan di aplikasi nya,24,25,"['aplikasi', 'yang', 'top', 'untuk', 'melihat', 'jaringan', 'karier', 'yang', 'lebih', 'luas', 'aplikasinya', 'juga', 'semakin', 'bagus', 'tampilannya', 'oke', 'tidak', 'ada', 'bug', 'semoga', 'ada', 'peningkatan', 'di', 'aplikasi', 'nya']","['aplikasi', 'top', 'jaringan', 'karier', 'luas', 'aplikasinya', 'bagus', 'tampilannya', 'oke', 'tidak', 'bug', 'semoga', 'peningkatan', 'aplikasi', 'nya']",25,15,10,aplikasi top jaring karier luas aplikasi bagus tampil oke tidak bug moga tingkat aplikasi nya,15,15
"Aplikasi LinkedIn logout sendiri dan meminta verifikasi wajah (data privasi rekam wajah). Apa tujuan dari rekam wajah semua sisi, apakah aman perekaman wajah padahal LinkedIn bukan aplikasi perbankan??",negatif,2024-07-19,2024,aplikasi linkedin logout sendiri dan meminta verifikasi wajah data privasi rekam wajah apa tujuan dari rekam wajah semua sisi apakah aman perekaman wajah padahal linkedin bukan aplikasi perbankan,28,28,aplikasi linkedin logout sendiri dan meminta verifikasi wajah data privasi rekam wajah apa tujuan dari rekam wajah semua sisi apakah aman perekaman wajah padahal linkedin bukan aplikasi perbankan,28,28,"['aplikasi', 'linkedin', 'logout', 'sendiri', 'dan', 'meminta', 'verifikasi', 'wajah', 'data', 'privasi', 'rekam', 'wajah', 'apa', 'tujuan', 'dari', 'rekam', 'wajah', 'semua', 'sisi', 'apakah', 'aman', 'perekaman', 'wajah', 'padahal', 'linkedin', 'bukan', 'aplikasi', 'perbankan']","['aplikasi', 'linkedin', 'logout', 'verifikasi', 'wajah', 'data', 'privasi', 'rekam', 'wajah', 'tujuan', 'rekam', 'wajah', 'sisi', 'aman', 'perekaman', 'wajah', 'linkedin', 'aplikasi', 'perbankan']",28,19,9,aplikasi linkedin logout verifikasi wajah data privasi rekam wajah tuju rekam wajah sisi aman rekam wajah linkedin aplikasi perban,19,19
"Verivikasi kenapa ngga pakai nomor telfon atau email yang tertaut,jadinya susah masuk disuruh nebak gambar hadap atas tapi gambar apapun yang dipilih semuanya bener dan hanya gambar terakhir yang selalu salah meskipun udah bener jawabannya itu.tolong diperbaiki untuk memberi kemudahan akses,bukan mempersulit!!!",negatif,2024-08-14,2024,verivikasi kenapa ngga pakai nomor telfon atau email yang tertaut jadinya susah masuk disuruh nebak gambar hadap atas tapi gambar apapun yang dipilih semuanya bener dan hanya gambar terakhir yang selalu salah meskipun udah bener jawabannya itu tolong diperbaiki untuk memberi kemudahan akses bukan mempersulit,42,45,verivikasi kenapa tidak pakai nomor telpon atau email yang tertaut jadinya susah masuk disuruh nebak gambar hadap atas tapi gambar apapun yang dipilih semuanya benar dan hanya gambar terakhir yang selalu salah meskipun sudah benar jawabannya itu tolong di perbaiki untuk memberi kemudahan akses bukan mempersulit,45,46,"['verivikasi', 'kenapa', 'tidak', 'pakai', 'nomor', 'telpon', 'atau', 'email', 'yang', 'tertaut', 'jadinya', 'susah', 'masuk', 'disuruh', 'nebak', 'gambar', 'hadap', 'atas', 'tapi', 'gambar', 'apapun', 'yang', 'dipilih', 'semuanya', 'benar', 'dan', 'hanya', 'gambar', 'terakhir', 'yang', 'selalu', 'salah', 'meskipun', 'sudah', 'benar', 'jawabannya', 'itu', 'tolong', 'di', 'perbaiki', 'untuk', 'memberi', 'kemudahan', 'akses', 'bukan', 'mempersulit']","['verivikasi', 'tidak', 'pakai', 'nomor', 'telpon', 'email', 'tertaut', 'susah', 'masuk', 'disuruh', 'nebak', 'gambar', 'hadap', 'gambar', 'apapun', 'dipilih', 'gambar', 'salah', 'jawabannya', 'tolong', 'perbaiki', 'kemudahan', 'akses', 'mempersulit']",46,24,22,verivikasi tidak pakai nomor telpon email taut susah masuk suruh nebak gambar hadap gambar apa pilih gambar salah jawab tolong baik mudah akses sulit,24,24
"Sistem verifikasi yang sangat aneh dan tidak transparan. 2 akun saya dibatasi hingga putus akses, verifikasi tidak pernah berhasil, serta tidak ada kejelasan dari pihak Linked in. SAYA MANUSIA BUKAN ROBOT, HARAP LAYANI DENGAN MANUSIA JUGA. ROBOT TIDAK MEMBERIKAN SOLUSI.",negatif,2024-07-23,2024,sistem verifikasi yang sangat aneh dan tidak transparan akun saya dibatasi hingga putus akses verifikasi tidak pernah berhasil serta tidak ada kejelasan dari pihak linked in saya manusia bukan robot harap layani dengan manusia juga robot tidak memberikan solusi,40,39,sistem verifikasi yang sangat aneh dan tidak transparan akun saya dibatasi hingga putus akses verifikasi tidak pernah berhasil serta tidak ada kejelasan dari pihak linked in saya manusia bukan robot harap layani dengan manusia juga robot tidak memberikan solusi,39,39,"['sistem', 'verifikasi', 'yang', 'sangat', 'aneh', 'dan', 'tidak', 'transparan', 'akun', 'saya', 'dibatasi', 'hingga', 'putus', 'akses', 'verifikasi', 'tidak', 'pernah', 'berhasil', 'serta', 'tidak', 'ada', 'kejelasan', 'dari', 'pihak', 'linked', 'in', 'saya', 'manusia', 'bukan', 'robot', 'harap', 'layani', 'dengan', 'manusia', 'juga', 'robot', 'tidak', 'memberikan', 'solusi']","['sistem', 'verifikasi', 'aneh', 'tidak', 'transparan', 'akun', 'dibatasi', 'putus', 'akses', 'verifikasi', 'tidak', 'berhasil', 'tidak', 'kejelasan', 'linked', 'in', 'manusia', 'robot', 'harap', 'layani', 'manusia', 'robot', 'tidak', 'solusi']",39,24,15,sistem verifikasi aneh tidak transparan akun batas putus akses verifikasi tidak hasil tidak jelas linked in manusia robot harap layan manusia robot tidak solusi,24,24
"Gak bisa login tiba tiba keluar, kalau buat verifikasi yang benar napa, apalagi yang gambar gk jelas udh milih yang hadap ke atas salah mulu",negatif,2024-08-18,2024,gak bisa login tiba tiba keluar kalau buat verifikasi yang benar napa apalagi yang gambar gk jelas udh milih yang hadap ke atas salah mulu,25,25,tidak bisa login tiba tiba keluar kalau buat verifikasi yang benar napa apalagi yang gambar tidak jelas sudah memilih yang hadap ke atas salah mulu,25,25,"['tidak', 'bisa', 'login', 'tiba', 'tiba', 'keluar', 'kalau', 'buat', 'verifikasi', 'yang', 'benar', 'napa', 'apalagi', 'yang', 'gambar', 'tidak', 'jelas', 'sudah', 'memilih', 'yang', 'hadap', 'ke', 'atas', 'salah', 'mulu']","['tidak', 'login', 'verifikasi', 'napa', 'gambar', 'tidak', 'memilih', 'hadap', 'salah', 'mulu']",25,10,15,tidak login verifikasi napa gambar tidak pilih hadap salah mulu,10,10
"verifikasi nya kenapa sih, udah pake ktp juga tapi selalu ga bisa padahal fotonya udah jelas. akun udah ke banned 4 kali ga bisa log in lagi gara-gara verifikasi nya menyusahkan.",negatif,2024-08-27,2024,verifikasi nya kenapa sih udah pake ktp juga tapi selalu ga bisa padahal fotonya udah jelas akun udah ke banned kali ga bisa log in lagi gara gara verifikasi nya menyusahkan,31,31,verifikasi nya kenapa sih sudah pakai ktp juga tapi selalu tidak bisa padahal fotonya sudah jelas akun sudah ke banned kali tidak bisa log in lagi gara gara verifikasi nya menyusahkan,31,31,"['verifikasi', 'nya', 'kenapa', 'sih', 'sudah', 'pakai', 'ktp', 'juga', 'tapi', 'selalu', 'tidak', 'bisa', 'padahal', 'fotonya', 'sudah', 'jelas', 'akun', 'sudah', 'ke', 'banned', 'kali', 'tidak', 'bisa', 'log', 'in', 'lagi', 'gara', 'gara', 'verifikasi', 'nya', 'menyusahkan']","['verifikasi', 'nya', 'sih', 'pakai', 'ktp', 'tidak', 'fotonya', 'akun', 'banned', 'kali', 'tidak', 'log', 'in', 'gara', 'gara', 'verifikasi', 'nya', 'menyusahkan']",31,18,13,verifikasi nya sih pakai ktp tidak foto akun banned kali tidak log in gara gara verifikasi nya susah,18,18
"Ketika pendaftaran,verifikasi selalu salah gambar yang manapun dipilih tetap bakal salah,mohon perbaikannya🙏",negatif,2024-08-28,2024,ketika pendaftaran verifikasi selalu salah gambar yang manapun dipilih tetap bakal salah mohon perbaikannya,12,14,ketika pendaftaran verifikasi selalu salah gambar yang manapun dipilih tetap bakal salah mohon perbaikannya,14,14,"['ketika', 'pendaftaran', 'verifikasi', 'selalu', 'salah', 'gambar', 'yang', 'manapun', 'dipilih', 'tetap', 'bakal', 'salah', 'mohon', 'perbaikannya']","['pendaftaran', 'verifikasi', 'salah', 'gambar', 'manapun', 'dipilih', 'salah', 'mohon', 'perbaikannya']",14,9,5,daftar verifikasi salah gambar mana pilih salah mohon baik,9,9
"Aplikasi makin sering update makin berat, sistem UI nya kurang bagus, terkadang waktu buka lama, dan search koneksi, makin lama app bazel handle hilang sendiri, terkadang buka profile lelet banget, gabisa buka, loading mulu parah sih, padahal buka app lain dan cek kecepatan koneksi internet stabil!!!",negatif,2024-04-25,2024,aplikasi makin sering update makin berat sistem ui nya kurang bagus terkadang waktu buka lama dan search koneksi makin lama app bazel handle hilang sendiri terkadang buka profile lelet banget gabisa buka loading mulu parah sih padahal buka app lain dan cek kecepatan koneksi internet stabil,46,46,aplikasi makin sering diperbarui makin berat sistem ui nya kurang bagus terkadang waktu buka lama dan search koneksi makin lama aplikasi bazel handle hilang sendiri terkadang buka profile lelet banget tidak bisa buka loading mulu parah sih padahal buka aplikasi lain dan cek kecepatan koneksi internet stabil,46,47,"['aplikasi', 'makin', 'sering', 'diperbarui', 'makin', 'berat', 'sistem', 'ui', 'nya', 'kurang', 'bagus', 'terkadang', 'waktu', 'buka', 'lama', 'dan', 'search', 'koneksi', 'makin', 'lama', 'aplikasi', 'bazel', 'handle', 'hilang', 'sendiri', 'terkadang', 'buka', 'profile', 'lelet', 'banget', 'tidak', 'bisa', 'buka', 'loading', 'mulu', 'parah', 'sih', 'padahal', 'buka', 'aplikasi', 'lain', 'dan', 'cek', 'kecepatan', 'koneksi', 'internet', 'stabil']","['aplikasi', 'diperbarui', 'berat', 'sistem', 'ui', 'nya', 'bagus', 'terkadang', 'buka', 'search', 'koneksi', 'aplikasi', 'bazel', 'handle', 'hilang', 'terkadang', 'buka', 'profile', 'lelet', 'banget', 'tidak', 'buka', 'loading', 'mulu', 'parah', 'sih', 'buka', 'aplikasi', 'cek', 'kecepatan', 'koneksi', 'internet', 'stabil']",47,33,14,aplikasi baru berat sistem ui nya bagus terkadang buka search koneksi aplikasi bazel handle hilang terkadang buka profile lelet banget tidak buka loading mulu parah sih buka aplikasi cek cepat koneksi internet stabil,33,33
"Kok apk nya pas ngedeteksi bot bermasalah ya, pengecekannya botnya, ada lima tahap yang keempat pertama mau pencet apapun oke, tapi yang kelima udah benar tapi kok salah",negatif,2024-08-08,2024,kok apk nya pas ngedeteksi bot bermasalah ya pengecekannya botnya ada lima tahap yang keempat pertama mau pencet apapun oke tapi yang kelima udah benar tapi kok salah,28,28,kok aplikasi nya pas ngedeteksi bot bermasalah ya pengecekannya botnya ada lima tahap yang keempat pertama mau tekan apapun oke tapi yang kelima sudah benar tapi kok salah,28,28,"['kok', 'aplikasi', 'nya', 'pas', 'ngedeteksi', 'bot', 'bermasalah', 'ya', 'pengecekannya', 'botnya', 'ada', 'lima', 'tahap', 'yang', 'keempat', 'pertama', 'mau', 'tekan', 'apapun', 'oke', 'tapi', 'yang', 'kelima', 'sudah', 'benar', 'tapi', 'kok', 'salah']","['aplikasi', 'nya', 'pas', 'ngedeteksi', 'bot', 'bermasalah', 'ya', 'pengecekannya', 'botnya', 'tahap', 'keempat', 'tekan', 'apapun', 'oke', 'salah']",28,15,13,aplikasi nya pas ngedeteksi bot masalah ya kece bot tahap empat tekan apa oke salah,15,15
"Mau, log in di perangkat baru aja susah. Verifikasi ribet gambar kambing sapi segala macem. Udah bolak balik verifikasi, gagal terus pas masukin capta hewan.",negatif,2024-08-06,2024,mau log in di perangkat baru aja susah verifikasi ribet gambar kambing sapi segala macem udah bolak balik verifikasi gagal terus pas masukin capta hewan,25,25,mau log in di perangkat baru saja susah verifikasi rumit gambar kambing sapi segala macem sudah bolak balik verifikasi gagal terus pas masukkan capta hewan,25,25,"['mau', 'log', 'in', 'di', 'perangkat', 'baru', 'saja', 'susah', 'verifikasi', 'rumit', 'gambar', 'kambing', 'sapi', 'segala', 'macem', 'sudah', 'bolak', 'balik', 'verifikasi', 'gagal', 'terus', 'pas', 'masukkan', 'capta', 'hewan']","['log', 'in', 'perangkat', 'susah', 'verifikasi', 'rumit', 'gambar', 'kambing', 'sapi', 'macem', 'bolak', 'verifikasi', 'gagal', 'pas', 'masukkan', 'capta', 'hewan']",25,17,8,log in perangkat susah verifikasi rumit gambar kambing sapi macem bolak verifikasi gagal pas masuk capta hewan,17,17
"Heran suka banget log out sendiri, buat masuk juga ribet lagi, aneh, padahal email sama password udah bener tapi proses verifikasinya ribett",negatif,2024-08-04,2024,heran suka banget log out sendiri buat masuk juga ribet lagi aneh padahal email sama password udah bener tapi proses verifikasinya ribett,22,22,heran suka banget log out sendiri buat masuk juga rumit lagi aneh padahal email sama password sudah benar tapi proses verifikasinya rumit,22,22,"['heran', 'suka', 'banget', 'log', 'out', 'sendiri', 'buat', 'masuk', 'juga', 'rumit', 'lagi', 'aneh', 'padahal', 'email', 'sama', 'password', 'sudah', 'benar', 'tapi', 'proses', 'verifikasinya', 'rumit']","['heran', 'suka', 'banget', 'log', 'out', 'masuk', 'rumit', 'aneh', 'email', 'password', 'proses', 'verifikasinya', 'rumit']",22,13,9,heran suka banget log out masuk rumit aneh email password proses verifikasi rumit,13,13
"padahal gaada niatan mau berlangganan dipencet berlangganan pun engga,kenapa tiba tiba saldo dana kesedot untuk berlangganan mana lumayan gede lagi dengan nominal Rp.1.116.078,tolong lah ya min kalau bisa tolong dibalikin,saya sudah mencoba untuk dikembalikan dan proses pembatalan belum juga ada respon haduhh gimana ini",negatif,2024-07-26,2024,padahal gaada niatan mau berlangganan dipencet berlangganan pun engga kenapa tiba tiba saldo dana kesedot untuk berlangganan mana lumayan gede lagi dengan nominal rp tolong lah ya min kalau bisa tolong dibalikin saya sudah mencoba untuk dikembalikan dan proses pembatalan belum juga ada respon haduhh gimana ini,44,47,padahal tidak ada niatan mau berlangganan dipencet berlangganan pun tidak kenapa tiba tiba saldo dana kesedot untuk berlangganan mana lumayan gede lagi dengan nominal rp tolong lah ya minimal kalau bisa tolong dikembalikan saya sudah mencoba untuk dikembalikan dan proses pembatalan belum juga ada respons haduhh bagaimana ini,47,48,"['padahal', 'tidak', 'ada', 'niatan', 'mau', 'berlangganan', 'dipencet', 'berlangganan', 'pun', 'tidak', 'kenapa', 'tiba', 'tiba', 'saldo', 'dana', 'kesedot', 'untuk', 'berlangganan', 'mana', 'lumayan', 'gede', 'lagi', 'dengan', 'nominal', 'rp', 'tolong', 'lah', 'ya', 'minimal', 'kalau', 'bisa', 'tolong', 'dikembalikan', 'saya', 'sudah', 'mencoba', 'untuk', 'dikembalikan', 'dan', 'proses', 'pembatalan', 'belum', 'juga', 'ada', 'respons', 'haduhh', 'bagaimana', 'ini']","['tidak', 'niatan', 'berlangganan', 'dipencet', 'berlangganan', 'tidak', 'saldo', 'dana', 'kesedot', 'berlangganan', 'lumayan', 'gede', 'nominal', 'rp', 'tolong', 'ya', 'minimal', 'tolong', 'dikembalikan', 'mencoba', 'dikembalikan', 'proses', 'pembatalan', 'respons', 'haduhh']",48,25,23,tidak niat langgan pencet langgan tidak saldo dana sedot langgan lumayan gede nominal rp tolong ya minimal tolong kembali coba kembali proses batal respons haduhh,25,25
"Aplikasinya terlalu rumit dan terkesan menyulitkan, kita selalu di arahkan ke berbagai web untuk mengisi data ulang dan selalu upload berulang2. Pusing",negatif,2024-07-17,2024,aplikasinya terlalu rumit dan terkesan menyulitkan kita selalu di arahkan ke berbagai web untuk mengisi data ulang dan selalu upload berulang pusing,22,22,aplikasi nya terlalu rumit dan terkesan menyulitkan kita selalu di arahkan ke berbagai web untuk mengisi data ulang dan selalu unggah berulang pusing,22,23,"['aplikasi', 'nya', 'terlalu', 'rumit', 'dan', 'terkesan', 'menyulitkan', 'kita', 'selalu', 'di', 'arahkan', 'ke', 'berbagai', 'web', 'untuk', 'mengisi', 'data', 'ulang', 'dan', 'selalu', 'unggah', 'berulang', 'pusing']","['aplikasi', 'nya', 'rumit', 'terkesan', 'menyulitkan', 'arahkan', 'web', 'mengisi', 'data', 'ulang', 'unggah', 'berulang', 'pusing']",23,13,10,aplikasi nya rumit kes sulit arah web isi data ulang unggah ulang pusing,13,13
"Apk aneh nih linkedin, Susah amat mau verivikasi login aja, udah nebak gambar yg menghadap ke atas semua tetep gak bisa. Mau nyari kerja aja di persulit t*i",negatif,2024-07-29,2024,apk aneh nih linkedin susah amat mau verivikasi login aja udah nebak gambar yg menghadap ke atas semua tetep gak bisa mau nyari kerja aja di persulit t i,28,29,aplikasi aneh nih linkedin susah amat mau verivikasi login saja sudah nebak gambar yang menghadap ke atas semua tetap tidak bisa mau mencari kerja saja di persulit t i,29,29,"['aplikasi', 'aneh', 'nih', 'linkedin', 'susah', 'amat', 'mau', 'verivikasi', 'login', 'saja', 'sudah', 'nebak', 'gambar', 'yang', 'menghadap', 'ke', 'atas', 'semua', 'tetap', 'tidak', 'bisa', 'mau', 'mencari', 'kerja', 'saja', 'di', 'persulit', 't', 'i']","['aplikasi', 'aneh', 'nih', 'linkedin', 'susah', 'verivikasi', 'login', 'nebak', 'gambar', 'menghadap', 'tidak', 'mencari', 'kerja', 'persulit', 't', 'i']",29,16,13,aplikasi aneh nih linkedin susah verivikasi login nebak gambar hadap tidak cari kerja sulit t i,16,16
"Ini LinkedIn nya bagaimana sih belum apa-apa sudah log out, terus verivikasi terus, udah verifikasi gagal sudah upload yang diminta juga gak bisa.... Kok makin aneh",negatif,2024-06-27,2024,ini linkedin nya bagaimana sih belum apa apa sudah log out terus verivikasi terus udah verifikasi gagal sudah upload yang diminta juga gak bisa kok makin aneh,26,27,ini linkedin nya bagaimana sih belum apa apa sudah log out terus verivikasi terus sudah verifikasi gagal sudah unggah yang diminta juga tidak bisa kok makin aneh,27,27,"['ini', 'linkedin', 'nya', 'bagaimana', 'sih', 'belum', 'apa', 'apa', 'sudah', 'log', 'out', 'terus', 'verivikasi', 'terus', 'sudah', 'verifikasi', 'gagal', 'sudah', 'unggah', 'yang', 'diminta', 'juga', 'tidak', 'bisa', 'kok', 'makin', 'aneh']","['linkedin', 'nya', 'sih', 'log', 'out', 'verivikasi', 'verifikasi', 'gagal', 'unggah', 'tidak', 'aneh']",27,11,16,linkedin nya sih log out verivikasi verifikasi gagal unggah tidak aneh,11,11
"Aplikasi aneh dan gak jelas, Padahal saya sudah melakukan verif data, katanya tunggu 24 jam di acc,, tapi sampe sekarang blom juga di acc.. ADMIN DAN PENGURUSNYA TIDAK RAMAH,TIDAK GERCEP",negatif,2024-07-27,2024,aplikasi aneh dan gak jelas padahal saya sudah melakukan verif data katanya tunggu jam di acc tapi sampe sekarang blom juga di acc admin dan pengurusnya tidak ramah tidak gercep,30,30,aplikasi aneh dan tidak jelas padahal saya sudah melakukan verif data katanya tunggu jam di acc tapi sampai sekarang belum juga di acc admin dan pengurusnya tidak ramah tidak gerak cepat,30,31,"['aplikasi', 'aneh', 'dan', 'tidak', 'jelas', 'padahal', 'saya', 'sudah', 'melakukan', 'verif', 'data', 'katanya', 'tunggu', 'jam', 'di', 'acc', 'tapi', 'sampai', 'sekarang', 'belum', 'juga', 'di', 'acc', 'admin', 'dan', 'pengurusnya', 'tidak', 'ramah', 'tidak', 'gerak', 'cepat']","['aplikasi', 'aneh', 'tidak', 'verif', 'data', 'tunggu', 'jam', 'acc', 'acc', 'admin', 'pengurusnya', 'tidak', 'ramah', 'tidak', 'gerak', 'cepat']",31,16,15,aplikasi aneh tidak verif data tunggu jam acc acc admin urus tidak ramah tidak gerak cepat,16,16
"Kenapa akun saya mendapatkan pesan akses dibatasi ya? Sudah verifikasi id pakai KTP, isi captcha berulang (ulang terus) tapi masih ngga bisa log in. Pakai g-mail ataupun Facebook juga tidak bisa..",negatif,2024-06-29,2024,kenapa akun saya mendapatkan pesan akses dibatasi ya sudah verifikasi id pakai ktp isi captcha berulang ulang terus tapi masih ngga bisa log in pakai g mail ataupun facebook juga tidak bisa,31,32,kenapa akun saya mendapatkan pesan akses dibatasi ya sudah verifikasi id pakai ktp isi captcha berulang ulang terus tapi masih tidak bisa log in pakai tidak mail ataupun facebook juga tidak bisa,32,32,"['kenapa', 'akun', 'saya', 'mendapatkan', 'pesan', 'akses', 'dibatasi', 'ya', 'sudah', 'verifikasi', 'id', 'pakai', 'ktp', 'isi', 'captcha', 'berulang', 'ulang', 'terus', 'tapi', 'masih', 'tidak', 'bisa', 'log', 'in', 'pakai', 'tidak', 'mail', 'ataupun', 'facebook', 'juga', 'tidak', 'bisa']","['akun', 'pesan', 'akses', 'dibatasi', 'ya', 'verifikasi', 'id', 'pakai', 'ktp', 'isi', 'captcha', 'berulang', 'ulang', 'tidak', 'log', 'in', 'pakai', 'tidak', 'mail', 'facebook', 'tidak']",32,21,11,akun pesan akses batas ya verifikasi id pakai ktp isi captcha ulang ulang tidak log in pakai tidak mail facebook tidak,21,21
"Kalo tidak bisa dibuka itu bagaimana ya min, mohon pencerahanya, dari kemaren nggak bisa dibuka aplikasinya padahal sinyal lancar🙏",negatif,2024-06-25,2024,kalo tidak bisa dibuka itu bagaimana ya min mohon pencerahanya dari kemaren nggak bisa dibuka aplikasinya padahal sinyal lancar,19,19,kalau tidak bisa dibuka itu bagaimana ya minimal mohon pencerahanya dari kemarin tidak bisa dibuka aplikasi nya padahal sinyal lancar,19,20,"['kalau', 'tidak', 'bisa', 'dibuka', 'itu', 'bagaimana', 'ya', 'minimal', 'mohon', 'pencerahanya', 'dari', 'kemarin', 'tidak', 'bisa', 'dibuka', 'aplikasi', 'nya', 'padahal', 'sinyal', 'lancar']","['tidak', 'dibuka', 'ya', 'minimal', 'mohon', 'pencerahanya', 'kemarin', 'tidak', 'dibuka', 'aplikasi', 'nya', 'sinyal', 'lancar']",20,13,7,tidak buka ya minimal mohon pencerahanya kemarin tidak buka aplikasi nya sinyal lancar,13,13
"Woi yang bener aja napa, verifikasi ga normal banget. Udah milih bener masih disalahkan. Kalau ga mau niat bantu, ga usah bikin aplikasi! Aneh.",negatif,2024-08-14,2024,woi yang bener aja napa verifikasi ga normal banget udah milih bener masih disalahkan kalau ga mau niat bantu ga usah bikin aplikasi aneh,24,24,woi yang benar saja napa verifikasi tidak normal banget sudah memilih benar masih disalahkan kalau tidak mau niat bantu tidak usah bikin aplikasi aneh,24,24,"['woi', 'yang', 'benar', 'saja', 'napa', 'verifikasi', 'tidak', 'normal', 'banget', 'sudah', 'memilih', 'benar', 'masih', 'disalahkan', 'kalau', 'tidak', 'mau', 'niat', 'bantu', 'tidak', 'usah', 'bikin', 'aplikasi', 'aneh']","['woi', 'napa', 'verifikasi', 'tidak', 'normal', 'banget', 'memilih', 'disalahkan', 'tidak', 'niat', 'bantu', 'tidak', 'bikin', 'aplikasi', 'aneh']",24,15,9,woi napa verifikasi tidak normal banget pilih salah tidak niat bantu tidak bikin aplikasi aneh,15,15
"Mau login gbisa, selalu di pemeriksaan keamanan, tidak bisa masuk ke akun",negatif,2024-08-21,2024,mau login gbisa selalu di pemeriksaan keamanan tidak bisa masuk ke akun,12,12,mau login gbisa selalu di pemeriksaan keamanan tidak bisa masuk ke akun,12,12,"['mau', 'login', 'gbisa', 'selalu', 'di', 'pemeriksaan', 'keamanan', 'tidak', 'bisa', 'masuk', 'ke', 'akun']","['login', 'gbisa', 'pemeriksaan', 'keamanan', 'tidak', 'masuk', 'akun']",12,7,5,login gbisa periksa aman tidak masuk akun,7,7
"Udah di suruh verifikasi make KTP, di tambah gagal terus pas proses ubah kata sandi, lalu di minta kembali verifikasi, menggunakan KTP. Apakah situs ini, akan menyalahgunakan data2 setiap orang tersebut?",negatif,2024-08-28,2024,udah di suruh verifikasi make ktp di tambah gagal terus pas proses ubah kata sandi lalu di minta kembali verifikasi menggunakan ktp apakah situs ini akan menyalahgunakan data setiap orang tersebut,31,31,sudah di suruh verifikasi make ktp di tambah gagal terus pas proses ubah kata sandi lalu di minta kembali verifikasi menggunakan ktp apakah situs ini akan menyalahgunakan data setiap orang tersebut,31,31,"['sudah', 'di', 'suruh', 'verifikasi', 'make', 'ktp', 'di', 'tambah', 'gagal', 'terus', 'pas', 'proses', 'ubah', 'kata', 'sandi', 'lalu', 'di', 'minta', 'kembali', 'verifikasi', 'menggunakan', 'ktp', 'apakah', 'situs', 'ini', 'akan', 'menyalahgunakan', 'data', 'setiap', 'orang', 'tersebut']","['suruh', 'verifikasi', 'make', 'ktp', 'gagal', 'pas', 'proses', 'ubah', 'sandi', 'verifikasi', 'ktp', 'situs', 'menyalahgunakan', 'data', 'orang']",31,15,16,suruh verifikasi make ktp gagal pas proses ubah sandi verifikasi ktp situs menyalahgunakan data orang,15,15
Kenapa sih login aja sulit. Cek keamanan tapi satu jam di tungguin pun gk muncul muncul. Perbaiki dong. Biar kutmbh bintangnya,negatif,2024-07-27,2024,kenapa sih login aja sulit cek keamanan tapi satu jam di tungguin pun gk muncul muncul perbaiki dong biar kutmbh bintangnya,21,21,kenapa sih login saja sulit cek keamanan tapi satu jam di tungguin pun tidak muncul muncul perbaikan dong biar kutmbh bintangnya,21,21,"['kenapa', 'sih', 'login', 'saja', 'sulit', 'cek', 'keamanan', 'tapi', 'satu', 'jam', 'di', 'tungguin', 'pun', 'tidak', 'muncul', 'muncul', 'perbaikan', 'dong', 'biar', 'kutmbh', 'bintangnya']","['sih', 'login', 'sulit', 'cek', 'keamanan', 'jam', 'tungguin', 'tidak', 'muncul', 'muncul', 'perbaikan', 'biar', 'kutmbh', 'bintangnya']",21,14,7,sih login sulit cek aman jam tungguin tidak muncul muncul baik biar kutmbh bintang,14,14
"Walau gak membantu dapat kerja, setidaknya bagus buat wadah personal branding",positif,2024-08-28,2024,walau gak membantu dapat kerja setidaknya bagus buat wadah personal branding,11,11,walau tidak membantu dapat kerja setidaknya bagus buat wadah personal branding,11,11,"['walau', 'tidak', 'membantu', 'dapat', 'kerja', 'setidaknya', 'bagus', 'buat', 'wadah', 'personal', 'branding']","['tidak', 'membantu', 'kerja', 'bagus', 'wadah', 'personal', 'branding']",11,7,4,tidak bantu kerja bagus wadah personal branding,7,7
"Aplikasi sampah, padahal penting banget loh. Ini coba login akun lagi, tapi terkendala proses verif security check nya (yanh gambar kuda gak jelas). Dicoba selalu gagal, padahal udah sesuai arahan dan benar. Blokkk",negatif,2024-03-23,2024,aplikasi sampah padahal penting banget loh ini coba login akun lagi tapi terkendala proses verif security check nya yanh gambar kuda gak jelas dicoba selalu gagal padahal udah sesuai arahan dan benar blokkk,33,33,aplikasi sampah padahal penting banget loh ini coba login akun lagi tapi terkendala proses verif security cek nya yanh gambar kuda tidak jelas dicoba selalu gagal padahal sudah sesuai arahan dan benar blokkk,33,33,"['aplikasi', 'sampah', 'padahal', 'penting', 'banget', 'loh', 'ini', 'coba', 'login', 'akun', 'lagi', 'tapi', 'terkendala', 'proses', 'verif', 'security', 'cek', 'nya', 'yanh', 'gambar', 'kuda', 'tidak', 'jelas', 'dicoba', 'selalu', 'gagal', 'padahal', 'sudah', 'sesuai', 'arahan', 'dan', 'benar', 'blokkk']","['aplikasi', 'sampah', 'banget', 'loh', 'coba', 'login', 'akun', 'terkendala', 'proses', 'verif', 'security', 'cek', 'nya', 'yanh', 'gambar', 'kuda', 'tidak', 'dicoba', 'gagal', 'sesuai', 'arahan', 'blokkk']",33,22,11,aplikasi sampah banget loh coba login akun kendala proses verif security cek nya yanh gambar kuda tidak coba gagal sesuai arah blokkk,22,22
Aku kesulitan untuk mereset paswordku... aplikasinya terus saja meminta foto personaku... sudah di berikan tetap saja tidak bisa login...,negatif,2024-07-23,2024,aku kesulitan untuk mereset paswordku aplikasinya terus saja meminta foto personaku sudah di berikan tetap saja tidak bisa login,19,19,aku kesulitan untuk mereset paswordku aplikasi nya terus saja meminta foto personaku sudah di berikan tetap saja tidak bisa login,19,20,"['aku', 'kesulitan', 'untuk', 'mereset', 'paswordku', 'aplikasi', 'nya', 'terus', 'saja', 'meminta', 'foto', 'personaku', 'sudah', 'di', 'berikan', 'tetap', 'saja', 'tidak', 'bisa', 'login']","['kesulitan', 'mereset', 'paswordku', 'aplikasi', 'nya', 'foto', 'personaku', 'tidak', 'login']",20,9,11,sulit mereset paswordku aplikasi nya foto persona tidak login,9,9
"kena verifikasinya musti make gambar sih iya klo langsung bener lah ini susah, salah jawab mulu knp ngga pake verifikasi dari SMS ato WA lebih gampang, ngeribetin anjir",negatif,2024-08-19,2024,kena verifikasinya musti make gambar sih iya klo langsung bener lah ini susah salah jawab mulu knp ngga pake verifikasi dari sms ato wa lebih gampang ngeribetin anjir,28,28,kena verifikasinya mesti make gambar sih iya kalau langsung benar lah ini susah salah jawab mulu kenapa tidak pakai verifikasi dari sms atau whatsapp lebih gampang ngeribetin anjir,28,28,"['kena', 'verifikasinya', 'mesti', 'make', 'gambar', 'sih', 'iya', 'kalau', 'langsung', 'benar', 'lah', 'ini', 'susah', 'salah', 'jawab', 'mulu', 'kenapa', 'tidak', 'pakai', 'verifikasi', 'dari', 'sms', 'atau', 'whatsapp', 'lebih', 'gampang', 'ngeribetin', 'anjir']","['kena', 'verifikasinya', 'mesti', 'make', 'gambar', 'sih', 'iya', 'langsung', 'susah', 'salah', 'mulu', 'tidak', 'pakai', 'verifikasi', 'sms', 'whatsapp', 'gampang', 'ngeribetin', 'anjir']",28,19,9,kena verifikasi mesti make gambar sih iya langsung susah salah mulu tidak pakai verifikasi sms whatsapp gampang ngeribetin anjir,19,19
"Ribet amat kalo mo masuk verivikasi manusia atau bukan! Udah jelas2 bisa masuk , pilih masuk lewat google pasti manusialah!! Ribet apk ini!!!",negatif,2024-08-03,2024,ribet amat kalo mo masuk verivikasi manusia atau bukan udah jelas bisa masuk pilih masuk lewat google pasti manusialah ribet apk ini,23,22,rumit amat kalau mau masuk verivikasi manusia atau bukan sudah jelas bisa masuk pilih masuk lewat google pasti manusialah rumit aplikasi ini,22,22,"['rumit', 'amat', 'kalau', 'mau', 'masuk', 'verivikasi', 'manusia', 'atau', 'bukan', 'sudah', 'jelas', 'bisa', 'masuk', 'pilih', 'masuk', 'lewat', 'google', 'pasti', 'manusialah', 'rumit', 'aplikasi', 'ini']","['rumit', 'masuk', 'verivikasi', 'manusia', 'masuk', 'pilih', 'masuk', 'google', 'manusialah', 'rumit', 'aplikasi']",22,11,11,rumit masuk verivikasi manusia masuk pilih masuk google manusia rumit aplikasi,11,11
"Terlalu sulit untuk login di HP lain. Selalu aja pemeriksaan captcha, padahal selalu benar.",negatif,2024-07-30,2024,terlalu sulit untuk login di hp lain selalu aja pemeriksaan captcha padahal selalu benar,14,14,terlalu sulit untuk login di handphone lain selalu saja pemeriksaan captcha padahal selalu benar,14,14,"['terlalu', 'sulit', 'untuk', 'login', 'di', 'handphone', 'lain', 'selalu', 'saja', 'pemeriksaan', 'captcha', 'padahal', 'selalu', 'benar']","['sulit', 'login', 'handphone', 'pemeriksaan', 'captcha']",14,5,9,sulit login handphone periksa captcha,5,5
Terlalu ribet Cara Melamar Pekerjaan nya.Knp Tidak Seperti Jobstreet yg hanya Perlu Sekali mengisi data diri dan mudah mengirim Lamaran.Di LinkedIn Selalu dibawa Keberbagai web yg harus mengulang mengisi data diri.,negatif,2024-06-29,2024,terlalu ribet cara melamar pekerjaan nya knp tidak seperti jobstreet yg hanya perlu sekali mengisi data diri dan mudah mengirim lamaran di linkedin selalu dibawa keberbagai web yg harus mengulang mengisi data diri,31,33,terlalu rumit cara melamar pekerjaan nya kenapa tidak seperti jobstreet yang hanya perlu sekali mengisi data diri dan mudah mengirim lamaran di linkedin selalu dibawa keberbagai web yang harus mengulang mengisi data diri,33,33,"['terlalu', 'rumit', 'cara', 'melamar', 'pekerjaan', 'nya', 'kenapa', 'tidak', 'seperti', 'jobstreet', 'yang', 'hanya', 'perlu', 'sekali', 'mengisi', 'data', 'diri', 'dan', 'mudah', 'mengirim', 'lamaran', 'di', 'linkedin', 'selalu', 'dibawa', 'keberbagai', 'web', 'yang', 'harus', 'mengulang', 'mengisi', 'data', 'diri']","['rumit', 'melamar', 'pekerjaan', 'nya', 'tidak', 'jobstreet', 'mengisi', 'data', 'mudah', 'mengirim', 'lamaran', 'linkedin', 'dibawa', 'keberbagai', 'web', 'mengulang', 'mengisi', 'data']",33,18,15,rumit lamar kerja nya tidak jobstreet isi data mudah kirim lamar linkedin bawa bagai web ulang isi data,18,18
"Aplikasi sosmed yang bagus, bisa mempertemukan orang² profesional dalam dunia kerja.",positif,2024-07-25,2024,aplikasi sosmed yang bagus bisa mempertemukan orang² profesional dalam dunia kerja,11,11,aplikasi sosmed yang bagus bisa mempertemukan orang² profesional dalam dunia kerja,11,11,"['aplikasi', 'sosmed', 'yang', 'bagus', 'bisa', 'mempertemukan', 'orang²', 'profesional', 'dalam', 'dunia', 'kerja']","['aplikasi', 'sosmed', 'bagus', 'mempertemukan', 'orang²', 'profesional', 'dunia', 'kerja']",11,8,3,aplikasi sosmed bagus temu orang profesional dunia kerja,8,8
"Tolonglah ini kenapa baru buat akun akses akun sudah dibatasi, ditambah sudah verifikasi pake ktp tetap saja belum bisa, padahal saya ga ngapa ngapain akun itu juga baru",negatif,2024-06-12,2024,tolonglah ini kenapa baru buat akun akses akun sudah dibatasi ditambah sudah verifikasi pake ktp tetap saja belum bisa padahal saya ga ngapa ngapain akun itu juga baru,28,28,tolonglah ini kenapa baru buat akun akses akun sudah dibatasi ditambah sudah verifikasi pakai ktp tetap saja belum bisa padahal saya tidak ngapa buat apa akun itu juga baru,28,29,"['tolonglah', 'ini', 'kenapa', 'baru', 'buat', 'akun', 'akses', 'akun', 'sudah', 'dibatasi', 'ditambah', 'sudah', 'verifikasi', 'pakai', 'ktp', 'tetap', 'saja', 'belum', 'bisa', 'padahal', 'saya', 'tidak', 'ngapa', 'buat', 'apa', 'akun', 'itu', 'juga', 'baru']","['tolonglah', 'akun', 'akses', 'akun', 'dibatasi', 'ditambah', 'verifikasi', 'pakai', 'ktp', 'tidak', 'ngapa', 'akun']",29,12,17,tolong akun akses akun batas tambah verifikasi pakai ktp tidak ngapa akun,12,12
"Aplikasi nya terlalu banyak bug sehingga gak bisa lagi mendaftar, aplikasi ini tidak direkomendasikan teman teman",negatif,2024-07-08,2024,aplikasi nya terlalu banyak bug sehingga gak bisa lagi mendaftar aplikasi ini tidak direkomendasikan teman teman,16,16,aplikasi nya terlalu banyak bug sehingga tidak bisa lagi mendaftar aplikasi ini tidak direkomendasikan teman teman,16,16,"['aplikasi', 'nya', 'terlalu', 'banyak', 'bug', 'sehingga', 'tidak', 'bisa', 'lagi', 'mendaftar', 'aplikasi', 'ini', 'tidak', 'direkomendasikan', 'teman', 'teman']","['aplikasi', 'nya', 'bug', 'tidak', 'mendaftar', 'aplikasi', 'tidak', 'direkomendasikan', 'teman', 'teman']",16,10,6,aplikasi nya bug tidak daftar aplikasi tidak rekomendasi teman teman,10,10
Saya suka walaupun tdk setiap saat saya bisa beriteraksi tapi aplikasi ini banyak.menambah wawasan dan pengetahuan,positif,2024-06-25,2024,saya suka walaupun tdk setiap saat saya bisa beriteraksi tapi aplikasi ini banyak menambah wawasan dan pengetahuan,16,17,saya suka walaupun tidak setiap saat saya bisa beriteraksi tapi aplikasi ini banyak menambah wawasan dan pengetahuan,17,17,"['saya', 'suka', 'walaupun', 'tidak', 'setiap', 'saat', 'saya', 'bisa', 'beriteraksi', 'tapi', 'aplikasi', 'ini', 'banyak', 'menambah', 'wawasan', 'dan', 'pengetahuan']","['suka', 'tidak', 'beriteraksi', 'aplikasi', 'menambah', 'wawasan', 'pengetahuan']",17,7,10,suka tidak beriteraksi aplikasi tambah wawas tahu,7,7
Sulit mendapatkan pekerjaan sekali ada panggilan penipuan semua..memang jaman sekarang nyari kerja harus pakai orang dalam... Ijazah S1 lawan ijazah SMA yang menang yang ijazah SMA dikarenakan yang ijazah SMA ada orang dalamnya sedangkan yang ijazah S1 di abaikan bahkan lamaran atau CV nya langsung dibuang ke tong sampah benar' benar aneh jaman sekarang,negatif,2024-06-14,2024,sulit mendapatkan pekerjaan sekali ada panggilan penipuan semua memang jaman sekarang nyari kerja harus pakai orang dalam ijazah s lawan ijazah sma yang menang yang ijazah sma dikarenakan yang ijazah sma ada orang dalamnya sedangkan yang ijazah s di abaikan bahkan lamaran atau cv nya langsung dibuang ke tong sampah benar benar aneh jaman sekarang,54,55,sulit mendapatkan pekerjaan sekali ada panggilan penipuan semua memang jaman sekarang mencari kerja harus pakai orang dalam ijazah s lawan ijazah sama yang menang yang ijazah sama dikarenakan yang ijazah sama ada orang dalamnya sedangkan yang ijazah s di abaikan bahkan lamaran atau cv nya langsung dibuang ke tong sampah benar benar aneh jaman sekarang,55,55,"['sulit', 'mendapatkan', 'pekerjaan', 'sekali', 'ada', 'panggilan', 'penipuan', 'semua', 'memang', 'jaman', 'sekarang', 'mencari', 'kerja', 'harus', 'pakai', 'orang', 'dalam', 'ijazah', 's', 'lawan', 'ijazah', 'sama', 'yang', 'menang', 'yang', 'ijazah', 'sama', 'dikarenakan', 'yang', 'ijazah', 'sama', 'ada', 'orang', 'dalamnya', 'sedangkan', 'yang', 'ijazah', 's', 'di', 'abaikan', 'bahkan', 'lamaran', 'atau', 'cv', 'nya', 'langsung', 'dibuang', 'ke', 'tong', 'sampah', 'benar', 'benar', 'aneh', 'jaman', 'sekarang']","['sulit', 'pekerjaan', 'panggilan', 'penipuan', 'jaman', 'mencari', 'kerja', 'pakai', 'orang', 'ijazah', 's', 'lawan', 'ijazah', 'menang', 'ijazah', 'ijazah', 'orang', 'dalamnya', 'ijazah', 's', 'abaikan', 'lamaran', 'cv', 'nya', 'langsung', 'dibuang', 'tong', 'sampah', 'aneh', 'jaman']",55,30,25,sulit kerja panggil tipu jaman cari kerja pakai orang ijazah s lawan ijazah menang ijazah ijazah orang dalam ijazah s abai lamar cv nya langsung buang tong sampah aneh jaman,30,30
The best aplikasi bikin minder hahaha keren relasi di aplikasi ini sumpah bikin minder tapi memotivasi untuk mengupgrade diri,positif,2024-07-15,2024,the best aplikasi bikin minder hahaha keren relasi di aplikasi ini sumpah bikin minder tapi memotivasi untuk mengupgrade diri,19,19,the terbaik aplikasi bikin minder hahaha keren relasi di aplikasi ini sumpah bikin minder tapi memotivasi untuk mengupgrade diri,19,19,"['the', 'terbaik', 'aplikasi', 'bikin', 'minder', 'hahaha', 'keren', 'relasi', 'di', 'aplikasi', 'ini', 'sumpah', 'bikin', 'minder', 'tapi', 'memotivasi', 'untuk', 'mengupgrade', 'diri']","['the', 'terbaik', 'aplikasi', 'bikin', 'minder', 'hahaha', 'keren', 'relasi', 'aplikasi', 'sumpah', 'bikin', 'minder', 'memotivasi', 'mengupgrade']",19,14,5,the baik aplikasi bikin minder hahaha keren relasi aplikasi sumpah bikin minder motivasi mengupgrade,14,14
System pencarian yang mudah digunakan dan saran-saran yang sangat berguna bagi yang membutuhkan,positif,2024-07-15,2024,system pencarian yang mudah digunakan dan saran saran yang sangat berguna bagi yang membutuhkan,13,14,system pencarian yang mudah digunakan dan saran saran yang sangat berguna bagi yang membutuhkan,14,14,"['system', 'pencarian', 'yang', 'mudah', 'digunakan', 'dan', 'saran', 'saran', 'yang', 'sangat', 'berguna', 'bagi', 'yang', 'membutuhkan']","['system', 'pencarian', 'mudah', 'saran', 'saran', 'berguna', 'membutuhkan']",14,7,7,system cari mudah saran saran guna butuh,7,7
Baru daftar bolak balik isi captcha mulu. Gajelas ini aplikasi. Bikin emosi aja. Belum aja cari kerja udah capek duluan bolak balik ngisi captcha. Benerin lah ini bug nya.,negatif,2024-06-19,2024,baru daftar bolak balik isi captcha mulu gajelas ini aplikasi bikin emosi aja belum aja cari kerja udah capek duluan bolak balik ngisi captcha benerin lah ini bug nya,29,29,baru daftar bolak balik isi captcha mulu tidak jelas ini aplikasi bikin emosi saja belum saja cari kerja sudah capek duluan bolak balik mengisi captcha benerin lah ini bug nya,29,30,"['baru', 'daftar', 'bolak', 'balik', 'isi', 'captcha', 'mulu', 'tidak', 'jelas', 'ini', 'aplikasi', 'bikin', 'emosi', 'saja', 'belum', 'saja', 'cari', 'kerja', 'sudah', 'capek', 'duluan', 'bolak', 'balik', 'mengisi', 'captcha', 'benerin', 'lah', 'ini', 'bug', 'nya']","['daftar', 'bolak', 'isi', 'captcha', 'mulu', 'tidak', 'aplikasi', 'bikin', 'emosi', 'cari', 'kerja', 'capek', 'duluan', 'bolak', 'mengisi', 'captcha', 'benerin', 'bug', 'nya']",30,19,11,daftar bolak isi captcha mulu tidak aplikasi bikin emosi cari kerja capek duluan bolak isi captcha benerin bug nya,19,19
Mau masuk susah padahal uda upload data diri. Jadi ga bisa ubah profil. Bolak balik minta verifikasi si gambar banteng dan domba. Menyebalkan! 😡😡,negatif,2024-06-19,2024,mau masuk susah padahal uda upload data diri jadi ga bisa ubah profil bolak balik minta verifikasi si gambar banteng dan domba menyebalkan,24,23,mau masuk susah padahal sudah unggah data diri jadi tidak bisa ubah profil bolak balik minta verifikasi sih gambar banteng dan domba menyebalkan,23,23,"['mau', 'masuk', 'susah', 'padahal', 'sudah', 'unggah', 'data', 'diri', 'jadi', 'tidak', 'bisa', 'ubah', 'profil', 'bolak', 'balik', 'minta', 'verifikasi', 'sih', 'gambar', 'banteng', 'dan', 'domba', 'menyebalkan']","['masuk', 'susah', 'unggah', 'data', 'tidak', 'ubah', 'profil', 'bolak', 'verifikasi', 'sih', 'gambar', 'banteng', 'domba', 'menyebalkan']",23,14,9,masuk susah unggah data tidak ubah profil bolak verifikasi sih gambar banteng domba sebal,14,14
"2 tahun sy mengunakn aplikasi bodong balasan pun nihil yg ada balasan kabar melalui email buat daftar lowongan kerja terus terusan. Ngabisin paket data, nyesel download , TUTUP AJA APLIKASI INI MERUGIKAN COUNSUMEN MAS BRO 2 tahun menunggu via email, rugi...........",negatif,2024-07-09,2024,tahun sy mengunakn aplikasi bodong balasan pun nihil yg ada balasan kabar melalui email buat daftar lowongan kerja terus terusan ngabisin paket data nyesel download tutup aja aplikasi ini merugikan counsumen mas bro tahun menunggu via email rugi,41,38,tahun saya mengunakn aplikasi bodong balasan pun nihil yang ada balasan kabar melalui email buat daftar lowongan kerja terus terusan ngabisin paket data menyesal unduh tutup saja aplikasi ini merugikan counsumen mas bro tahun menunggu melalui email rugi,38,38,"['tahun', 'saya', 'mengunakn', 'aplikasi', 'bodong', 'balasan', 'pun', 'nihil', 'yang', 'ada', 'balasan', 'kabar', 'melalui', 'email', 'buat', 'daftar', 'lowongan', 'kerja', 'terus', 'terusan', 'ngabisin', 'paket', 'data', 'menyesal', 'unduh', 'tutup', 'saja', 'aplikasi', 'ini', 'merugikan', 'counsumen', 'mas', 'bro', 'tahun', 'menunggu', 'melalui', 'email', 'rugi']","['mengunakn', 'aplikasi', 'bodong', 'balasan', 'nihil', 'balasan', 'kabar', 'email', 'daftar', 'lowongan', 'kerja', 'terusan', 'ngabisin', 'paket', 'data', 'menyesal', 'unduh', 'tutup', 'aplikasi', 'merugikan', 'counsumen', 'mas', 'bro', 'menunggu', 'email', 'rugi']",38,26,12,mengunakn aplikasi bodong balas nihil balas kabar email daftar lowong kerja terus ngabisin paket data sesal unduh tutup aplikasi rugi counsumen mas bro tunggu email rugi,26,26
"Apk yg bermanfaat utk menimba ilmu dan insight, dan mencari pekerjaan pastinya",positif,2024-07-08,2024,apk yg bermanfaat utk menimba ilmu dan insight dan mencari pekerjaan pastinya,12,12,aplikasi yang bermanfaat untuk menimba ilmu dan insight dan mencari pekerjaan pastinya,12,12,"['aplikasi', 'yang', 'bermanfaat', 'untuk', 'menimba', 'ilmu', 'dan', 'insight', 'dan', 'mencari', 'pekerjaan', 'pastinya']","['aplikasi', 'bermanfaat', 'menimba', 'ilmu', 'insight', 'mencari', 'pekerjaan', 'pastinya']",12,8,4,aplikasi manfaat timba ilmu insight cari kerja pasti,8,8
Akun saya ke tiba tiba berubah menjadi nama steven dan tidak bisa masuk sangat megecewakan,negatif,2024-07-04,2024,akun saya ke tiba tiba berubah menjadi nama steven dan tidak bisa masuk sangat megecewakan,15,15,akun saya ke tiba tiba berubah menjadi nama steven dan tidak bisa masuk sangat megecewakan,15,15,"['akun', 'saya', 'ke', 'tiba', 'tiba', 'berubah', 'menjadi', 'nama', 'steven', 'dan', 'tidak', 'bisa', 'masuk', 'sangat', 'megecewakan']","['akun', 'berubah', 'nama', 'steven', 'tidak', 'masuk', 'megecewakan']",15,7,8,akun ubah nama steven tidak masuk megecewakan,7,7
"Situs kerha favorit saya, karena berisi tentang info loker dan ada jaringan koneksi pertemanan dengan orang2 hebat di berbagai bidang kerja dan korporat.",positif,2024-07-13,2024,situs kerha favorit saya karena berisi tentang info loker dan ada jaringan koneksi pertemanan dengan orang hebat di berbagai bidang kerja dan korporat,23,23,situs kerha favorit saya karena berisi tentang informasi loker dan ada jaringan koneksi pertemanan dengan orang hebat di berbagai bidang kerja dan korporat,23,23,"['situs', 'kerha', 'favorit', 'saya', 'karena', 'berisi', 'tentang', 'informasi', 'loker', 'dan', 'ada', 'jaringan', 'koneksi', 'pertemanan', 'dengan', 'orang', 'hebat', 'di', 'berbagai', 'bidang', 'kerja', 'dan', 'korporat']","['situs', 'kerha', 'favorit', 'berisi', 'informasi', 'loker', 'jaringan', 'koneksi', 'pertemanan', 'orang', 'hebat', 'bidang', 'kerja', 'korporat']",23,14,9,situs kerha favorit isi informasi loker jaring koneksi teman orang hebat bidang kerja korporat,14,14
Baru download eh malah gak bisa verifikasi agak kesel ya di suruh milih gambar gtu dan berulang kali salah terus,negatif,2024-07-06,2024,baru download eh malah gak bisa verifikasi agak kesel ya di suruh milih gambar gtu dan berulang kali salah terus,20,20,baru unduh eh bahkan tidak bisa verifikasi agak kesel ya di suruh memilih gambar begitu dan berulang kali salah terus,20,20,"['baru', 'unduh', 'eh', 'bahkan', 'tidak', 'bisa', 'verifikasi', 'agak', 'kesel', 'ya', 'di', 'suruh', 'memilih', 'gambar', 'begitu', 'dan', 'berulang', 'kali', 'salah', 'terus']","['unduh', 'eh', 'tidak', 'verifikasi', 'kesel', 'ya', 'suruh', 'memilih', 'gambar', 'berulang', 'kali', 'salah']",20,12,8,unduh eh tidak verifikasi kesel ya suruh pilih gambar ulang kali salah,12,12
"aplikasi yang sangat membantu para pelamar kerja, ada kerja remote juga wah pokoknya keren lah aplikasi ini",positif,2024-08-01,2024,aplikasi yang sangat membantu para pelamar kerja ada kerja remote juga wah pokoknya keren lah aplikasi ini,17,17,aplikasi yang sangat membantu para pelamar kerja ada kerja remote juga wah pokoknya keren lah aplikasi ini,17,17,"['aplikasi', 'yang', 'sangat', 'membantu', 'para', 'pelamar', 'kerja', 'ada', 'kerja', 'remote', 'juga', 'wah', 'pokoknya', 'keren', 'lah', 'aplikasi', 'ini']","['aplikasi', 'membantu', 'pelamar', 'kerja', 'kerja', 'remote', 'pokoknya', 'keren', 'aplikasi']",17,9,8,aplikasi bantu lamar kerja kerja remote pokok keren aplikasi,9,9
Sangat bagus aplikasinya bisa mendapatkan informasi lowongan kerja disini dengan cepat😍,positif,2024-07-31,2024,sangat bagus aplikasinya bisa mendapatkan informasi lowongan kerja disini dengan cepat,11,11,sangat bagus aplikasi nya bisa mendapatkan informasi lowongan kerja disini dengan cepat,11,12,"['sangat', 'bagus', 'aplikasi', 'nya', 'bisa', 'mendapatkan', 'informasi', 'lowongan', 'kerja', 'disini', 'dengan', 'cepat']","['bagus', 'aplikasi', 'nya', 'informasi', 'lowongan', 'kerja', 'cepat']",12,7,5,bagus aplikasi nya informasi lowong kerja cepat,7,7
"Set asli dah ini aplikasi, masa iya mau log in malah force close di android 14",negatif,2024-07-12,2024,set asli dah ini aplikasi masa iya mau log in malah force close di android,16,15,set asli sudah ini aplikasi masa iya mau log in bahkan force close di android,15,15,"['set', 'asli', 'sudah', 'ini', 'aplikasi', 'masa', 'iya', 'mau', 'log', 'in', 'bahkan', 'force', 'close', 'di', 'android']","['set', 'asli', 'aplikasi', 'iya', 'log', 'in', 'force', 'close', 'android']",15,9,6,set asli aplikasi iya log in force close android,9,9
"Saat seseorang ingin menjalin koneksi dengan saya, karena tombol (x) dan (checklist) kecil dan bersampingan, saya malah tidak sengaja memencet (x) dan saya ingin membatalkannya tapu malah terpemcet lagi tulisan yang menanyakan untuk tidak menyarankan dalam pencarian bla3x dan sekali lagi tidak sengaja saya memencet ya karena di posisi yang sama tombolnya!!! Saya gabisa cari orangnya lagi jadinya 😭😭😭",negatif,2024-04-01,2024,saat seseorang ingin menjalin koneksi dengan saya karena tombol x dan checklist kecil dan bersampingan saya malah tidak sengaja memencet x dan saya ingin membatalkannya tapu malah terpemcet lagi tulisan yang menanyakan untuk tidak menyarankan dalam pencarian bla x dan sekali lagi tidak sengaja saya memencet ya karena di posisi yang sama tombolnya saya gabisa cari orangnya lagi jadinya,59,59,saat seseorang ingin menjalin koneksi dengan saya karena tombol x dan checklist kecil dan bersampingan saya bahkan tidak sengaja memencet x dan saya ingin membatalkannya tapu bahkan terpemcet lagi tulisan yang menanyakan untuk tidak menyarankan dalam pencarian bla x dan sekali lagi tidak sengaja saya memencet ya karena di posisi yang sama tombolnya saya tidak bisa cari orangnya lagi jadinya,59,60,"['saat', 'seseorang', 'ingin', 'menjalin', 'koneksi', 'dengan', 'saya', 'karena', 'tombol', 'x', 'dan', 'checklist', 'kecil', 'dan', 'bersampingan', 'saya', 'bahkan', 'tidak', 'sengaja', 'memencet', 'x', 'dan', 'saya', 'ingin', 'membatalkannya', 'tapu', 'bahkan', 'terpemcet', 'lagi', 'tulisan', 'yang', 'menanyakan', 'untuk', 'tidak', 'menyarankan', 'dalam', 'pencarian', 'bla', 'x', 'dan', 'sekali', 'lagi', 'tidak', 'sengaja', 'saya', 'memencet', 'ya', 'karena', 'di', 'posisi', 'yang', 'sama', 'tombolnya', 'saya', 'tidak', 'bisa', 'cari', 'orangnya', 'lagi', 'jadinya']","['menjalin', 'koneksi', 'tombol', 'x', 'checklist', 'bersampingan', 'tidak', 'sengaja', 'memencet', 'x', 'membatalkannya', 'tapu', 'terpemcet', 'tulisan', 'tidak', 'menyarankan', 'pencarian', 'bla', 'x', 'tidak', 'sengaja', 'memencet', 'ya', 'posisi', 'tombolnya', 'tidak', 'cari', 'orangnya']",60,28,32,jalin koneksi tombol x checklist samping tidak sengaja pencet x batal tapu terpemcet tulis tidak saran cari bla x tidak sengaja pencet ya posisi tombol tidak cari orang,28,28
"Untuk jobseeker, biaya bulanan nya terlalu mahal dalam bentuk IDR. Ditambah gak bisa liat, siapa aja yg cek profile jobseeker. Padahal cuma untuk cari kerja doang, tapi biaya yang diberikan kelewat mahal",negatif,2024-03-17,2024,untuk jobseeker biaya bulanan nya terlalu mahal dalam bentuk idr ditambah gak bisa liat siapa aja yg cek profile jobseeker padahal cuma untuk cari kerja doang tapi biaya yang diberikan kelewat mahal,32,32,untuk jobseeker biaya bulanan nya terlalu mahal dalam bentuk idr ditambah tidak bisa lihat siapa saja yang cek profile jobseeker padahal cuma untuk cari kerja saja tapi biaya yang diberikan kelewat mahal,32,32,"['untuk', 'jobseeker', 'biaya', 'bulanan', 'nya', 'terlalu', 'mahal', 'dalam', 'bentuk', 'idr', 'ditambah', 'tidak', 'bisa', 'lihat', 'siapa', 'saja', 'yang', 'cek', 'profile', 'jobseeker', 'padahal', 'cuma', 'untuk', 'cari', 'kerja', 'saja', 'tapi', 'biaya', 'yang', 'diberikan', 'kelewat', 'mahal']","['jobseeker', 'biaya', 'bulanan', 'nya', 'mahal', 'bentuk', 'idr', 'ditambah', 'tidak', 'lihat', 'cek', 'profile', 'jobseeker', 'cari', 'kerja', 'biaya', 'kelewat', 'mahal']",32,18,14,jobseeker biaya bulan nya mahal bentuk idr tambah tidak lihat cek profile jobseeker cari kerja biaya lewat mahal,18,18
"awalnya bisa log in pakai gmail, tapi beberapa hari kemudian mau buka aplikasi disuruh log in ulang. pakai cara dengan gmail lagi, diarahkan verifikasi yg ga jelas arahannya hingga akhirnya sering gagal. suruh pilih gambar menghadap ke atas, maksudnya kepala atau badan ? akhirnya berhasil juga verifikasi dan ternyata yg dimaksud hadap atas itu badannya dan bukan kepala. tapi endingnya sama aja ga bisa masuk akun, padahal mau pakai gmail tapi dibilang sandi salah. maksudnya gimana? uninstall aja!",negatif,2024-04-14,2024,awalnya bisa log in pakai gmail tapi beberapa hari kemudian mau buka aplikasi disuruh log in ulang pakai cara dengan gmail lagi diarahkan verifikasi yg ga jelas arahannya hingga akhirnya sering gagal suruh pilih gambar menghadap ke atas maksudnya kepala atau badan akhirnya berhasil juga verifikasi dan ternyata yg dimaksud hadap atas itu badannya dan bukan kepala tapi endingnya sama aja ga bisa masuk akun padahal mau pakai gmail tapi dibilang sandi salah maksudnya gimana uninstall aja,78,77,awalnya bisa log in pakai gmail tapi beberapa hari kemudian mau buka aplikasi disuruh log in ulang pakai cara dengan gmail lagi diarahkan verifikasi yang tidak jelas arahannya hingga akhirnya sering gagal suruh pilih gambar menghadap ke atas maksudnya kepala atau badan akhirnya berhasil juga verifikasi dan ternyata yang dimaksud hadap atas itu badannya dan bukan kepala tapi endingnya sama saja tidak bisa masuk akun padahal mau pakai gmail tapi dibilang sandi salah maksudnya bagaimana uninstall saja,77,77,"['awalnya', 'bisa', 'log', 'in', 'pakai', 'gmail', 'tapi', 'beberapa', 'hari', 'kemudian', 'mau', 'buka', 'aplikasi', 'disuruh', 'log', 'in', 'ulang', 'pakai', 'cara', 'dengan', 'gmail', 'lagi', 'diarahkan', 'verifikasi', 'yang', 'tidak', 'jelas', 'arahannya', 'hingga', 'akhirnya', 'sering', 'gagal', 'suruh', 'pilih', 'gambar', 'menghadap', 'ke', 'atas', 'maksudnya', 'kepala', 'atau', 'badan', 'akhirnya', 'berhasil', 'juga', 'verifikasi', 'dan', 'ternyata', 'yang', 'dimaksud', 'hadap', 'atas', 'itu', 'badannya', 'dan', 'bukan', 'kepala', 'tapi', 'endingnya', 'sama', 'saja', 'tidak', 'bisa', 'masuk', 'akun', 'padahal', 'mau', 'pakai', 'gmail', 'tapi', 'dibilang', 'sandi', 'salah', 'maksudnya', 'bagaimana', 'uninstall', 'saja']","['log', 'in', 'pakai', 'gmail', 'buka', 'aplikasi', 'disuruh', 'log', 'in', 'ulang', 'pakai', 'gmail', 'diarahkan', 'verifikasi', 'tidak', 'arahannya', 'gagal', 'suruh', 'pilih', 'gambar', 'menghadap', 'maksudnya', 'kepala', 'badan', 'berhasil', 'verifikasi', 'hadap', 'badannya', 'kepala', 'endingnya', 'tidak', 'masuk', 'akun', 'pakai', 'gmail', 'dibilang', 'sandi', 'salah', 'maksudnya', 'uninstall']",77,40,37,log in pakai gmail buka aplikasi suruh log in ulang pakai gmail arah verifikasi tidak arah gagal suruh pilih gambar hadap maksud kepala badan hasil verifikasi hadap badan kepala endingnya tidak masuk akun pakai gmail bilang sandi salah maksud uninstall,40,40
"nama saya hanya terdiri 1 kata, tidak bisa verifikasi passport. Slalu fail",negatif,2024-08-30,2024,nama saya hanya terdiri kata tidak bisa verifikasi passport slalu fail,12,11,nama saya hanya terdiri kata tidak bisa verifikasi passport selalu fail,11,11,"['nama', 'saya', 'hanya', 'terdiri', 'kata', 'tidak', 'bisa', 'verifikasi', 'passport', 'selalu', 'fail']","['nama', 'tidak', 'verifikasi', 'passport', 'fail']",11,5,6,nama tidak verifikasi passport fail,5,5
"Kenapa sih harud verifikasi terus jadi gabisa login, ga jelas banget",negatif,2024-07-12,2024,kenapa sih harud verifikasi terus jadi gabisa login ga jelas banget,11,11,kenapa sih harud verifikasi terus jadi tidak bisa login tidak jelas banget,11,12,"['kenapa', 'sih', 'harud', 'verifikasi', 'terus', 'jadi', 'tidak', 'bisa', 'login', 'tidak', 'jelas', 'banget']","['sih', 'harud', 'verifikasi', 'tidak', 'login', 'tidak', 'banget']",12,7,5,sih harud verifikasi tidak login tidak banget,7,7
"Aplikasi Sampah, udah login, malah disuruh login lagi",negatif,2024-08-22,2024,aplikasi sampah udah login malah disuruh login lagi,8,8,aplikasi sampah sudah login bahkan disuruh login lagi,8,8,"['aplikasi', 'sampah', 'sudah', 'login', 'bahkan', 'disuruh', 'login', 'lagi']","['aplikasi', 'sampah', 'login', 'disuruh', 'login']",8,5,3,aplikasi sampah login suruh login,5,5
"Verifikasi login dipersulit, padahal sudah memilih gambar yang benar tapi di ulang ulang terus",negatif,2024-06-22,2024,verifikasi login dipersulit padahal sudah memilih gambar yang benar tapi di ulang ulang terus,14,14,verifikasi login dipersulit padahal sudah memilih gambar yang benar tapi di ulang ulang terus,14,14,"['verifikasi', 'login', 'dipersulit', 'padahal', 'sudah', 'memilih', 'gambar', 'yang', 'benar', 'tapi', 'di', 'ulang', 'ulang', 'terus']","['verifikasi', 'login', 'dipersulit', 'memilih', 'gambar', 'ulang', 'ulang']",14,7,7,verifikasi login sulit pilih gambar ulang ulang,7,7
"ngelag bgtt tiba"" keluar sendiri, mau upload foto ga bisa",negatif,2024-07-05,2024,ngelag bgtt tiba keluar sendiri mau upload foto ga bisa,10,10,lambat banget tiba keluar sendiri mau unggah foto tidak bisa,10,10,"['lambat', 'banget', 'tiba', 'keluar', 'sendiri', 'mau', 'unggah', 'foto', 'tidak', 'bisa']","['lambat', 'banget', 'unggah', 'foto', 'tidak']",10,5,5,lambat banget unggah foto tidak,5,5
"Tolong dibenarkan apk nya, verifikasi sudah benar masih tetap salah",negatif,2024-06-25,2024,tolong dibenarkan apk nya verifikasi sudah benar masih tetap salah,10,10,tolong dibenarkan aplikasi nya verifikasi sudah benar masih tetap salah,10,10,"['tolong', 'dibenarkan', 'aplikasi', 'nya', 'verifikasi', 'sudah', 'benar', 'masih', 'tetap', 'salah']","['tolong', 'dibenarkan', 'aplikasi', 'nya', 'verifikasi', 'salah']",10,6,4,tolong benar aplikasi nya verifikasi salah,6,6
"Mau login ga bisa bisa, udah verifikasi beberapa kali tapi tetep balik ke halaman login",negatif,2024-07-08,2024,mau login ga bisa bisa udah verifikasi beberapa kali tapi tetep balik ke halaman login,15,15,mau login tidak bisa bisa sudah verifikasi beberapa kali tapi tetap balik ke halaman login,15,15,"['mau', 'login', 'tidak', 'bisa', 'bisa', 'sudah', 'verifikasi', 'beberapa', 'kali', 'tapi', 'tetap', 'balik', 'ke', 'halaman', 'login']","['login', 'tidak', 'verifikasi', 'kali', 'halaman', 'login']",15,6,9,login tidak verifikasi kali halaman login,6,6
"setelah saya ganti perangkat, saytidak bisa login. sudah memasukkan nomor tlf dan kata sandi yg benar tp tidak ada respon Apapun ketika diklik ""lanjutkan"". tolong perbaiki bug ini mengingat banyak sekali data diri didamnya!",negatif,2024-08-25,2024,setelah saya ganti perangkat saytidak bisa login sudah memasukkan nomor tlf dan kata sandi yg benar tp tidak ada respon apapun ketika diklik lanjutkan tolong perbaiki bug ini mengingat banyak sekali data diri didamnya,34,34,setelah saya ganti perangkat saytidak bisa login sudah memasukkan nomor tlf dan kata sandi yang benar tapi tidak ada respons apapun ketika diklik lanjutkan tolong perbaikan bug ini mengingat banyak sekali data diri didamnya,34,34,"['setelah', 'saya', 'ganti', 'perangkat', 'saytidak', 'bisa', 'login', 'sudah', 'memasukkan', 'nomor', 'tlf', 'dan', 'kata', 'sandi', 'yang', 'benar', 'tapi', 'tidak', 'ada', 'respons', 'apapun', 'ketika', 'diklik', 'lanjutkan', 'tolong', 'perbaikan', 'bug', 'ini', 'mengingat', 'banyak', 'sekali', 'data', 'diri', 'didamnya']","['ganti', 'perangkat', 'saytidak', 'login', 'memasukkan', 'nomor', 'tlf', 'sandi', 'tidak', 'respons', 'apapun', 'diklik', 'lanjutkan', 'tolong', 'perbaikan', 'bug', 'data', 'didamnya']",34,18,16,ganti perangkat saytidak login masuk nomor tlf sandi tidak respons apa klik lanjut tolong baik bug data dam,18,18
"Kalo bisa kasih bintang setengah ni aplikasi gua rating bintang setengah, burukkk bangetttt, mulai dari login susah udah kaya tes CPNS, udah punya akun disuruh masukin kode buat masuk malah ngga bisa. Emang busuk aplikasi ini",negatif,2024-03-22,2024,kalo bisa kasih bintang setengah ni aplikasi gua rating bintang setengah burukkk bangetttt mulai dari login susah udah kaya tes cpns udah punya akun disuruh masukin kode buat masuk malah ngga bisa emang busuk aplikasi ini,36,36,kalau bisa kasih bintang setengah ini aplikasi saya rating bintang setengah burukkk bangetttt mulai dari login susah sudah kayak tes cpns sudah punya akun disuruh masukkan kode buat masuk bahkan tidak bisa memang busuk aplikasi ini,36,36,"['kalau', 'bisa', 'kasih', 'bintang', 'setengah', 'ini', 'aplikasi', 'saya', 'rating', 'bintang', 'setengah', 'burukkk', 'bangetttt', 'mulai', 'dari', 'login', 'susah', 'sudah', 'kayak', 'tes', 'cpns', 'sudah', 'punya', 'akun', 'disuruh', 'masukkan', 'kode', 'buat', 'masuk', 'bahkan', 'tidak', 'bisa', 'memang', 'busuk', 'aplikasi', 'ini']","['kasih', 'bintang', 'aplikasi', 'rating', 'bintang', 'burukkk', 'bangetttt', 'login', 'susah', 'kayak', 'tes', 'cpns', 'akun', 'disuruh', 'masukkan', 'kode', 'masuk', 'tidak', 'busuk', 'aplikasi']",36,20,16,kasih bintang aplikasi rating bintang burukkk bangetttt login susah kayak tes cpns akun suruh masuk kode masuk tidak busuk aplikasi,20,20
"Saya sudah bikin akun sampai 2x dan tiba² setelah saya buat akun yg pertama, akun saya tiba² logout dengan sendirinya, dan ketika saya coba untuk login kembali terdapat masalah karena akun dibatasi padahal saya tidak melakukan kesalahan apapun, akhirnya saya mencoba untuk mengikuti langkah² untuk verifikasi akun saya agar bisa kembali, tetapi hasilnya nihil tetap tidak bisa, tolong untuk devoloper/admin berikan saya alasanya dan cepat perbaiki ini sangat merugikan, saya kasih bintang 1 dulu",negatif,2024-05-29,2024,saya sudah bikin akun sampai x dan tiba² setelah saya buat akun yg pertama akun saya tiba² logout dengan sendirinya dan ketika saya coba untuk login kembali terdapat masalah karena akun dibatasi padahal saya tidak melakukan kesalahan apapun akhirnya saya mencoba untuk mengikuti langkah² untuk verifikasi akun saya agar bisa kembali tetapi hasilnya nihil tetap tidak bisa tolong untuk devoloper admin berikan saya alasanya dan cepat perbaiki ini sangat merugikan saya kasih bintang dulu,74,74,saya sudah bikin akun sampai x dan tiba² setelah saya buat akun yang pertama akun saya tiba² logout dengan sendirinya dan ketika saya coba untuk login kembali terdapat masalah karena akun dibatasi padahal saya tidak melakukan kesalahan apapun akhirnya saya mencoba untuk mengikuti langkah² untuk verifikasi akun saya agar bisa kembali tetapi hasilnya nihil tetap tidak bisa tolong untuk devoloper admin berikan saya alasanya dan cepat perbaikan ini sangat merugikan saya kasih bintang dahulu,74,74,"['saya', 'sudah', 'bikin', 'akun', 'sampai', 'x', 'dan', 'tiba²', 'setelah', 'saya', 'buat', 'akun', 'yang', 'pertama', 'akun', 'saya', 'tiba²', 'logout', 'dengan', 'sendirinya', 'dan', 'ketika', 'saya', 'coba', 'untuk', 'login', 'kembali', 'terdapat', 'masalah', 'karena', 'akun', 'dibatasi', 'padahal', 'saya', 'tidak', 'melakukan', 'kesalahan', 'apapun', 'akhirnya', 'saya', 'mencoba', 'untuk', 'mengikuti', 'langkah²', 'untuk', 'verifikasi', 'akun', 'saya', 'agar', 'bisa', 'kembali', 'tetapi', 'hasilnya', 'nihil', 'tetap', 'tidak', 'bisa', 'tolong', 'untuk', 'devoloper', 'admin', 'berikan', 'saya', 'alasanya', 'dan', 'cepat', 'perbaikan', 'ini', 'sangat', 'merugikan', 'saya', 'kasih', 'bintang', 'dahulu']","['bikin', 'akun', 'x', 'tiba²', 'akun', 'akun', 'tiba²', 'logout', 'coba', 'login', 'akun', 'dibatasi', 'tidak', 'kesalahan', 'apapun', 'mencoba', 'mengikuti', 'langkah²', 'verifikasi', 'akun', 'hasilnya', 'nihil', 'tidak', 'tolong', 'devoloper', 'admin', 'alasanya', 'cepat', 'perbaikan', 'merugikan', 'kasih', 'bintang']",74,32,42,bikin akun x tiba akun akun tiba logout coba login akun batas tidak salah apa coba ikut langkah verifikasi akun hasil nihil tidak tolong devoloper admin alasanya cepat baik rugi kasih bintang,32,32
"Heiii apa apaan si ini, tiba tiba di suruh login ulang padahal saya tidak pernah mengeluarkan akun saya, udah buat verifikasi tapi selalu di ulang², tolong lahh aplnya d perbaiki lagi, nggak jelas banget tau nggak..",negatif,2024-04-28,2024,heiii apa apaan si ini tiba tiba di suruh login ulang padahal saya tidak pernah mengeluarkan akun saya udah buat verifikasi tapi selalu di ulang² tolong lahh aplnya d perbaiki lagi nggak jelas banget tau nggak,36,36,heiii apa apa sih ini tiba tiba di suruh login ulang padahal saya tidak pernah mengeluarkan akun saya sudah buat verifikasi tapi selalu di ulang² tolong lah aplnya di perbaikan lagi tidak jelas banget tahu tidak,36,36,"['heiii', 'apa', 'apa', 'sih', 'ini', 'tiba', 'tiba', 'di', 'suruh', 'login', 'ulang', 'padahal', 'saya', 'tidak', 'pernah', 'mengeluarkan', 'akun', 'saya', 'sudah', 'buat', 'verifikasi', 'tapi', 'selalu', 'di', 'ulang²', 'tolong', 'lah', 'aplnya', 'di', 'perbaikan', 'lagi', 'tidak', 'jelas', 'banget', 'tahu', 'tidak']","['heiii', 'sih', 'suruh', 'login', 'ulang', 'tidak', 'mengeluarkan', 'akun', 'verifikasi', 'ulang²', 'tolong', 'aplnya', 'perbaikan', 'tidak', 'banget', 'tidak']",36,16,20,heiii sih suruh login ulang tidak keluar akun verifikasi ulang tolong aplnya baik tidak banget tidak,16,16
Aplikasi sangat baik untuk berbagai keperluan seperti ini,positif,2024-08-12,2024,aplikasi sangat baik untuk berbagai keperluan seperti ini,8,8,aplikasi sangat baik untuk berbagai keperluan seperti ini,8,8,"['aplikasi', 'sangat', 'baik', 'untuk', 'berbagai', 'keperluan', 'seperti', 'ini']","['aplikasi', 'keperluan']",8,2,6,aplikasi perlu,2,2
"aplikasi langganann gak jelas habiskan saldo main potong"" aja",negatif,2024-08-18,2024,aplikasi langganann gak jelas habiskan saldo main potong aja,9,9,aplikasi langganann tidak jelas habiskan saldo main potong saja,9,9,"['aplikasi', 'langganann', 'tidak', 'jelas', 'habiskan', 'saldo', 'main', 'potong', 'saja']","['aplikasi', 'langganann', 'tidak', 'habiskan', 'saldo', 'main', 'potong']",9,7,2,aplikasi langganann tidak habis saldo main potong,7,7
"Mau login disuruh verifikasi pake gambar, udah berkali2 nyoba gambar terakhir pasti salah. Bikin yg betulah, menghadap ke atas yg kayak apa, yg kepalanya aja ke atas apa sebadan nya😑",negatif,2024-03-28,2024,mau login disuruh verifikasi pake gambar udah berkali nyoba gambar terakhir pasti salah bikin yg betulah menghadap ke atas yg kayak apa yg kepalanya aja ke atas apa sebadan nya,30,30,mau login disuruh verifikasi pakai gambar sudah berkali mencoba gambar terakhir pasti salah bikin yang betulah menghadap ke atas yang kayak apa yang kepalanya saja ke atas apa sebadan nya,30,30,"['mau', 'login', 'disuruh', 'verifikasi', 'pakai', 'gambar', 'sudah', 'berkali', 'mencoba', 'gambar', 'terakhir', 'pasti', 'salah', 'bikin', 'yang', 'betulah', 'menghadap', 'ke', 'atas', 'yang', 'kayak', 'apa', 'yang', 'kepalanya', 'saja', 'ke', 'atas', 'apa', 'sebadan', 'nya']","['login', 'disuruh', 'verifikasi', 'pakai', 'gambar', 'berkali', 'mencoba', 'gambar', 'salah', 'bikin', 'betulah', 'menghadap', 'kayak', 'kepalanya', 'sebadan', 'nya']",30,16,14,login suruh verifikasi pakai gambar kali coba gambar salah bikin betulah hadap kayak kepala bad nya,16,16
Linkedln bermanfaat dan berguna guna saat kita memakainya Semoga bagi pemakai semoga dapat bermanfaat,positif,2024-08-20,2024,linkedln bermanfaat dan berguna guna saat kita memakainya semoga bagi pemakai semoga dapat bermanfaat,14,14,linkedln bermanfaat dan berguna guna saat kita memakainya semoga bagi pemakai semoga dapat bermanfaat,14,14,"['linkedln', 'bermanfaat', 'dan', 'berguna', 'guna', 'saat', 'kita', 'memakainya', 'semoga', 'bagi', 'pemakai', 'semoga', 'dapat', 'bermanfaat']","['linkedln', 'bermanfaat', 'berguna', 'memakainya', 'semoga', 'pemakai', 'semoga', 'bermanfaat']",14,8,6,linkedln manfaat guna maka moga pakai moga manfaat,8,8
"Min mohon bantuannya kenapa di profil saya tidak ada opsi pengalaman ya min?, jadinya pengalaman saya ga mau muncul di profil",negatif,2024-08-15,2024,min mohon bantuannya kenapa di profil saya tidak ada opsi pengalaman ya min jadinya pengalaman saya ga mau muncul di profil,21,21,minimal mohon bantuannya kenapa di profil saya tidak ada opsi pengalaman ya minimal jadinya pengalaman saya tidak mau muncul di profil,21,21,"['minimal', 'mohon', 'bantuannya', 'kenapa', 'di', 'profil', 'saya', 'tidak', 'ada', 'opsi', 'pengalaman', 'ya', 'minimal', 'jadinya', 'pengalaman', 'saya', 'tidak', 'mau', 'muncul', 'di', 'profil']","['minimal', 'mohon', 'bantuannya', 'profil', 'tidak', 'opsi', 'pengalaman', 'ya', 'minimal', 'pengalaman', 'tidak', 'muncul', 'profil']",21,13,8,minimal mohon bantu profil tidak opsi alam ya minimal alam tidak muncul profil,13,13
"Reset kata sandi susah, kode verifikasi tidak muncul",negatif,2024-08-21,2024,reset kata sandi susah kode verifikasi tidak muncul,8,8,reset kata sandi susah kode verifikasi tidak muncul,8,8,"['reset', 'kata', 'sandi', 'susah', 'kode', 'verifikasi', 'tidak', 'muncul']","['reset', 'sandi', 'susah', 'kode', 'verifikasi', 'tidak', 'muncul']",8,7,1,reset sandi susah kode verifikasi tidak muncul,7,7
"Saya mengalami bug tidak bisa login setelah mengisi recaptcha, tertulis invalid atau gagal. Padahal jawaban sudah benar semua dan itu terjadi secara berulang",negatif,2024-04-22,2024,saya mengalami bug tidak bisa login setelah mengisi recaptcha tertulis invalid atau gagal padahal jawaban sudah benar semua dan itu terjadi secara berulang,23,23,saya mengalami bug tidak bisa login setelah mengisi recaptcha tertulis invalid atau gagal padahal jawaban sudah benar semua dan itu terjadi secara berulang,23,23,"['saya', 'mengalami', 'bug', 'tidak', 'bisa', 'login', 'setelah', 'mengisi', 'recaptcha', 'tertulis', 'invalid', 'atau', 'gagal', 'padahal', 'jawaban', 'sudah', 'benar', 'semua', 'dan', 'itu', 'terjadi', 'secara', 'berulang']","['mengalami', 'bug', 'tidak', 'login', 'mengisi', 'recaptcha', 'tertulis', 'invalid', 'gagal', 'berulang']",23,10,13,alami bug tidak login isi recaptcha tulis invalid gagal ulang,10,10
Kenapa akun saya hari ini tiba2 berganti dengan akun dengan nama Qihua Zhou dan alamat email saya cek masih punya saya serta noner hp,negatif,2024-08-28,2024,kenapa akun saya hari ini tiba berganti dengan akun dengan nama qihua zhou dan alamat email saya cek masih punya saya serta noner hp,24,24,kenapa akun saya hari ini tiba berganti dengan akun dengan nama qihua zhou dan alamat email saya cek masih punya saya serta noner handphone,24,24,"['kenapa', 'akun', 'saya', 'hari', 'ini', 'tiba', 'berganti', 'dengan', 'akun', 'dengan', 'nama', 'qihua', 'zhou', 'dan', 'alamat', 'email', 'saya', 'cek', 'masih', 'punya', 'saya', 'serta', 'noner', 'handphone']","['akun', 'berganti', 'akun', 'nama', 'qihua', 'zhou', 'alamat', 'email', 'cek', 'noner', 'handphone']",24,11,13,akun ganti akun nama qihua zhou alamat email cek noner handphone,11,11
Mantap aplikasinya. Semoga bisa Upgrade skill,positif,2024-08-27,2024,mantap aplikasinya semoga bisa upgrade skill,6,6,mantap aplikasi nya semoga bisa upgrade skill,6,7,"['mantap', 'aplikasi', 'nya', 'semoga', 'bisa', 'upgrade', 'skill']","['mantap', 'aplikasi', 'nya', 'semoga', 'upgrade', 'skill']",7,6,1,mantap aplikasi nya moga upgrade skill,6,6
"Terlalu kebahasa inggris an, terlalu mematok umur, tidak memperhatikan pengalaman otodidak",negatif,2024-06-23,2024,terlalu kebahasa inggris an terlalu mematok umur tidak memperhatikan pengalaman otodidak,11,11,terlalu kebahasa inggris an terlalu mematok umur tidak memperhatikan pengalaman otodidak,11,11,"['terlalu', 'kebahasa', 'inggris', 'an', 'terlalu', 'mematok', 'umur', 'tidak', 'memperhatikan', 'pengalaman', 'otodidak']","['kebahasa', 'inggris', 'an', 'mematok', 'umur', 'tidak', 'memperhatikan', 'pengalaman', 'otodidak']",11,9,2,bahasa inggris an patok umur tidak perhati alam otodidak,9,9
"Berhubung lupa, niatnya mau cek akun sekalian mau update data dll, tapi hampir 30 menit an nyoba login, servernya lama lemot banget, proses quick check dan verifikasinya bener"" lama, blm selesai verifikasi koneksi server keputus terus, pdhl sinyal udh kenceng, aplikasi lain ga ada masalah, cuma mau ngurusin akun linkedin ini malah bener"" makan waktu. Berkali-kali nyoba selalu keputus servernya sama lemotnya masyaallah. Saya saran, kedepannya tlg diperbaiki lagi aps nya, bikin ga nyaman pengguna",negatif,2023-10-29,2023,berhubung lupa niatnya mau cek akun sekalian mau update data dll tapi hampir menit an nyoba login servernya lama lemot banget proses quick check dan verifikasinya bener lama blm selesai verifikasi koneksi server keputus terus pdhl sinyal udh kenceng aplikasi lain ga ada masalah cuma mau ngurusin akun linkedin ini malah bener makan waktu berkali kali nyoba selalu keputus servernya sama lemotnya masyaallah saya saran kedepannya tlg diperbaiki lagi aps nya bikin ga nyaman pengguna,75,75,berhubung lupa niatnya mau cek akun sekalian mau diperbarui data dan lain lain tapi hampir menit an mencoba login server nya lama lambat banget proses quick cek dan verifikasinya benar lama belum selesai verifikasi koneksi server keputus terus padahal sinyal sudah kenceng aplikasi lain tidak ada masalah cuma mau ngurusin akun linkedin ini bahkan benar makan waktu berkali kali mencoba selalu keputus server nya sama lemotnya masyaallah saya saran kedepannya tlg di perbaiki lagi aps nya bikin tidak nyaman pengguna,75,80,"['berhubung', 'lupa', 'niatnya', 'mau', 'cek', 'akun', 'sekalian', 'mau', 'diperbarui', 'data', 'dan', 'lain', 'lain', 'tapi', 'hampir', 'menit', 'an', 'mencoba', 'login', 'server', 'nya', 'lama', 'lambat', 'banget', 'proses', 'quick', 'cek', 'dan', 'verifikasinya', 'benar', 'lama', 'belum', 'selesai', 'verifikasi', 'koneksi', 'server', 'keputus', 'terus', 'padahal', 'sinyal', 'sudah', 'kenceng', 'aplikasi', 'lain', 'tidak', 'ada', 'masalah', 'cuma', 'mau', 'ngurusin', 'akun', 'linkedin', 'ini', 'bahkan', 'benar', 'makan', 'waktu', 'berkali', 'kali', 'mencoba', 'selalu', 'keputus', 'server', 'nya', 'sama', 'lemotnya', 'masyaallah', 'saya', 'saran', 'kedepannya', 'tlg', 'di', 'perbaiki', 'lagi', 'aps', 'nya', 'bikin', 'tidak', 'nyaman', 'pengguna']","['berhubung', 'lupa', 'niatnya', 'cek', 'akun', 'diperbarui', 'data', 'menit', 'an', 'mencoba', 'login', 'server', 'nya', 'lambat', 'banget', 'proses', 'quick', 'cek', 'verifikasinya', 'selesai', 'verifikasi', 'koneksi', 'server', 'keputus', 'sinyal', 'kenceng', 'aplikasi', 'tidak', 'ngurusin', 'akun', 'linkedin', 'makan', 'berkali', 'kali', 'mencoba', 'keputus', 'server', 'nya', 'lemotnya', 'masyaallah', 'saran', 'kedepannya', 'tlg', 'perbaiki', 'aps', 'nya', 'bikin', 'tidak', 'nyaman', 'pengguna']",80,50,30,hubung lupa niat cek akun baru data menit an coba login server nya lambat banget proses quick cek verifikasi selesai verifikasi koneksi server putus sinyal kenceng aplikasi tidak ngurusin akun linkedin makan kali kali coba putus server nya lot masyaallah saran depan tlg baik aps nya bikin tidak nyaman guna,50,50
"Membantu menambah relasi dalam pekerjaan, mendapatkan informasi informasi lowongan pekerjaan, Membantu saya untuk lebih baik lagi",positif,2024-06-24,2024,membantu menambah relasi dalam pekerjaan mendapatkan informasi informasi lowongan pekerjaan membantu saya untuk lebih baik lagi,16,16,membantu menambah relasi dalam pekerjaan mendapatkan informasi informasi lowongan pekerjaan membantu saya untuk lebih baik lagi,16,16,"['membantu', 'menambah', 'relasi', 'dalam', 'pekerjaan', 'mendapatkan', 'informasi', 'informasi', 'lowongan', 'pekerjaan', 'membantu', 'saya', 'untuk', 'lebih', 'baik', 'lagi']","['membantu', 'menambah', 'relasi', 'pekerjaan', 'informasi', 'informasi', 'lowongan', 'pekerjaan', 'membantu']",16,9,7,bantu tambah relasi kerja informasi informasi lowong kerja bantu,9,9
Padahal sudah mematuhi kebijakan dengan baik. Tiba-tiba akun saya tersuspend sendiri. Kerja keras saya menjadi sia-sia.,negatif,2024-08-19,2024,padahal sudah mematuhi kebijakan dengan baik tiba tiba akun saya tersuspend sendiri kerja keras saya menjadi sia sia,16,18,padahal sudah mematuhi kebijakan dengan baik tiba tiba akun saya tersuspend sendiri kerja keras saya menjadi sia sia,18,18,"['padahal', 'sudah', 'mematuhi', 'kebijakan', 'dengan', 'baik', 'tiba', 'tiba', 'akun', 'saya', 'tersuspend', 'sendiri', 'kerja', 'keras', 'saya', 'menjadi', 'sia', 'sia']","['mematuhi', 'kebijakan', 'akun', 'tersuspend', 'kerja', 'keras', 'sia', 'sia']",18,8,10,patuh bijak akun tersuspend kerja keras sia sia,8,8
Selalalu berkelahi dengan aplikasi ini developer jujur sama saya tidak mengerti tolong di hanjurkan akun tak membuat pusing lagi thanks,negatif,2024-06-30,2024,selalalu berkelahi dengan aplikasi ini developer jujur sama saya tidak mengerti tolong di hanjurkan akun tak membuat pusing lagi thanks,20,20,selalalu berkelahi dengan aplikasi ini developer jujur sama saya tidak mengerti tolong di hanjurkan akun tidak membuat pusing lagi terima kasih,20,21,"['selalalu', 'berkelahi', 'dengan', 'aplikasi', 'ini', 'developer', 'jujur', 'sama', 'saya', 'tidak', 'mengerti', 'tolong', 'di', 'hanjurkan', 'akun', 'tidak', 'membuat', 'pusing', 'lagi', 'terima', 'kasih']","['selalalu', 'berkelahi', 'aplikasi', 'developer', 'jujur', 'tidak', 'mengerti', 'tolong', 'hanjurkan', 'akun', 'tidak', 'pusing', 'terima', 'kasih']",21,14,7,selalalu kelah aplikasi developer jujur tidak erti tolong hanjurkan akun tidak pusing terima kasih,14,14
Sangat membantu untuk mendapati informasi pekerjaan Kasi bintang 3 dulu,positif,2024-06-22,2024,sangat membantu untuk mendapati informasi pekerjaan kasi bintang dulu,10,9,sangat membantu untuk mendapati informasi pekerjaan kasih bintang dahulu,9,9,"['sangat', 'membantu', 'untuk', 'mendapati', 'informasi', 'pekerjaan', 'kasih', 'bintang', 'dahulu']","['membantu', 'mendapati', 'informasi', 'pekerjaan', 'kasih', 'bintang']",9,6,3,bantu dapat informasi kerja kasih bintang,6,6
Banyak informasi lowongan kerja,positif,2024-08-22,2024,banyak informasi lowongan kerja,4,4,banyak informasi lowongan kerja,4,4,"['banyak', 'informasi', 'lowongan', 'kerja']","['informasi', 'lowongan', 'kerja']",4,3,1,informasi lowong kerja,3,3
Aplikasi yg mnrt saya pribadi sangat informatif,positif,2024-08-29,2024,aplikasi yg mnrt saya pribadi sangat informatif,7,7,aplikasi yang mnrt saya pribadi sangat informatif,7,7,"['aplikasi', 'yang', 'mnrt', 'saya', 'pribadi', 'sangat', 'informatif']","['aplikasi', 'mnrt', 'pribadi', 'informatif']",7,4,3,aplikasi mnrt pribadi informatif,4,4
Cuma mau ganti foto profil susah amat gagal terus mau di laptop atau hp,negatif,2024-08-12,2024,cuma mau ganti foto profil susah amat gagal terus mau di laptop atau hp,14,14,cuma mau ganti foto profil susah amat gagal terus mau di laptop atau handphone,14,14,"['cuma', 'mau', 'ganti', 'foto', 'profil', 'susah', 'amat', 'gagal', 'terus', 'mau', 'di', 'laptop', 'atau', 'handphone']","['ganti', 'foto', 'profil', 'susah', 'gagal', 'laptop', 'handphone']",14,7,7,ganti foto profil susah gagal laptop handphone,7,7
"Sebenarnya gak mau saya kasih bintang soalnya di banned mulu padahal tidak ngelanggar apapun, menyusahkan",negatif,2024-08-13,2024,sebenarnya gak mau saya kasih bintang soalnya di banned mulu padahal tidak ngelanggar apapun menyusahkan,15,15,sebenarnya tidak mau saya kasih bintang soalnya di banned mulu padahal tidak ngelanggar apapun menyusahkan,15,15,"['sebenarnya', 'tidak', 'mau', 'saya', 'kasih', 'bintang', 'soalnya', 'di', 'banned', 'mulu', 'padahal', 'tidak', 'ngelanggar', 'apapun', 'menyusahkan']","['tidak', 'kasih', 'bintang', 'banned', 'mulu', 'tidak', 'ngelanggar', 'apapun', 'menyusahkan']",15,9,6,tidak kasih bintang banned mulu tidak ngelanggar apa susah,9,9
Bagus dan tetap terus Update mengikuti perkembangan zaman,positif,2024-07-03,2024,bagus dan tetap terus update mengikuti perkembangan zaman,8,8,bagus dan tetap terus diperbarui mengikuti perkembangan zaman,8,8,"['bagus', 'dan', 'tetap', 'terus', 'diperbarui', 'mengikuti', 'perkembangan', 'zaman']","['bagus', 'diperbarui', 'mengikuti', 'perkembangan', 'zaman']",8,5,3,bagus baru ikut kembang zaman,5,5
"Tolong saya tidak bisa login ke akun linkedin karena perlu verifikasi persona. Namun setalah upload ktp proses verifikasi gagal. Sudah membuat 2 akun namun dua duanya terkena pembatasan akun juga. Mohon bantuannya. Sebelum nya akun saya terkena hack orang hongkong, padahal sebelumnya tidak ada masalah sama sekali. Setelah hapus akun & membuat akun baru masalah pembatasan akun terjadi. Mohon segera di perbaiki",negatif,2024-05-09,2024,tolong saya tidak bisa login ke akun linkedin karena perlu verifikasi persona namun setalah upload ktp proses verifikasi gagal sudah membuat akun namun dua duanya terkena pembatasan akun juga mohon bantuannya sebelum nya akun saya terkena hack orang hongkong padahal sebelumnya tidak ada masalah sama sekali setelah hapus akun membuat akun baru masalah pembatasan akun terjadi mohon segera di perbaiki,62,60,tolong saya tidak bisa login ke akun linkedin karena perlu verifikasi persona namun setalah unggah ktp proses verifikasi gagal sudah membuat akun namun dua duanya terkena pembatasan akun juga mohon bantuannya sebelum nya akun saya terkena hack orang hongkong padahal sebelumnya tidak ada masalah sama sekali setelah hapus akun membuat akun baru masalah pembatasan akun terjadi mohon segera di perbaikan,60,60,"['tolong', 'saya', 'tidak', 'bisa', 'login', 'ke', 'akun', 'linkedin', 'karena', 'perlu', 'verifikasi', 'persona', 'namun', 'setalah', 'unggah', 'ktp', 'proses', 'verifikasi', 'gagal', 'sudah', 'membuat', 'akun', 'namun', 'dua', 'duanya', 'terkena', 'pembatasan', 'akun', 'juga', 'mohon', 'bantuannya', 'sebelum', 'nya', 'akun', 'saya', 'terkena', 'hack', 'orang', 'hongkong', 'padahal', 'sebelumnya', 'tidak', 'ada', 'masalah', 'sama', 'sekali', 'setelah', 'hapus', 'akun', 'membuat', 'akun', 'baru', 'masalah', 'pembatasan', 'akun', 'terjadi', 'mohon', 'segera', 'di', 'perbaikan']","['tolong', 'tidak', 'login', 'akun', 'linkedin', 'verifikasi', 'persona', 'setalah', 'unggah', 'ktp', 'proses', 'verifikasi', 'gagal', 'akun', 'duanya', 'terkena', 'pembatasan', 'akun', 'mohon', 'bantuannya', 'nya', 'akun', 'terkena', 'hack', 'orang', 'hongkong', 'tidak', 'hapus', 'akun', 'akun', 'pembatasan', 'akun', 'mohon', 'perbaikan']",60,34,26,tolong tidak login akun linkedin verifikasi persona seta unggah ktp proses verifikasi gagal akun dua kena batas akun mohon bantu nya akun kena hack orang hongkong tidak hapus akun akun batas akun mohon baik,34,34
Aplikasi mau daftar buat login nya aja susah banget lah males,negatif,2024-06-23,2024,aplikasi mau daftar buat login nya aja susah banget lah males,11,11,aplikasi mau daftar buat login nya saja susah banget lah malas,11,11,"['aplikasi', 'mau', 'daftar', 'buat', 'login', 'nya', 'saja', 'susah', 'banget', 'lah', 'malas']","['aplikasi', 'daftar', 'login', 'nya', 'susah', 'banget', 'malas']",11,7,4,aplikasi daftar login nya susah banget malas,7,7
"Parah banget, baru daftar dan besoknya tidak bisa akses karena ""akses akun dibatasi"", udah verifikasi dgn foto ktp dan isi segala macem data tapi tetap aja gak bisa di akses. Nyesel si daftar linkedIn, mana data pribadi udah disini semua. Apa jangan"" sengaja kali ya ""akses akun dibatasi"" supaya data pribadi bisa dicuri.. Buat yang mau daftar, please pikir 2 kali, masih banyak aplikasi atau website pencari kerja yang gak ribet kaya LinkedIn.",negatif,2024-06-10,2024,parah banget baru daftar dan besoknya tidak bisa akses karena akses akun dibatasi udah verifikasi dgn foto ktp dan isi segala macem data tapi tetap aja gak bisa di akses nyesel si daftar linkedin mana data pribadi udah disini semua apa jangan sengaja kali ya akses akun dibatasi supaya data pribadi bisa dicuri buat yang mau daftar please pikir kali masih banyak aplikasi atau website pencari kerja yang gak ribet kaya linkedin,73,72,parah banget baru daftar dan besoknya tidak bisa akses karena akses akun dibatasi sudah verifikasi dengan foto ktp dan isi segala macem data tapi tetap saja tidak bisa di akses menyesal sih daftar linkedin mana data pribadi sudah disini semua apa jangan sengaja kali ya akses akun dibatasi supaya data pribadi bisa dicuri buat yang mau daftar please pikir kali masih banyak aplikasi atau website pencari kerja yang tidak rumit kayak linkedin,72,72,"['parah', 'banget', 'baru', 'daftar', 'dan', 'besoknya', 'tidak', 'bisa', 'akses', 'karena', 'akses', 'akun', 'dibatasi', 'sudah', 'verifikasi', 'dengan', 'foto', 'ktp', 'dan', 'isi', 'segala', 'macem', 'data', 'tapi', 'tetap', 'saja', 'tidak', 'bisa', 'di', 'akses', 'menyesal', 'sih', 'daftar', 'linkedin', 'mana', 'data', 'pribadi', 'sudah', 'disini', 'semua', 'apa', 'jangan', 'sengaja', 'kali', 'ya', 'akses', 'akun', 'dibatasi', 'supaya', 'data', 'pribadi', 'bisa', 'dicuri', 'buat', 'yang', 'mau', 'daftar', 'please', 'pikir', 'kali', 'masih', 'banyak', 'aplikasi', 'atau', 'website', 'pencari', 'kerja', 'yang', 'tidak', 'rumit', 'kayak', 'linkedin']","['parah', 'banget', 'daftar', 'besoknya', 'tidak', 'akses', 'akses', 'akun', 'dibatasi', 'verifikasi', 'foto', 'ktp', 'isi', 'macem', 'data', 'tidak', 'akses', 'menyesal', 'sih', 'daftar', 'linkedin', 'data', 'pribadi', 'sengaja', 'kali', 'ya', 'akses', 'akun', 'dibatasi', 'data', 'pribadi', 'dicuri', 'daftar', 'please', 'pikir', 'kali', 'aplikasi', 'website', 'pencari', 'kerja', 'tidak', 'rumit', 'kayak', 'linkedin']",72,44,28,parah banget daftar besok tidak akses akses akun batas verifikasi foto ktp isi macem data tidak akses sesal sih daftar linkedin data pribadi sengaja kali ya akses akun batas data pribadi curi daftar please pikir kali aplikasi website cari kerja tidak rumit kayak linkedin,44,44
Saya pernah klik Berlangganan Premium dengan Harga 0 rupiah (gratis). tetapi kenapa pas ada saldo DANA di akun saya terpotong otomatis. tolong pihak Linkedin yg bekerja sama dengan Google kembalikan Saldo DANA saya 654.900,negatif,2024-06-22,2024,saya pernah klik berlangganan premium dengan harga rupiah gratis tetapi kenapa pas ada saldo dana di akun saya terpotong otomatis tolong pihak linkedin yg bekerja sama dengan google kembalikan saldo dana saya,34,32,saya pernah klik berlangganan premium dengan harga rupiah gratis tetapi kenapa pas ada saldo dana di akun saya terpotong otomatis tolong pihak linkedin yang bekerja sama dengan google kembalikan saldo dana saya,32,32,"['saya', 'pernah', 'klik', 'berlangganan', 'premium', 'dengan', 'harga', 'rupiah', 'gratis', 'tetapi', 'kenapa', 'pas', 'ada', 'saldo', 'dana', 'di', 'akun', 'saya', 'terpotong', 'otomatis', 'tolong', 'pihak', 'linkedin', 'yang', 'bekerja', 'sama', 'dengan', 'google', 'kembalikan', 'saldo', 'dana', 'saya']","['klik', 'berlangganan', 'premium', 'harga', 'rupiah', 'gratis', 'pas', 'saldo', 'dana', 'akun', 'terpotong', 'otomatis', 'tolong', 'linkedin', 'google', 'kembalikan', 'saldo', 'dana']",32,18,14,klik langgan premium harga rupiah gratis pas saldo dana akun potong otomatis tolong linkedin google kembali saldo dana,18,18
Kenapa saya tidak bisa login dan Kenapa akun saya di batasi? Ini Sungguh aneh sedang saya tidak pernah merasa melakukan kesalahan ataupun melanggar aturan yang sudah di tetapkan di LinkedIn. Saya menggunakan LinkedIn hanya sebatas mencari pekerjaan dan tidak lebih dari itu. Mohon penjelasannya dari pihak LinkedIn,negatif,2024-06-12,2024,kenapa saya tidak bisa login dan kenapa akun saya di batasi ini sungguh aneh sedang saya tidak pernah merasa melakukan kesalahan ataupun melanggar aturan yang sudah di tetapkan di linkedin saya menggunakan linkedin hanya sebatas mencari pekerjaan dan tidak lebih dari itu mohon penjelasannya dari pihak linkedin,47,47,kenapa saya tidak bisa login dan kenapa akun saya di batasi ini sungguh aneh sedang saya tidak pernah merasa melakukan kesalahan ataupun melanggar aturan yang sudah di tetapkan di linkedin saya menggunakan linkedin hanya sebatas mencari pekerjaan dan tidak lebih dari itu mohon penjelasannya dari pihak linkedin,47,47,"['kenapa', 'saya', 'tidak', 'bisa', 'login', 'dan', 'kenapa', 'akun', 'saya', 'di', 'batasi', 'ini', 'sungguh', 'aneh', 'sedang', 'saya', 'tidak', 'pernah', 'merasa', 'melakukan', 'kesalahan', 'ataupun', 'melanggar', 'aturan', 'yang', 'sudah', 'di', 'tetapkan', 'di', 'linkedin', 'saya', 'menggunakan', 'linkedin', 'hanya', 'sebatas', 'mencari', 'pekerjaan', 'dan', 'tidak', 'lebih', 'dari', 'itu', 'mohon', 'penjelasannya', 'dari', 'pihak', 'linkedin']","['tidak', 'login', 'akun', 'batasi', 'sungguh', 'aneh', 'tidak', 'kesalahan', 'melanggar', 'aturan', 'tetapkan', 'linkedin', 'linkedin', 'sebatas', 'mencari', 'pekerjaan', 'tidak', 'mohon', 'penjelasannya', 'linkedin']",47,20,27,tidak login akun batas sungguh aneh tidak salah langgar atur tetap linkedin linkedin batas cari kerja tidak mohon jelas linkedin,20,20
"Coba akses lagi akun, sudah ada fitur verifikasi KTP. Tapi di coba selalu gagal. Tetap akun dak bisa di akses",negatif,2024-06-12,2024,coba akses lagi akun sudah ada fitur verifikasi ktp tapi di coba selalu gagal tetap akun dak bisa di akses,20,20,coba akses lagi akun sudah ada fitur verifikasi ktp tapi di coba selalu gagal tetap akun tidak bisa di akses,20,20,"['coba', 'akses', 'lagi', 'akun', 'sudah', 'ada', 'fitur', 'verifikasi', 'ktp', 'tapi', 'di', 'coba', 'selalu', 'gagal', 'tetap', 'akun', 'tidak', 'bisa', 'di', 'akses']","['coba', 'akses', 'akun', 'fitur', 'verifikasi', 'ktp', 'coba', 'gagal', 'akun', 'tidak', 'akses']",20,11,9,coba akses akun fitur verifikasi ktp coba gagal akun tidak akses,11,11
"Tidak ada panduan, lalu untuk filter tempat yg diinginkan blm mencapai seluruh bagian terpencil.",negatif,2024-06-05,2024,tidak ada panduan lalu untuk filter tempat yg diinginkan blm mencapai seluruh bagian terpencil,14,14,tidak ada panduan lalu untuk filter tempat yang diinginkan belum mencapai seluruh bagian terpencil,14,14,"['tidak', 'ada', 'panduan', 'lalu', 'untuk', 'filter', 'tempat', 'yang', 'diinginkan', 'belum', 'mencapai', 'seluruh', 'bagian', 'terpencil']","['tidak', 'panduan', 'filter', 'mencapai', 'terpencil']",14,5,9,tidak pandu filter capai pencil,5,5
Bintang satu karena gak bisa tambah email dan gagal waktu klik lamar mudah.,negatif,2024-06-11,2024,bintang satu karena gak bisa tambah email dan gagal waktu klik lamar mudah,13,13,bintang satu karena tidak bisa tambah email dan gagal waktu klik lamar mudah,13,13,"['bintang', 'satu', 'karena', 'tidak', 'bisa', 'tambah', 'email', 'dan', 'gagal', 'waktu', 'klik', 'lamar', 'mudah']","['bintang', 'tidak', 'email', 'gagal', 'klik', 'lamar', 'mudah']",13,7,6,bintang tidak email gagal klik lamar mudah,7,7
"Tiba-tiba akun ke Logout sendiri, terus selalu gagal login katanya sandi salah, akun dibatasi, blablabla shibal",negatif,2024-06-04,2024,tiba tiba akun ke logout sendiri terus selalu gagal login katanya sandi salah akun dibatasi blablabla shibal,16,17,tiba tiba akun ke logout sendiri terus selalu gagal login katanya sandi salah akun dibatasi blablabla shibal,17,17,"['tiba', 'tiba', 'akun', 'ke', 'logout', 'sendiri', 'terus', 'selalu', 'gagal', 'login', 'katanya', 'sandi', 'salah', 'akun', 'dibatasi', 'blablabla', 'shibal']","['akun', 'logout', 'gagal', 'login', 'sandi', 'salah', 'akun', 'dibatasi', 'blablabla', 'shibal']",17,10,7,akun logout gagal login sandi salah akun batas blablabla shibal,10,10
Satu dari sebagian banyak portal info pekerjaan yg ada yg di sertai dengan berbagi info pekerjaan baik dlm negri maupun luar negri beserta dengan informasi yg lengkap baik dari data pelamar maupun yg. Melamar nya. Overall is good.,positif,2024-04-26,2024,satu dari sebagian banyak portal info pekerjaan yg ada yg di sertai dengan berbagi info pekerjaan baik dlm negri maupun luar negri beserta dengan informasi yg lengkap baik dari data pelamar maupun yg melamar nya overall is good,38,38,satu dari sebagian banyak portal informasi pekerjaan yang ada yang di sertai dengan berbagi informasi pekerjaan baik dalam negri maupun luar negri beserta dengan informasi yang lengkap baik dari data pelamar maupun yang melamar nya secara keseluruhan is bagus,38,39,"['satu', 'dari', 'sebagian', 'banyak', 'portal', 'informasi', 'pekerjaan', 'yang', 'ada', 'yang', 'di', 'sertai', 'dengan', 'berbagi', 'informasi', 'pekerjaan', 'baik', 'dalam', 'negri', 'maupun', 'luar', 'negri', 'beserta', 'dengan', 'informasi', 'yang', 'lengkap', 'baik', 'dari', 'data', 'pelamar', 'maupun', 'yang', 'melamar', 'nya', 'secara', 'keseluruhan', 'is', 'bagus']","['portal', 'informasi', 'pekerjaan', 'sertai', 'berbagi', 'informasi', 'pekerjaan', 'negri', 'negri', 'beserta', 'informasi', 'lengkap', 'data', 'pelamar', 'melamar', 'nya', 'is', 'bagus']",39,18,21,portal informasi kerja serta bagi informasi kerja negri negri serta informasi lengkap data lamar lamar nya is bagus,18,18
Pemeriksaan captcha berulangkali sehingga saya tidak bisa login,negatif,2024-07-17,2024,pemeriksaan captcha berulangkali sehingga saya tidak bisa login,8,8,pemeriksaan captcha berulangkali sehingga saya tidak bisa login,8,8,"['pemeriksaan', 'captcha', 'berulangkali', 'sehingga', 'saya', 'tidak', 'bisa', 'login']","['pemeriksaan', 'captcha', 'berulangkali', 'tidak', 'login']",8,5,3,periksa captcha berulangkali tidak login,5,5
"Apk buruk tiba tiba gra² apk ini uang saya tersedot otomatis sebanyak 1 juta dri akun dana saya,mna uang nya itu buat berobat kk saya",negatif,2024-08-05,2024,apk buruk tiba tiba gra² apk ini uang saya tersedot otomatis sebanyak juta dri akun dana saya mna uang nya itu buat berobat kk saya,25,25,aplikasi buruk tiba tiba gra² aplikasi ini uang saya tersedot otomatis sebanyak juta dari akun dana saya mana uang nya itu buat berobat kakak saya,25,25,"['aplikasi', 'buruk', 'tiba', 'tiba', 'gra²', 'aplikasi', 'ini', 'uang', 'saya', 'tersedot', 'otomatis', 'sebanyak', 'juta', 'dari', 'akun', 'dana', 'saya', 'mana', 'uang', 'nya', 'itu', 'buat', 'berobat', 'kakak', 'saya']","['aplikasi', 'buruk', 'gra²', 'aplikasi', 'uang', 'tersedot', 'otomatis', 'juta', 'akun', 'dana', 'uang', 'nya', 'berobat', 'kakak']",25,14,11,aplikasi buruk gra aplikasi uang sedot otomatis juta akun dana uang nya obat kakak,14,14
"Indriver Sangat membantu untuk kebutuhan sehari hari , terima kasih 🙏🙏👍",positif,2024-08-07,2024,indriver sangat membantu untuk kebutuhan sehari hari terima kasih,11,9,indriver sangat membantu untuk kebutuhan sehari hari terima kasih,9,9,"['indriver', 'sangat', 'membantu', 'untuk', 'kebutuhan', 'sehari', 'hari', 'terima', 'kasih']","['indriver', 'membantu', 'kebutuhan', 'sehari', 'terima', 'kasih']",9,6,3,indriver bantu butuh hari terima kasih,6,6
Ok sip lumayan buat curhatan juga sering per mantan karyawan risgn tanpa buku aslinya mohon maaf sebelumnya saya mussai japang timur,positif,2024-08-07,2024,ok sip lumayan buat curhatan juga sering per mantan karyawan risgn tanpa buku aslinya mohon maaf sebelumnya saya mussai japang timur,21,21,oke sip lumayan buat curhatan juga sering per mantan karyawan risgn tanpa buku aslinya mohon maaf sebelumnya saya mussai japang timur,21,21,"['oke', 'sip', 'lumayan', 'buat', 'curhatan', 'juga', 'sering', 'per', 'mantan', 'karyawan', 'risgn', 'tanpa', 'buku', 'aslinya', 'mohon', 'maaf', 'sebelumnya', 'saya', 'mussai', 'japang', 'timur']","['oke', 'sip', 'lumayan', 'curhatan', 'mantan', 'karyawan', 'risgn', 'buku', 'aslinya', 'mohon', 'maaf', 'mussai', 'japang', 'timur']",21,14,7,oke sip lumayan curhatan mantan karyawan risgn buku asli mohon maaf mussai japang timur,14,14
"Di minta verifikasi ga jelas bangeettt, apk👎👎👎 jelek bangetttt, mau tutup akunpun susah bangett, gajelas pokonyaa",negatif,2024-08-08,2024,di minta verifikasi ga jelas bangeettt apk jelek bangetttt mau tutup akunpun susah bangett gajelas pokonyaa,16,16,di minta verifikasi tidak jelas bangeettt aplikasi jelek bangetttt mau tutup akunpun susah banget tidak jelas pokoknya,16,17,"['di', 'minta', 'verifikasi', 'tidak', 'jelas', 'bangeettt', 'aplikasi', 'jelek', 'bangetttt', 'mau', 'tutup', 'akunpun', 'susah', 'banget', 'tidak', 'jelas', 'pokoknya']","['verifikasi', 'tidak', 'bangeettt', 'aplikasi', 'jelek', 'bangetttt', 'tutup', 'akunpun', 'susah', 'banget', 'tidak', 'pokoknya']",17,12,5,verifikasi tidak bangeettt aplikasi jelek bangetttt tutup akun susah banget tidak pokok,12,12
Baru mencoba.. cari kerja tapi blm ada masukan dr teman Linkedln Semoga ada info lowongan pekerjaan secepatnya,positif,2024-06-17,2024,baru mencoba cari kerja tapi blm ada masukan dr teman linkedln semoga ada info lowongan pekerjaan secepatnya,17,17,baru mencoba cari kerja tapi belum ada masukan dari teman linkedln semoga ada informasi lowongan pekerjaan secepatnya,17,17,"['baru', 'mencoba', 'cari', 'kerja', 'tapi', 'belum', 'ada', 'masukan', 'dari', 'teman', 'linkedln', 'semoga', 'ada', 'informasi', 'lowongan', 'pekerjaan', 'secepatnya']","['mencoba', 'cari', 'kerja', 'masukan', 'teman', 'linkedln', 'semoga', 'informasi', 'lowongan', 'pekerjaan', 'secepatnya']",17,11,6,coba cari kerja masuk teman linkedln moga informasi lowong kerja cepat,11,11
sangat di butuhkan dalam mencari pekerjaan tentang informasi lowongan kerja.,positif,2024-07-26,2024,sangat di butuhkan dalam mencari pekerjaan tentang informasi lowongan kerja,10,10,sangat di butuhkan dalam mencari pekerjaan tentang informasi lowongan kerja,10,10,"['sangat', 'di', 'butuhkan', 'dalam', 'mencari', 'pekerjaan', 'tentang', 'informasi', 'lowongan', 'kerja']","['butuhkan', 'mencari', 'pekerjaan', 'informasi', 'lowongan', 'kerja']",10,6,4,butuh cari kerja informasi lowong kerja,6,6
"Ini ke 5 kali saya instal ulang dan bermasalah di login ,cuma bisa digunakan lewat browser Edge saja, banyak data yang hilang karena tidak bisa akses aplikasi. Padahal menurut saya ini salah satu Aplikasi terbaik dalam pengembangan bisnis dan jaringan. Bukan aplikasi murahan dalam interaksi nya. Please perbaiki secepatnya dong admin.",negatif,2024-02-02,2024,ini ke kali saya instal ulang dan bermasalah di login cuma bisa digunakan lewat browser edge saja banyak data yang hilang karena tidak bisa akses aplikasi padahal menurut saya ini salah satu aplikasi terbaik dalam pengembangan bisnis dan jaringan bukan aplikasi murahan dalam interaksi nya please perbaiki secepatnya dong admin,51,50,ini ke kali saya memasang ulang dan bermasalah di login cuma bisa digunakan lewat browser edge saja banyak data yang hilang karena tidak bisa akses aplikasi padahal menurut saya ini salah satu aplikasi terbaik dalam pengembangan bisnis dan jaringan bukan aplikasi murahan dalam interaksi nya please perbaikan secepatnya dong admin,50,50,"['ini', 'ke', 'kali', 'saya', 'memasang', 'ulang', 'dan', 'bermasalah', 'di', 'login', 'cuma', 'bisa', 'digunakan', 'lewat', 'browser', 'edge', 'saja', 'banyak', 'data', 'yang', 'hilang', 'karena', 'tidak', 'bisa', 'akses', 'aplikasi', 'padahal', 'menurut', 'saya', 'ini', 'salah', 'satu', 'aplikasi', 'terbaik', 'dalam', 'pengembangan', 'bisnis', 'dan', 'jaringan', 'bukan', 'aplikasi', 'murahan', 'dalam', 'interaksi', 'nya', 'please', 'perbaikan', 'secepatnya', 'dong', 'admin']","['kali', 'memasang', 'ulang', 'bermasalah', 'login', 'browser', 'edge', 'data', 'hilang', 'tidak', 'akses', 'aplikasi', 'salah', 'aplikasi', 'terbaik', 'pengembangan', 'bisnis', 'jaringan', 'aplikasi', 'murahan', 'interaksi', 'nya', 'please', 'perbaikan', 'secepatnya', 'admin']",50,26,24,kali pasang ulang masalah login browser edge data hilang tidak akses aplikasi salah aplikasi baik kembang bisnis jaring aplikasi murah interaksi nya please baik cepat admin,26,26
Tolong diperbaiki untuk sistem login lewat google tidak bisa.,negatif,2024-07-04,2024,tolong diperbaiki untuk sistem login lewat google tidak bisa,9,9,tolong di perbaiki untuk sistem login lewat google tidak bisa,9,10,"['tolong', 'di', 'perbaiki', 'untuk', 'sistem', 'login', 'lewat', 'google', 'tidak', 'bisa']","['tolong', 'perbaiki', 'sistem', 'login', 'google', 'tidak']",10,6,4,tolong baik sistem login google tidak,6,6
susah bgt loginnya minta kode ga muncul nebak gambar pas akhir salah mulu pdhl jawaban sebelumnya bener,negatif,2024-07-08,2024,susah bgt loginnya minta kode ga muncul nebak gambar pas akhir salah mulu pdhl jawaban sebelumnya bener,17,17,susah banget loginnya minta kode tidak muncul nebak gambar pas akhir salah mulu padahal jawaban sebelumnya benar,17,17,"['susah', 'banget', 'loginnya', 'minta', 'kode', 'tidak', 'muncul', 'nebak', 'gambar', 'pas', 'akhir', 'salah', 'mulu', 'padahal', 'jawaban', 'sebelumnya', 'benar']","['susah', 'banget', 'loginnya', 'kode', 'tidak', 'muncul', 'nebak', 'gambar', 'pas', 'salah', 'mulu']",17,11,6,susah banget loginnya kode tidak muncul nebak gambar pas salah mulu,11,11
Untuk login dan koneksi ribet,negatif,2024-07-04,2024,untuk login dan koneksi ribet,5,5,untuk login dan koneksi rumit,5,5,"['untuk', 'login', 'dan', 'koneksi', 'rumit']","['login', 'koneksi', 'rumit']",5,3,2,login koneksi rumit,3,3
Sangat bagus untuk pengembangan pribadi dalam berbagai aspek dunia usaha,positif,2024-07-18,2024,sangat bagus untuk pengembangan pribadi dalam berbagai aspek dunia usaha,10,10,sangat bagus untuk pengembangan pribadi dalam berbagai aspek dunia usaha,10,10,"['sangat', 'bagus', 'untuk', 'pengembangan', 'pribadi', 'dalam', 'berbagai', 'aspek', 'dunia', 'usaha']","['bagus', 'pengembangan', 'pribadi', 'aspek', 'dunia', 'usaha']",10,6,4,bagus kembang pribadi aspek dunia usaha,6,6
Di sini kita bertemu dengan banyak orang hebat.. bisa banyak belajar dari Beliau. Dapat menemukan banyak peluang kerja dr berbagai bidang..,positif,2024-07-06,2024,di sini kita bertemu dengan banyak orang hebat bisa banyak belajar dari beliau dapat menemukan banyak peluang kerja dr berbagai bidang,21,21,di sini kita bertemu dengan banyak orang hebat bisa banyak belajar dari beliau dapat menemukan banyak peluang kerja dari berbagai bidang,21,21,"['di', 'sini', 'kita', 'bertemu', 'dengan', 'banyak', 'orang', 'hebat', 'bisa', 'banyak', 'belajar', 'dari', 'beliau', 'dapat', 'menemukan', 'banyak', 'peluang', 'kerja', 'dari', 'berbagai', 'bidang']","['bertemu', 'orang', 'hebat', 'belajar', 'beliau', 'menemukan', 'peluang', 'kerja', 'bidang']",21,9,12,temu orang hebat ajar beliau temu peluang kerja bidang,9,9
Kecewa karna tiba2 akun saya dibatasin. Padahal penting linked saya buat lamar kerja. Ini gimana si? Tolong diperbaiki.,negatif,2024-07-14,2024,kecewa karna tiba akun saya dibatasin padahal penting linked saya buat lamar kerja ini gimana si tolong diperbaiki,18,18,kecewa karena tiba akun saya dibatasin padahal penting linked saya buat lamar kerja ini bagaimana sih tolong di perbaiki,18,19,"['kecewa', 'karena', 'tiba', 'akun', 'saya', 'dibatasin', 'padahal', 'penting', 'linked', 'saya', 'buat', 'lamar', 'kerja', 'ini', 'bagaimana', 'sih', 'tolong', 'di', 'perbaiki']","['kecewa', 'akun', 'dibatasin', 'linked', 'lamar', 'kerja', 'sih', 'tolong', 'perbaiki']",19,9,10,kecewa akun dibatasin linked lamar kerja sih tolong baik,9,9
"Gak jelas, capek2 bikin akun. Setting sana sini. Tiba2 di batasi tanpa alasan yg jelas. Ajukan banding di tolak. Aneh.",negatif,2024-07-01,2024,gak jelas capek bikin akun setting sana sini tiba di batasi tanpa alasan yg jelas ajukan banding di tolak aneh,20,20,tidak jelas capek bikin akun setting sana sini tiba di batasi tanpa alasan yang jelas ajukan banding di tolak aneh,20,20,"['tidak', 'jelas', 'capek', 'bikin', 'akun', 'setting', 'sana', 'sini', 'tiba', 'di', 'batasi', 'tanpa', 'alasan', 'yang', 'jelas', 'ajukan', 'banding', 'di', 'tolak', 'aneh']","['tidak', 'capek', 'bikin', 'akun', 'setting', 'batasi', 'alasan', 'ajukan', 'banding', 'tolak', 'aneh']",20,11,9,tidak capek bikin akun setting batas alas aju banding tolak aneh,11,11
Sangat berguna bagi pencari kerja tetapi sdh mulai dikotori dg berita-berita politik,positif,2024-06-21,2024,sangat berguna bagi pencari kerja tetapi sdh mulai dikotori dg berita berita politik,12,13,sangat berguna bagi pencari kerja tetapi sudah mulai dikotori dengan berita berita politik,13,13,"['sangat', 'berguna', 'bagi', 'pencari', 'kerja', 'tetapi', 'sudah', 'mulai', 'dikotori', 'dengan', 'berita', 'berita', 'politik']","['berguna', 'pencari', 'kerja', 'dikotori', 'berita', 'berita', 'politik']",13,7,6,guna cari kerja kotor berita berita politik,7,7
"mau masuk juga susah, uninstall deh kesel",negatif,2024-06-28,2024,mau masuk juga susah uninstall deh kesel,7,7,mau masuk juga susah uninstall deh kesel,7,7,"['mau', 'masuk', 'juga', 'susah', 'uninstall', 'deh', 'kesel']","['masuk', 'susah', 'uninstall', 'deh', 'kesel']",7,5,2,masuk susah uninstall deh kesel,5,5
Mau nambah keahlian ga bisa². Dikit² terjadi kesalahan,negatif,2024-07-01,2024,mau nambah keahlian ga bisa² dikit² terjadi kesalahan,8,8,mau nambah keahlian tidak bisa² dikit² terjadi kesalahan,8,8,"['mau', 'nambah', 'keahlian', 'tidak', 'bisa²', 'dikit²', 'terjadi', 'kesalahan']","['nambah', 'keahlian', 'tidak', 'bisa²', 'dikit²', 'kesalahan']",8,6,2,nambah ahli tidak bisa dikit salah,6,6
"Menambah wawasan dunia kerja, dan menambah relasi",positif,2024-06-15,2024,menambah wawasan dunia kerja dan menambah relasi,7,7,menambah wawasan dunia kerja dan menambah relasi,7,7,"['menambah', 'wawasan', 'dunia', 'kerja', 'dan', 'menambah', 'relasi']","['menambah', 'wawasan', 'dunia', 'kerja', 'menambah', 'relasi']",7,6,1,tambah wawas dunia kerja tambah relasi,6,6
Pengalamannya...kurang berhasil dulu...semoga kali ini berhasil....,positif,2024-06-18,2024,pengalamannya kurang berhasil dulu semoga kali ini berhasil,6,8,pengalamannya kurang berhasil dahulu semoga kali ini berhasil,8,8,"['pengalamannya', 'kurang', 'berhasil', 'dahulu', 'semoga', 'kali', 'ini', 'berhasil']","['pengalamannya', 'berhasil', 'semoga', 'kali', 'berhasil']",8,5,3,alam hasil moga kali hasil,5,5
"Apk ga guna sialan, buat yang nyari kerja di Keama dimulai dengan memaha veloper mengumpulkan apk ini jgn asal2an daftarin akun google a dapat kalian yang udh ketaut sama akun google Developer membe informasi ini dan dapat memp nya dana atau apk bank lainnya, kalo kalian salah daftarin saldo dana kalian bakalan di ambil sama yang bikin apk brengsek ini, cari kerja bikin apk Kya gini malah seenaknya ambil duit orang tanpa ijin sampe kena 1jt namanya pemerasan itu.",negatif,2024-07-05,2024,apk ga guna sialan buat yang nyari kerja di keama dimulai dengan memaha veloper mengumpulkan apk ini jgn asal an daftarin akun google a dapat kalian yang udh ketaut sama akun google developer membe informasi ini dan dapat memp nya dana atau apk bank lainnya kalo kalian salah daftarin saldo dana kalian bakalan di ambil sama yang bikin apk brengsek ini cari kerja bikin apk kya gini malah seenaknya ambil duit orang tanpa ijin sampe kena jt namanya pemerasan itu,79,80,aplikasi tidak guna sialan buat yang mencari kerja di keama dimulai dengan memaha veloper mengumpulkan aplikasi ini jangan asal an daftarin akun google a dapat kalian yang sudah ketaut sama akun google developer membe informasi ini dan dapat memp nya dana atau aplikasi bank lainnya kalau kalian salah daftarin saldo dana kalian bakalan di ambil sama yang bikin aplikasi brengsek ini cari kerja bikin aplikasi kya begini bahkan seenaknya ambil uang orang tanpa ijin sampai kena jt namanya pemerasan itu,80,80,"['aplikasi', 'tidak', 'guna', 'sialan', 'buat', 'yang', 'mencari', 'kerja', 'di', 'keama', 'dimulai', 'dengan', 'memaha', 'veloper', 'mengumpulkan', 'aplikasi', 'ini', 'jangan', 'asal', 'an', 'daftarin', 'akun', 'google', 'a', 'dapat', 'kalian', 'yang', 'sudah', 'ketaut', 'sama', 'akun', 'google', 'developer', 'membe', 'informasi', 'ini', 'dan', 'dapat', 'memp', 'nya', 'dana', 'atau', 'aplikasi', 'bank', 'lainnya', 'kalau', 'kalian', 'salah', 'daftarin', 'saldo', 'dana', 'kalian', 'bakalan', 'di', 'ambil', 'sama', 'yang', 'bikin', 'aplikasi', 'brengsek', 'ini', 'cari', 'kerja', 'bikin', 'aplikasi', 'kya', 'begini', 'bahkan', 'seenaknya', 'ambil', 'uang', 'orang', 'tanpa', 'ijin', 'sampai', 'kena', 'jt', 'namanya', 'pemerasan', 'itu']","['aplikasi', 'tidak', 'sialan', 'mencari', 'kerja', 'keama', 'memaha', 'veloper', 'mengumpulkan', 'aplikasi', 'an', 'daftarin', 'akun', 'google', 'a', 'ketaut', 'akun', 'google', 'developer', 'membe', 'informasi', 'memp', 'nya', 'dana', 'aplikasi', 'bank', 'salah', 'daftarin', 'saldo', 'dana', 'ambil', 'bikin', 'aplikasi', 'brengsek', 'cari', 'kerja', 'bikin', 'aplikasi', 'kya', 'ambil', 'uang', 'orang', 'ijin', 'kena', 'jt', 'namanya', 'pemerasan']",80,47,33,aplikasi tidak sial cari kerja ama maha veloper kumpul aplikasi an daftarin akun google a taut akun google developer membe informasi memp nya dana aplikasi bank salah daftarin saldo dana ambil bikin aplikasi brengsek cari kerja bikin aplikasi kya ambil uang orang ijin kena jt nama peras,47,47
Cara verifikasi nya macam game ngga guna yang susah banget.. asli.. parah sih,negatif,2024-07-26,2024,cara verifikasi nya macam game ngga guna yang susah banget asli parah sih,13,13,cara verifikasi nya macam game tidak guna yang susah banget asli parah sih,13,13,"['cara', 'verifikasi', 'nya', 'macam', 'game', 'tidak', 'guna', 'yang', 'susah', 'banget', 'asli', 'parah', 'sih']","['verifikasi', 'nya', 'game', 'tidak', 'susah', 'banget', 'asli', 'parah', 'sih']",13,9,4,verifikasi nya game tidak susah banget asli parah sih,9,9
Tiba2 akun lama hilang login pakai email lama harus verikasi lagi,negatif,2024-07-03,2024,tiba akun lama hilang login pakai email lama harus verikasi lagi,11,11,tiba akun lama hilang login pakai email lama harus verikasi lagi,11,11,"['tiba', 'akun', 'lama', 'hilang', 'login', 'pakai', 'email', 'lama', 'harus', 'verikasi', 'lagi']","['akun', 'hilang', 'login', 'pakai', 'email', 'verikasi']",11,6,5,akun hilang login pakai email verikasi,6,6
"Ditambahin fitur foto ngga bisa di ss atau download min, kasian yang jadi korban ss atau download buat nipu orang di telegram",negatif,2024-08-18,2024,ditambahin fitur foto ngga bisa di ss atau download min kasian yang jadi korban ss atau download buat nipu orang di telegram,22,22,di tambah in fitur foto tidak bisa di ss atau unduh minimal kasian yang jadi korban ss atau unduh buat tipu orang di telegram,22,24,"['di', 'tambah', 'in', 'fitur', 'foto', 'tidak', 'bisa', 'di', 'ss', 'atau', 'unduh', 'minimal', 'kasian', 'yang', 'jadi', 'korban', 'ss', 'atau', 'unduh', 'buat', 'tipu', 'orang', 'di', 'telegram']","['in', 'fitur', 'foto', 'tidak', 'ss', 'unduh', 'minimal', 'kasian', 'korban', 'ss', 'unduh', 'tipu', 'orang', 'telegram']",24,14,10,in fitur foto tidak ss unduh minimal kasi korban ss unduh tipu orang telegram,14,14
Kak tolong di perbaiki di verifikasi capcha nya tidak valid terus. Sudah tebak gambar sampai berkali kali pun tetap tidak bisa padahal jawaban sudah centang benar. Jadinya tidak bisa login,negatif,2024-08-26,2024,kak tolong di perbaiki di verifikasi capcha nya tidak valid terus sudah tebak gambar sampai berkali kali pun tetap tidak bisa padahal jawaban sudah centang benar jadinya tidak bisa login,30,30,kak tolong di perbaikan di verifikasi capcha nya tidak valid terus sudah tebak gambar sampai berkali kali pun tetap tidak bisa padahal jawaban sudah centang benar jadinya tidak bisa login,30,30,"['kak', 'tolong', 'di', 'perbaikan', 'di', 'verifikasi', 'capcha', 'nya', 'tidak', 'valid', 'terus', 'sudah', 'tebak', 'gambar', 'sampai', 'berkali', 'kali', 'pun', 'tetap', 'tidak', 'bisa', 'padahal', 'jawaban', 'sudah', 'centang', 'benar', 'jadinya', 'tidak', 'bisa', 'login']","['kak', 'tolong', 'perbaikan', 'verifikasi', 'capcha', 'nya', 'tidak', 'valid', 'tebak', 'gambar', 'berkali', 'kali', 'tidak', 'centang', 'tidak', 'login']",30,16,14,kak tolong baik verifikasi capcha nya tidak valid tebak gambar kali kali tidak centang tidak login,16,16
"Aplikasi yang sangat membantu dalam mencari kerja, dan sudah 2x dapat pekerjaan dengan lingkungan sekaligus salary yang kompetitif dari LinkedIn.",positif,2024-05-02,2024,aplikasi yang sangat membantu dalam mencari kerja dan sudah x dapat pekerjaan dengan lingkungan sekaligus salary yang kompetitif dari linkedin,20,20,aplikasi yang sangat membantu dalam mencari kerja dan sudah x dapat pekerjaan dengan lingkungan sekaligus salary yang kompetitif dari linkedin,20,20,"['aplikasi', 'yang', 'sangat', 'membantu', 'dalam', 'mencari', 'kerja', 'dan', 'sudah', 'x', 'dapat', 'pekerjaan', 'dengan', 'lingkungan', 'sekaligus', 'salary', 'yang', 'kompetitif', 'dari', 'linkedin']","['aplikasi', 'membantu', 'mencari', 'kerja', 'x', 'pekerjaan', 'lingkungan', 'salary', 'kompetitif', 'linkedin']",20,10,10,aplikasi bantu cari kerja x kerja lingkung salary kompetitif linkedin,10,10
"Apa-apaan ini, verifikasi gambar tidak jelas! Seakan saya bukan pemilik akun tersebut seluruh verifikasi dipersulit! KENAPA TIDAK PAKAI OTP GOOGLE?! nyuruh kami registrasi email itu fungsinya buat apa? Login pakai Gmail juga tidak bisa! Nyuruh saya buang akun atau gimana? Untuk recovery password juga tidak bisa 🖕🏻. Kesel banget liatnya, si paling ""PERLINDUNGAN PENGGUNA""",negatif,2024-08-08,2024,apa apaan ini verifikasi gambar tidak jelas seakan saya bukan pemilik akun tersebut seluruh verifikasi dipersulit kenapa tidak pakai otp google nyuruh kami registrasi email itu fungsinya buat apa login pakai gmail juga tidak bisa nyuruh saya buang akun atau gimana untuk recovery password juga tidak bisa kesel banget liatnya si paling perlindungan pengguna,54,54,apa apa ini verifikasi gambar tidak jelas seakan saya bukan pemilik akun tersebut seluruh verifikasi dipersulit kenapa tidak pakai one time password google nyuruh kami registrasi email itu fungsinya buat apa login pakai gmail juga tidak bisa nyuruh saya buang akun atau bagaimana untuk recovery password juga tidak bisa kesel banget liatnya sih paling perlindungan pengguna,54,56,"['apa', 'apa', 'ini', 'verifikasi', 'gambar', 'tidak', 'jelas', 'seakan', 'saya', 'bukan', 'pemilik', 'akun', 'tersebut', 'seluruh', 'verifikasi', 'dipersulit', 'kenapa', 'tidak', 'pakai', 'one', 'time', 'password', 'google', 'nyuruh', 'kami', 'registrasi', 'email', 'itu', 'fungsinya', 'buat', 'apa', 'login', 'pakai', 'gmail', 'juga', 'tidak', 'bisa', 'nyuruh', 'saya', 'buang', 'akun', 'atau', 'bagaimana', 'untuk', 'recovery', 'password', 'juga', 'tidak', 'bisa', 'kesel', 'banget', 'liatnya', 'sih', 'paling', 'perlindungan', 'pengguna']","['verifikasi', 'gambar', 'tidak', 'seakan', 'pemilik', 'akun', 'verifikasi', 'dipersulit', 'tidak', 'pakai', 'one', 'time', 'password', 'google', 'nyuruh', 'registrasi', 'email', 'fungsinya', 'login', 'pakai', 'gmail', 'tidak', 'nyuruh', 'buang', 'akun', 'recovery', 'password', 'tidak', 'kesel', 'banget', 'liatnya', 'sih', 'perlindungan', 'pengguna']",56,34,22,verifikasi gambar tidak akan milik akun verifikasi sulit tidak pakai one time password google nyuruh registrasi email fungsi login pakai gmail tidak nyuruh buang akun recovery password tidak kesel banget liat sih lindung guna,34,34
"tidak bisa menggunakan nomor sendiri karena sempat beberapa kali salah kode, udah ngisi sesuai padahal, dari sananya dikirim pake ada kode titik nya jadi bingung",negatif,2024-08-10,2024,tidak bisa menggunakan nomor sendiri karena sempat beberapa kali salah kode udah ngisi sesuai padahal dari sananya dikirim pake ada kode titik nya jadi bingung,25,25,tidak bisa menggunakan nomor sendiri karena sempat beberapa kali salah kode sudah mengisi sesuai padahal dari sananya dikirim pakai ada kode titik nya jadi bingung,25,25,"['tidak', 'bisa', 'menggunakan', 'nomor', 'sendiri', 'karena', 'sempat', 'beberapa', 'kali', 'salah', 'kode', 'sudah', 'mengisi', 'sesuai', 'padahal', 'dari', 'sananya', 'dikirim', 'pakai', 'ada', 'kode', 'titik', 'nya', 'jadi', 'bingung']","['tidak', 'nomor', 'kali', 'salah', 'kode', 'mengisi', 'sesuai', 'sananya', 'dikirim', 'pakai', 'kode', 'titik', 'nya', 'bingung']",25,14,11,tidak nomor kali salah kode isi sesuai sana kirim pakai kode titik nya bingung,14,14
"Sistem keamanan lemah,gk pernah login udh 3 bulan lbh tp tiba tiba ada notifikasi login,ganti password, menambahkan email. Email customer service nya mana ini,kalo tidak ad tindakan bantuan menghapus email pelaku,saya gk akan rubah rating.",negatif,2024-04-28,2024,sistem keamanan lemah gk pernah login udh bulan lbh tp tiba tiba ada notifikasi login ganti password menambahkan email email customer service nya mana ini kalo tidak ad tindakan bantuan menghapus email pelaku saya gk akan rubah rating,35,38,sistem keamanan lemah tidak pernah login sudah bulan lebih tapi tiba tiba ada notifikasi login ganti password menambahkan email email pelanggan pelayanan nya mana ini kalau tidak ada tindakan bantuan menghapus email pelaku saya tidak akan rubah rating,38,38,"['sistem', 'keamanan', 'lemah', 'tidak', 'pernah', 'login', 'sudah', 'bulan', 'lebih', 'tapi', 'tiba', 'tiba', 'ada', 'notifikasi', 'login', 'ganti', 'password', 'menambahkan', 'email', 'email', 'pelanggan', 'pelayanan', 'nya', 'mana', 'ini', 'kalau', 'tidak', 'ada', 'tindakan', 'bantuan', 'menghapus', 'email', 'pelaku', 'saya', 'tidak', 'akan', 'rubah', 'rating']","['sistem', 'keamanan', 'lemah', 'tidak', 'login', 'notifikasi', 'login', 'ganti', 'password', 'email', 'email', 'pelanggan', 'pelayanan', 'nya', 'tidak', 'tindakan', 'bantuan', 'menghapus', 'email', 'pelaku', 'tidak', 'rubah', 'rating']",38,23,15,sistem aman lemah tidak login notifikasi login ganti password email email langgan layan nya tidak tindak bantu hapus email laku tidak rubah rating,23,23
Sangat membantu buat perkembangan,positif,2024-08-12,2024,sangat membantu buat perkembangan,4,4,sangat membantu buat perkembangan,4,4,"['sangat', 'membantu', 'buat', 'perkembangan']","['membantu', 'perkembangan']",4,2,2,bantu kembang,2,2
"gabisa loginnn harus verifikasi dulu pake gambar tapi tetep gabisa. terus langganan nya mahal banget 🫠🫠🫠. tolong ini kenapa yaaa linked ko gabisa login, eror tah?",negatif,2024-04-13,2024,gabisa loginnn harus verifikasi dulu pake gambar tapi tetep gabisa terus langganan nya mahal banget tolong ini kenapa yaaa linked ko gabisa login eror tah,26,25,tidak bisa loginnn harus verifikasi dahulu pakai gambar tapi tetap tidak bisa terus langganan nya mahal banget tolong ini kenapa yaaa linked kok tidak bisa login error tah,25,28,"['tidak', 'bisa', 'loginnn', 'harus', 'verifikasi', 'dahulu', 'pakai', 'gambar', 'tapi', 'tetap', 'tidak', 'bisa', 'terus', 'langganan', 'nya', 'mahal', 'banget', 'tolong', 'ini', 'kenapa', 'yaaa', 'linked', 'kok', 'tidak', 'bisa', 'login', 'error', 'tah']","['tidak', 'loginnn', 'verifikasi', 'pakai', 'gambar', 'tidak', 'langganan', 'nya', 'mahal', 'banget', 'tolong', 'yaaa', 'linked', 'tidak', 'login', 'error', 'tah']",28,17,11,tidak loginnn verifikasi pakai gambar tidak langgan nya mahal banget tolong yaaa linked tidak login error tah,17,17
"Jujur, saya sangat kecewa menggunakan aplikasi ini. Akun saya bisa dibobol oleh orang lain sehingga data pribadi saya bocor. Data verifikasi gak jelas. Nama saya di ubah menjadi Isabelle. Ini membuktikan bahwa akun saya sudah dibobol orang lain. Dulu aplikasi ini sangat bagus sekarang jadi sampah.",negatif,2024-04-13,2024,jujur saya sangat kecewa menggunakan aplikasi ini akun saya bisa dibobol oleh orang lain sehingga data pribadi saya bocor data verifikasi gak jelas nama saya di ubah menjadi isabelle ini membuktikan bahwa akun saya sudah dibobol orang lain dulu aplikasi ini sangat bagus sekarang jadi sampah,46,46,jujur saya sangat kecewa menggunakan aplikasi ini akun saya bisa dibobol oleh orang lain sehingga data pribadi saya bocor data verifikasi tidak jelas nama saya di ubah menjadi isabelle ini membuktikan bahwa akun saya sudah dibobol orang lain dahulu aplikasi ini sangat bagus sekarang jadi sampah,46,46,"['jujur', 'saya', 'sangat', 'kecewa', 'menggunakan', 'aplikasi', 'ini', 'akun', 'saya', 'bisa', 'dibobol', 'oleh', 'orang', 'lain', 'sehingga', 'data', 'pribadi', 'saya', 'bocor', 'data', 'verifikasi', 'tidak', 'jelas', 'nama', 'saya', 'di', 'ubah', 'menjadi', 'isabelle', 'ini', 'membuktikan', 'bahwa', 'akun', 'saya', 'sudah', 'dibobol', 'orang', 'lain', 'dahulu', 'aplikasi', 'ini', 'sangat', 'bagus', 'sekarang', 'jadi', 'sampah']","['jujur', 'kecewa', 'aplikasi', 'akun', 'dibobol', 'orang', 'data', 'pribadi', 'bocor', 'data', 'verifikasi', 'tidak', 'nama', 'ubah', 'isabelle', 'membuktikan', 'akun', 'dibobol', 'orang', 'aplikasi', 'bagus', 'sampah']",46,22,24,jujur kecewa aplikasi akun bobol orang data pribadi bocor data verifikasi tidak nama ubah isabelle bukti akun bobol orang aplikasi bagus sampah,22,22
"Tolong apapun itu alasannya, entah untuk keamanan akun, terkait login ke akun LinkedIn agar di perbaiki masa iya berkali kali mengikuti instruksi keamanan akun, tapi responnya selalu ""RESPON KODE NO CAPTCHA ANDA TIDAK VALID ATAU BELUM DI ISI"" dah berkali-kali saya, hapus data, hapus aplikasi ulang lagi ga ada kemajuan sama sekali cuman buat login, aneh soalnya login di Website aman-aman aja langsung masuk, ini mau berkali kali pun seenggaknya masuk, malah ga masuk sama sekali. TOLONG LA PERBAIKI",negatif,2023-08-31,2023,tolong apapun itu alasannya entah untuk keamanan akun terkait login ke akun linkedin agar di perbaiki masa iya berkali kali mengikuti instruksi keamanan akun tapi responnya selalu respon kode no captcha anda tidak valid atau belum di isi dah berkali kali saya hapus data hapus aplikasi ulang lagi ga ada kemajuan sama sekali cuman buat login aneh soalnya login di website aman aman aja langsung masuk ini mau berkali kali pun seenggaknya masuk malah ga masuk sama sekali tolong la perbaiki,79,81,tolong apapun itu alasannya entah untuk keamanan akun terkait login ke akun linkedin agar di perbaikan masa iya berkali kali mengikuti instruksi keamanan akun tapi responsnya selalu respons kode nomor captcha anda tidak valid atau belum di isi sudah berkali kali saya hapus data hapus aplikasi ulang lagi tidak ada kemajuan sama sekali cuman buat login aneh soalnya login di website aman aman saja langsung masuk ini mau berkali kali pun seenggaknya masuk bahkan tidak masuk sama sekali tolong lah perbaikan,81,81,"['tolong', 'apapun', 'itu', 'alasannya', 'entah', 'untuk', 'keamanan', 'akun', 'terkait', 'login', 'ke', 'akun', 'linkedin', 'agar', 'di', 'perbaikan', 'masa', 'iya', 'berkali', 'kali', 'mengikuti', 'instruksi', 'keamanan', 'akun', 'tapi', 'responsnya', 'selalu', 'respons', 'kode', 'nomor', 'captcha', 'anda', 'tidak', 'valid', 'atau', 'belum', 'di', 'isi', 'sudah', 'berkali', 'kali', 'saya', 'hapus', 'data', 'hapus', 'aplikasi', 'ulang', 'lagi', 'tidak', 'ada', 'kemajuan', 'sama', 'sekali', 'cuman', 'buat', 'login', 'aneh', 'soalnya', 'login', 'di', 'website', 'aman', 'aman', 'saja', 'langsung', 'masuk', 'ini', 'mau', 'berkali', 'kali', 'pun', 'seenggaknya', 'masuk', 'bahkan', 'tidak', 'masuk', 'sama', 'sekali', 'tolong', 'lah', 'perbaikan']","['tolong', 'apapun', 'alasannya', 'keamanan', 'akun', 'terkait', 'login', 'akun', 'linkedin', 'perbaikan', 'iya', 'berkali', 'kali', 'mengikuti', 'instruksi', 'keamanan', 'akun', 'responsnya', 'respons', 'kode', 'nomor', 'captcha', 'tidak', 'valid', 'isi', 'berkali', 'kali', 'hapus', 'data', 'hapus', 'aplikasi', 'ulang', 'tidak', 'kemajuan', 'cuman', 'login', 'aneh', 'login', 'website', 'aman', 'aman', 'langsung', 'masuk', 'berkali', 'kali', 'seenggaknya', 'masuk', 'tidak', 'masuk', 'tolong', 'perbaikan']",81,51,30,tolong apa alas aman akun kait login akun linkedin baik iya kali kali ikut instruksi aman akun respons respons kode nomor captcha tidak valid isi kali kali hapus data hapus aplikasi ulang tidak maju cuman login aneh login website aman aman langsung masuk kali kali enggak masuk tidak masuk tolong baik,51,51
"Sangat buruk aplikasi nya, ngeselin, kita ini jobseeker malah setelah di perbarui profil nya malah jadi asisten manajer, aneh",negatif,2024-03-21,2024,sangat buruk aplikasi nya ngeselin kita ini jobseeker malah setelah di perbarui profil nya malah jadi asisten manajer aneh,19,19,sangat buruk aplikasi nya ngeselin kita ini jobseeker bahkan setelah di perbarui profil nya bahkan jadi asisten manajer aneh,19,19,"['sangat', 'buruk', 'aplikasi', 'nya', 'ngeselin', 'kita', 'ini', 'jobseeker', 'bahkan', 'setelah', 'di', 'perbarui', 'profil', 'nya', 'bahkan', 'jadi', 'asisten', 'manajer', 'aneh']","['buruk', 'aplikasi', 'nya', 'ngeselin', 'jobseeker', 'perbarui', 'profil', 'nya', 'asisten', 'manajer', 'aneh']",19,11,8,buruk aplikasi nya ngeselin jobseeker baru profil nya asisten manajer aneh,11,11
"Masa iya mau login pake akun google, harus verifikasi berkali kali, mana udh pilih gambar yg bener lagi, tetep aja gak bisa masuk, tolong di perbaiki lagi ya min",negatif,2024-05-14,2024,masa iya mau login pake akun google harus verifikasi berkali kali mana udh pilih gambar yg bener lagi tetep aja gak bisa masuk tolong di perbaiki lagi ya min,29,29,masa iya mau login pakai akun google harus verifikasi berkali kali mana sudah pilih gambar yang benar lagi tetap saja tidak bisa masuk tolong di perbaikan lagi ya minimal,29,29,"['masa', 'iya', 'mau', 'login', 'pakai', 'akun', 'google', 'harus', 'verifikasi', 'berkali', 'kali', 'mana', 'sudah', 'pilih', 'gambar', 'yang', 'benar', 'lagi', 'tetap', 'saja', 'tidak', 'bisa', 'masuk', 'tolong', 'di', 'perbaikan', 'lagi', 'ya', 'minimal']","['iya', 'login', 'pakai', 'akun', 'google', 'verifikasi', 'berkali', 'kali', 'pilih', 'gambar', 'tidak', 'masuk', 'tolong', 'perbaikan', 'ya', 'minimal']",29,16,13,iya login pakai akun google verifikasi kali kali pilih gambar tidak masuk tolong baik ya minimal,16,16
Mantab sekali. Gampang digunakan kan sangat nyaman dengan fitur - fitur yang mudah difahami. Pilihan bahasa Indonesia juga sangat menarik,positif,2024-05-28,2024,mantab sekali gampang digunakan kan sangat nyaman dengan fitur fitur yang mudah difahami pilihan bahasa indonesia juga sangat menarik,20,19,mantap sekali gampang digunakan akan sangat nyaman dengan fitur fitur yang mudah difahami pilihan bahasa indonesia juga sangat menarik,19,19,"['mantap', 'sekali', 'gampang', 'digunakan', 'akan', 'sangat', 'nyaman', 'dengan', 'fitur', 'fitur', 'yang', 'mudah', 'difahami', 'pilihan', 'bahasa', 'indonesia', 'juga', 'sangat', 'menarik']","['mantap', 'gampang', 'nyaman', 'fitur', 'fitur', 'mudah', 'difahami', 'pilihan', 'bahasa', 'indonesia', 'menarik']",19,11,8,mantap gampang nyaman fitur fitur mudah difahami pilih bahasa indonesia tarik,11,11
"Gk jelas banget, gk ada badai gk hujan tiba2 disuruh login ulang, verivikasi keamanan, mana ulang2 mulu dah selesai kemabali lagi verifikasi, mana gambar nya gk jelas Aplikasi gede kok kayak gini",negatif,2024-05-27,2024,gk jelas banget gk ada badai gk hujan tiba disuruh login ulang verivikasi keamanan mana ulang mulu dah selesai kemabali lagi verifikasi mana gambar nya gk jelas aplikasi gede kok kayak gini,32,32,tidak jelas banget tidak ada badai tidak hujan tiba disuruh login ulang verivikasi keamanan mana ulang mulu sudah selesai kemabali lagi verifikasi mana gambar nya tidak jelas aplikasi gede kok kayak begini,32,32,"['tidak', 'jelas', 'banget', 'tidak', 'ada', 'badai', 'tidak', 'hujan', 'tiba', 'disuruh', 'login', 'ulang', 'verivikasi', 'keamanan', 'mana', 'ulang', 'mulu', 'sudah', 'selesai', 'kemabali', 'lagi', 'verifikasi', 'mana', 'gambar', 'nya', 'tidak', 'jelas', 'aplikasi', 'gede', 'kok', 'kayak', 'begini']","['tidak', 'banget', 'tidak', 'badai', 'tidak', 'hujan', 'disuruh', 'login', 'ulang', 'verivikasi', 'keamanan', 'ulang', 'mulu', 'selesai', 'kemabali', 'verifikasi', 'gambar', 'nya', 'tidak', 'aplikasi', 'gede', 'kayak']",32,22,10,tidak banget tidak badai tidak hujan suruh login ulang verivikasi aman ulang mulu selesai kemabali verifikasi gambar nya tidak aplikasi gede kayak,22,22
Saya ingin meminta refund/pengembalian dana dikarenakan tidak sengaja membeli paket Premium dan bukan dari saya yg membeli layanan tersebut dan pembayarannya melalui otomatis tanpa sepengetahuan saya.,negatif,2024-05-01,2024,saya ingin meminta refund pengembalian dana dikarenakan tidak sengaja membeli paket premium dan bukan dari saya yg membeli layanan tersebut dan pembayarannya melalui otomatis tanpa sepengetahuan saya,26,27,saya ingin meminta refund pengembalian dana dikarenakan tidak sengaja membeli paket premium dan bukan dari saya yang membeli layanan tersebut dan pembayarannya melalui otomatis tanpa sepengetahuan saya,27,27,"['saya', 'ingin', 'meminta', 'refund', 'pengembalian', 'dana', 'dikarenakan', 'tidak', 'sengaja', 'membeli', 'paket', 'premium', 'dan', 'bukan', 'dari', 'saya', 'yang', 'membeli', 'layanan', 'tersebut', 'dan', 'pembayarannya', 'melalui', 'otomatis', 'tanpa', 'sepengetahuan', 'saya']","['refund', 'pengembalian', 'dana', 'tidak', 'sengaja', 'membeli', 'paket', 'premium', 'membeli', 'layanan', 'pembayarannya', 'otomatis', 'sepengetahuan']",27,13,14,refund kembali dana tidak sengaja beli paket premium beli layan bayar otomatis tahu,13,13
"login aja dipersulit, masa udah input email dan sandi yang bener di hp gabisa login.. aneh aplikasinya",negatif,2024-04-22,2024,login aja dipersulit masa udah input email dan sandi yang bener di hp gabisa login aneh aplikasinya,17,17,login saja dipersulit masa sudah input email dan sandi yang benar di handphone tidak bisa login aneh aplikasi nya,17,19,"['login', 'saja', 'dipersulit', 'masa', 'sudah', 'input', 'email', 'dan', 'sandi', 'yang', 'benar', 'di', 'handphone', 'tidak', 'bisa', 'login', 'aneh', 'aplikasi', 'nya']","['login', 'dipersulit', 'input', 'email', 'sandi', 'handphone', 'tidak', 'login', 'aneh', 'aplikasi', 'nya']",19,11,8,login sulit input email sandi handphone tidak login aneh aplikasi nya,11,11
"Aplikasi rusak, disuruh vefikasi gambar, tapi gagal mulu. Tolong dong diperbaiki aplikasinya",negatif,2024-04-21,2024,aplikasi rusak disuruh vefikasi gambar tapi gagal mulu tolong dong diperbaiki aplikasinya,12,12,aplikasi rusak disuruh vefikasi gambar tapi gagal mulu tolong dong di perbaiki aplikasi nya,12,14,"['aplikasi', 'rusak', 'disuruh', 'vefikasi', 'gambar', 'tapi', 'gagal', 'mulu', 'tolong', 'dong', 'di', 'perbaiki', 'aplikasi', 'nya']","['aplikasi', 'rusak', 'disuruh', 'vefikasi', 'gambar', 'gagal', 'mulu', 'tolong', 'perbaiki', 'aplikasi', 'nya']",14,11,3,aplikasi rusak suruh vefikasi gambar gagal mulu tolong baik aplikasi nya,11,11
Habis di update kenapa malah crash gak bisa masuk ke LinkedIn sih. Udh dicoba beberapa kali tetep aja gak bisa masuk ke home,negatif,2024-04-15,2024,habis di update kenapa malah crash gak bisa masuk ke linkedin sih udh dicoba beberapa kali tetep aja gak bisa masuk ke home,23,23,habis di diperbarui kenapa bahkan crash tidak bisa masuk ke linkedin sih sudah dicoba beberapa kali tetap saja tidak bisa masuk ke home,23,23,"['habis', 'di', 'diperbarui', 'kenapa', 'bahkan', 'crash', 'tidak', 'bisa', 'masuk', 'ke', 'linkedin', 'sih', 'sudah', 'dicoba', 'beberapa', 'kali', 'tetap', 'saja', 'tidak', 'bisa', 'masuk', 'ke', 'home']","['habis', 'diperbarui', 'crash', 'tidak', 'masuk', 'linkedin', 'sih', 'dicoba', 'kali', 'tidak', 'masuk', 'home']",23,12,11,habis baru crash tidak masuk linkedin sih coba kali tidak masuk home,12,12
medsos berbasis mencari pekerjaan dan informasi sangat sangat rekomendasi untuk para fresh graduate 👍👍,positif,2024-04-21,2024,medsos berbasis mencari pekerjaan dan informasi sangat sangat rekomendasi untuk para fresh graduate,14,13,media sosial berbasis mencari pekerjaan dan informasi sangat sangat rekomendasi untuk para segar graduate,13,14,"['media', 'sosial', 'berbasis', 'mencari', 'pekerjaan', 'dan', 'informasi', 'sangat', 'sangat', 'rekomendasi', 'untuk', 'para', 'segar', 'graduate']","['media', 'sosial', 'berbasis', 'mencari', 'pekerjaan', 'informasi', 'rekomendasi', 'segar', 'graduate']",14,9,5,media sosial bas cari kerja informasi rekomendasi segar graduate,9,9
"Susah Login Berbelit udah isi data diri, ngisi verifikasi, dan ganti sandi tetep aja gabisa Login",negatif,2024-04-28,2024,susah login berbelit udah isi data diri ngisi verifikasi dan ganti sandi tetep aja gabisa login,16,16,susah login berbelit sudah isi data diri mengisi verifikasi dan ganti sandi tetap saja tidak bisa login,16,17,"['susah', 'login', 'berbelit', 'sudah', 'isi', 'data', 'diri', 'mengisi', 'verifikasi', 'dan', 'ganti', 'sandi', 'tetap', 'saja', 'tidak', 'bisa', 'login']","['susah', 'login', 'berbelit', 'isi', 'data', 'mengisi', 'verifikasi', 'ganti', 'sandi', 'tidak', 'login']",17,11,6,susah login belit isi data isi verifikasi ganti sandi tidak login,11,11
Aplikasi yang paling menyulitkan pengguna. Untuk mengedit bio saja susah menemukan menunya.,negatif,2024-05-11,2024,aplikasi yang paling menyulitkan pengguna untuk mengedit bio saja susah menemukan menunya,12,12,aplikasi yang paling menyulitkan pengguna untuk mengedit bio saja susah menemukan menunya,12,12,"['aplikasi', 'yang', 'paling', 'menyulitkan', 'pengguna', 'untuk', 'mengedit', 'bio', 'saja', 'susah', 'menemukan', 'menunya']","['aplikasi', 'menyulitkan', 'pengguna', 'mengedit', 'bio', 'susah', 'menemukan', 'menunya']",12,8,4,aplikasi sulit guna edit bio susah temu menu,8,8
Verifikasi email doang tapi ribetnya minta ampun Gak bisa login dan loading aja Akhirnya malah kena kick,negatif,2024-04-22,2024,verifikasi email doang tapi ribetnya minta ampun gak bisa login dan loading aja akhirnya malah kena kick,17,17,verifikasi email saja tapi ribetnya minta ampun tidak bisa login dan loading saja akhirnya bahkan kena kick,17,17,"['verifikasi', 'email', 'saja', 'tapi', 'ribetnya', 'minta', 'ampun', 'tidak', 'bisa', 'login', 'dan', 'loading', 'saja', 'akhirnya', 'bahkan', 'kena', 'kick']","['verifikasi', 'email', 'ribetnya', 'ampun', 'tidak', 'login', 'loading', 'kena', 'kick']",17,9,8,verifikasi email ribetnya ampun tidak login loading kena kick,9,9
"Aplikasi yg bermanfaat bagi pemberi kerja dan pencari kerja,juga jadi media berbagi ilmu sesama anggota,thanks LinkedIn",positif,2024-05-01,2024,aplikasi yg bermanfaat bagi pemberi kerja dan pencari kerja juga jadi media berbagi ilmu sesama anggota thanks linkedin,16,18,aplikasi yang bermanfaat bagi pemberi kerja dan pencari kerja juga jadi media berbagi ilmu sesama anggota terima kasih linkedin,18,19,"['aplikasi', 'yang', 'bermanfaat', 'bagi', 'pemberi', 'kerja', 'dan', 'pencari', 'kerja', 'juga', 'jadi', 'media', 'berbagi', 'ilmu', 'sesama', 'anggota', 'terima', 'kasih', 'linkedin']","['aplikasi', 'bermanfaat', 'pemberi', 'kerja', 'pencari', 'kerja', 'media', 'berbagi', 'ilmu', 'anggota', 'terima', 'kasih', 'linkedin']",19,13,6,aplikasi manfaat beri kerja cari kerja media bagi ilmu anggota terima kasih linkedin,13,13
premium ga bisa pake AI ga bisa berguna apa apa harus bayar mahal sue banget sih aplikasinya,negatif,2024-05-06,2024,premium ga bisa pake ai ga bisa berguna apa apa harus bayar mahal sue banget sih aplikasinya,17,17,premium tidak bisa pakai ai tidak bisa berguna apa apa harus bayar mahal sue banget sih aplikasi nya,17,18,"['premium', 'tidak', 'bisa', 'pakai', 'ai', 'tidak', 'bisa', 'berguna', 'apa', 'apa', 'harus', 'bayar', 'mahal', 'sue', 'banget', 'sih', 'aplikasi', 'nya']","['premium', 'tidak', 'pakai', 'ai', 'tidak', 'berguna', 'bayar', 'mahal', 'sue', 'banget', 'sih', 'aplikasi', 'nya']",18,13,5,premium tidak pakai ai tidak guna bayar mahal sue banget sih aplikasi nya,13,13
"Sangat sulit untuk mengubah data pribadi kita, benar2 memusingkan dan membingungkan",negatif,2024-05-08,2024,sangat sulit untuk mengubah data pribadi kita benar memusingkan dan membingungkan,11,11,sangat sulit untuk mengubah data pribadi kita benar memusingkan dan membingungkan,11,11,"['sangat', 'sulit', 'untuk', 'mengubah', 'data', 'pribadi', 'kita', 'benar', 'memusingkan', 'dan', 'membingungkan']","['sulit', 'mengubah', 'data', 'pribadi', 'memusingkan', 'membingungkan']",11,6,5,sulit ubah data pribadi pusing bingung,6,6
Saya mau kluar dari apk ini dengan cara menghapus akun saya tapi tidak bisa berkali' saya mencoba mohon diperbaiki lagi karena saya mau kluar dari apk ini🙏,negatif,2024-06-04,2024,saya mau kluar dari apk ini dengan cara menghapus akun saya tapi tidak bisa berkali saya mencoba mohon diperbaiki lagi karena saya mau kluar dari apk ini,27,27,saya mau keluar dari aplikasi ini dengan cara menghapus akun saya tapi tidak bisa berkali saya mencoba mohon di perbaiki lagi karena saya mau keluar dari aplikasi ini,27,28,"['saya', 'mau', 'keluar', 'dari', 'aplikasi', 'ini', 'dengan', 'cara', 'menghapus', 'akun', 'saya', 'tapi', 'tidak', 'bisa', 'berkali', 'saya', 'mencoba', 'mohon', 'di', 'perbaiki', 'lagi', 'karena', 'saya', 'mau', 'keluar', 'dari', 'aplikasi', 'ini']","['aplikasi', 'menghapus', 'akun', 'tidak', 'berkali', 'mencoba', 'mohon', 'perbaiki', 'aplikasi']",28,9,19,aplikasi hapus akun tidak kali coba mohon baik aplikasi,9,9
"Untuk edit profile bagian pekerjaan ada sedikit bug, tidak bisa menambahkan atau merubah posisi dan jenis pekerjaan, jadi tolong lebih di perhatikan lagi.",negatif,2024-05-24,2024,untuk edit profile bagian pekerjaan ada sedikit bug tidak bisa menambahkan atau merubah posisi dan jenis pekerjaan jadi tolong lebih di perhatikan lagi,23,23,untuk edit profile bagian pekerjaan ada sedikit bug tidak bisa menambahkan atau merubah posisi dan jenis pekerjaan jadi tolong lebih di perhatikan lagi,23,23,"['untuk', 'edit', 'profile', 'bagian', 'pekerjaan', 'ada', 'sedikit', 'bug', 'tidak', 'bisa', 'menambahkan', 'atau', 'merubah', 'posisi', 'dan', 'jenis', 'pekerjaan', 'jadi', 'tolong', 'lebih', 'di', 'perhatikan', 'lagi']","['edit', 'profile', 'pekerjaan', 'bug', 'tidak', 'merubah', 'posisi', 'jenis', 'pekerjaan', 'tolong', 'perhatikan']",23,11,12,edit profile kerja bug tidak rubah posisi jenis kerja tolong perhati,11,11
"Medsos LinkedIn ini sangat luas terbuka banyak peluang kerja yg sudah terkenal dan tempat tongkrongan para pengusaha untuk menampilkan profil perusahaan.ini sangat membantu pencari kerja,saya rekomendasikan untuk ikut LinkedIn ini.",positif,2024-04-13,2024,medsos linkedin ini sangat luas terbuka banyak peluang kerja yg sudah terkenal dan tempat tongkrongan para pengusaha untuk menampilkan profil perusahaan ini sangat membantu pencari kerja saya rekomendasikan untuk ikut linkedin ini,30,32,media sosial linkedin ini sangat luas terbuka banyak peluang kerja yang sudah terkenal dan tempat tongkrongan para pengusaha untuk menampilkan profil perusahaan ini sangat membantu pencari kerja saya rekomendasikan untuk ikut linkedin ini,32,33,"['media', 'sosial', 'linkedin', 'ini', 'sangat', 'luas', 'terbuka', 'banyak', 'peluang', 'kerja', 'yang', 'sudah', 'terkenal', 'dan', 'tempat', 'tongkrongan', 'para', 'pengusaha', 'untuk', 'menampilkan', 'profil', 'perusahaan', 'ini', 'sangat', 'membantu', 'pencari', 'kerja', 'saya', 'rekomendasikan', 'untuk', 'ikut', 'linkedin', 'ini']","['media', 'sosial', 'linkedin', 'luas', 'terbuka', 'peluang', 'kerja', 'terkenal', 'tongkrongan', 'pengusaha', 'menampilkan', 'profil', 'perusahaan', 'membantu', 'pencari', 'kerja', 'rekomendasikan', 'linkedin']",33,18,15,media sosial linkedin luas buka peluang kerja kenal tongkrong usaha tampil profil usaha bantu cari kerja rekomendasi linkedin,18,18
Kenapa saya eror terus ya ketika akan login,negatif,2024-08-19,2024,kenapa saya eror terus ya ketika akan login,8,8,kenapa saya error terus ya ketika akan login,8,8,"['kenapa', 'saya', 'error', 'terus', 'ya', 'ketika', 'akan', 'login']","['error', 'ya', 'login']",8,3,5,error ya login,3,3
Aplikasinya payah sekelas Linkedln programmerrnya kurang pro bikin sistem diaplikasinya banyak error dan gak berfungsi setelah diupdate padahal aplikasi ini sangat membantu sekali tapi apa daya sekarang aplikasinya jadi gak guna setelah diupdate banyak errorr nya .....!!!!!,negatif,2022-09-21,2022,aplikasinya payah sekelas linkedln programmerrnya kurang pro bikin sistem diaplikasinya banyak error dan gak berfungsi setelah diupdate padahal aplikasi ini sangat membantu sekali tapi apa daya sekarang aplikasinya jadi gak guna setelah diupdate banyak errorr nya,37,36,aplikasi nya payah sekelas linkedln programmerrnya kurang pro bikin sistem diaplikasinya banyak error dan tidak berfungsi setelah di perbarui padahal aplikasi ini sangat membantu sekali tapi apa daya sekarang aplikasi nya jadi tidak guna setelah di perbarui banyak errorr nya,36,40,"['aplikasi', 'nya', 'payah', 'sekelas', 'linkedln', 'programmerrnya', 'kurang', 'pro', 'bikin', 'sistem', 'diaplikasinya', 'banyak', 'error', 'dan', 'tidak', 'berfungsi', 'setelah', 'di', 'perbarui', 'padahal', 'aplikasi', 'ini', 'sangat', 'membantu', 'sekali', 'tapi', 'apa', 'daya', 'sekarang', 'aplikasi', 'nya', 'jadi', 'tidak', 'guna', 'setelah', 'di', 'perbarui', 'banyak', 'errorr', 'nya']","['aplikasi', 'nya', 'payah', 'sekelas', 'linkedln', 'programmerrnya', 'pro', 'bikin', 'sistem', 'diaplikasinya', 'error', 'tidak', 'berfungsi', 'perbarui', 'aplikasi', 'membantu', 'daya', 'aplikasi', 'nya', 'tidak', 'perbarui', 'errorr', 'nya']",40,23,17,aplikasi nya payah kelas linkedln programmerrnya pro bikin sistem aplikasi error tidak fungsi baru aplikasi bantu daya aplikasi nya tidak baru errorr nya,23,23
"Verifikasi bolak balik doang, ku kira pakai klik akun langsung login malah verifikasi lagi... hati² deh kalau lupa password emang nih suka logout sendiri walaupun di aplikasi sendiri",negatif,2024-08-03,2024,verifikasi bolak balik doang ku kira pakai klik akun langsung login malah verifikasi lagi hati² deh kalau lupa password emang nih suka logout sendiri walaupun di aplikasi sendiri,28,28,verifikasi bolak balik saja saya kira pakai klik akun langsung login bahkan verifikasi lagi hati² deh kalau lupa password memang nih suka logout sendiri walaupun di aplikasi sendiri,28,28,"['verifikasi', 'bolak', 'balik', 'saja', 'saya', 'kira', 'pakai', 'klik', 'akun', 'langsung', 'login', 'bahkan', 'verifikasi', 'lagi', 'hati²', 'deh', 'kalau', 'lupa', 'password', 'memang', 'nih', 'suka', 'logout', 'sendiri', 'walaupun', 'di', 'aplikasi', 'sendiri']","['verifikasi', 'bolak', 'pakai', 'klik', 'akun', 'langsung', 'login', 'verifikasi', 'hati²', 'deh', 'lupa', 'password', 'nih', 'suka', 'logout', 'aplikasi']",28,16,12,verifikasi bolak pakai klik akun langsung login verifikasi hati deh lupa password nih suka logout aplikasi,16,16
"gjls bgt, mau login aja susah",negatif,2024-08-09,2024,gjls bgt mau login aja susah,6,6,gjls banget mau login saja susah,6,6,"['gjls', 'banget', 'mau', 'login', 'saja', 'susah']","['gjls', 'banget', 'login', 'susah']",6,4,2,gjls banget login susah,4,4
Aplikasinya bagus tapi banyak bug menurut saya seperti saya tidak bs melihat gambar orang lain... Dan ketika saya ingin menganti profile dan banner profil pun juga tetap tidak bisa malah jadi warna putih.. Sudah di restart (baik website & mobile ) jg ttp tidak bisa.. Min mohon perbaikannya untuk masalah ini terimakasih..,positif,2021-12-26,2021,aplikasinya bagus tapi banyak bug menurut saya seperti saya tidak bs melihat gambar orang lain dan ketika saya ingin menganti profile dan banner profil pun juga tetap tidak bisa malah jadi warna putih sudah di restart baik website mobile jg ttp tidak bisa min mohon perbaikannya untuk masalah ini terimakasih,52,50,aplikasi nya bagus tapi banyak bug menurut saya seperti saya tidak bisa melihat gambar orang lain dan ketika saya ingin menganti profile dan banner profil pun juga tetap tidak bisa bahkan jadi warna putih sudah di restart baik website mobile juga tetap tidak bisa minimal mohon perbaikannya untuk masalah ini terima kasih,50,52,"['aplikasi', 'nya', 'bagus', 'tapi', 'banyak', 'bug', 'menurut', 'saya', 'seperti', 'saya', 'tidak', 'bisa', 'melihat', 'gambar', 'orang', 'lain', 'dan', 'ketika', 'saya', 'ingin', 'menganti', 'profile', 'dan', 'banner', 'profil', 'pun', 'juga', 'tetap', 'tidak', 'bisa', 'bahkan', 'jadi', 'warna', 'putih', 'sudah', 'di', 'restart', 'baik', 'website', 'mobile', 'juga', 'tetap', 'tidak', 'bisa', 'minimal', 'mohon', 'perbaikannya', 'untuk', 'masalah', 'ini', 'terima', 'kasih']","['aplikasi', 'nya', 'bagus', 'bug', 'tidak', 'gambar', 'orang', 'menganti', 'profile', 'banner', 'profil', 'tidak', 'warna', 'putih', 'restart', 'website', 'mobile', 'tidak', 'minimal', 'mohon', 'perbaikannya', 'terima', 'kasih']",52,23,29,aplikasi nya bagus bug tidak gambar orang anti profile banner profil tidak warna putih restart website mobile tidak minimal mohon baik terima kasih,23,23
"Apalah ga ada satupun yg manggil interview minimal, pdhl sebagai fresh graduate dngn lumayan bnyk pengalaman w minimal di interview",negatif,2024-07-10,2024,apalah ga ada satupun yg manggil interview minimal pdhl sebagai fresh graduate dngn lumayan bnyk pengalaman w minimal di interview,20,20,apalah tidak ada satupun yang panggil interview minimal padahal sebagai segar graduate dengan lumayan banyak pengalaman w minimal di interview,20,20,"['apalah', 'tidak', 'ada', 'satupun', 'yang', 'panggil', 'interview', 'minimal', 'padahal', 'sebagai', 'segar', 'graduate', 'dengan', 'lumayan', 'banyak', 'pengalaman', 'w', 'minimal', 'di', 'interview']","['apalah', 'tidak', 'satupun', 'panggil', 'interview', 'minimal', 'segar', 'graduate', 'lumayan', 'pengalaman', 'w', 'minimal', 'interview']",20,13,7,apa tidak satu panggil interview minimal segar graduate lumayan alam w minimal interview,13,13
Lah ini gimana dah padahal udh buat akun malah gak bisa masuk,negatif,2024-06-21,2024,lah ini gimana dah padahal udh buat akun malah gak bisa masuk,12,12,lah ini bagaimana sudah padahal sudah buat akun bahkan tidak bisa masuk,12,12,"['lah', 'ini', 'bagaimana', 'sudah', 'padahal', 'sudah', 'buat', 'akun', 'bahkan', 'tidak', 'bisa', 'masuk']","['akun', 'tidak', 'masuk']",12,3,9,akun tidak masuk,3,3
"Ini LinkedIn kenapa si mau login aja selalu gagal, udah Verifikasi berkali kali masih aja ga bisa login, cuma diulang ulang terus milih gambar gajelas. Padahal udah muncul notifikasi ""verisikasi berhasil"", malah disuruh milh gambar lagi, mana udah berkali kali tetep gabisa!",negatif,2023-05-18,2023,ini linkedin kenapa si mau login aja selalu gagal udah verifikasi berkali kali masih aja ga bisa login cuma diulang ulang terus milih gambar gajelas padahal udah muncul notifikasi verisikasi berhasil malah disuruh milh gambar lagi mana udah berkali kali tetep gabisa,42,42,ini linkedin kenapa sih mau login saja selalu gagal sudah verifikasi berkali kali masih saja tidak bisa login cuma diulang ulang terus memilih gambar tidak jelas padahal sudah muncul notifikasi verisikasi berhasil bahkan disuruh milh gambar lagi mana sudah berkali kali tetap tidak bisa,42,44,"['ini', 'linkedin', 'kenapa', 'sih', 'mau', 'login', 'saja', 'selalu', 'gagal', 'sudah', 'verifikasi', 'berkali', 'kali', 'masih', 'saja', 'tidak', 'bisa', 'login', 'cuma', 'diulang', 'ulang', 'terus', 'memilih', 'gambar', 'tidak', 'jelas', 'padahal', 'sudah', 'muncul', 'notifikasi', 'verisikasi', 'berhasil', 'bahkan', 'disuruh', 'milh', 'gambar', 'lagi', 'mana', 'sudah', 'berkali', 'kali', 'tetap', 'tidak', 'bisa']","['linkedin', 'sih', 'login', 'gagal', 'verifikasi', 'berkali', 'kali', 'tidak', 'login', 'diulang', 'ulang', 'memilih', 'gambar', 'tidak', 'muncul', 'notifikasi', 'verisikasi', 'berhasil', 'disuruh', 'milh', 'gambar', 'berkali', 'kali', 'tidak']",44,24,20,linkedin sih login gagal verifikasi kali kali tidak login ulang ulang pilih gambar tidak muncul notifikasi verisikasi hasil suruh milh gambar kali kali tidak,24,24
Sumpah lu apk model apan dah. Gua kaga pernah namanya pembelian langganan di apk lu. Tapi ngapin lu ambil saldo dana gua 1jt. Adahl gua kaga ernah ngelakuin pembayaran itu. Ini sama aja pencurian. Mana uang mau buat kebutuhan pula. Mohon itikat baik nya,negatif,2024-07-29,2024,sumpah lu apk model apan dah gua kaga pernah namanya pembelian langganan di apk lu tapi ngapin lu ambil saldo dana gua jt adahl gua kaga ernah ngelakuin pembayaran itu ini sama aja pencurian mana uang mau buat kebutuhan pula mohon itikat baik nya,44,44,sumpah lu aplikasi model apan sudah saya tidak pernah namanya pembelian langganan di aplikasi lu tapi ngapin lu ambil saldo dana saya jt adahl saya tidak ernah ngelakuin pembayaran itu ini sama saja pencurian mana uang mau buat kebutuhan pula mohon itikat baik nya,44,44,"['sumpah', 'lu', 'aplikasi', 'model', 'apan', 'sudah', 'saya', 'tidak', 'pernah', 'namanya', 'pembelian', 'langganan', 'di', 'aplikasi', 'lu', 'tapi', 'ngapin', 'lu', 'ambil', 'saldo', 'dana', 'saya', 'jt', 'adahl', 'saya', 'tidak', 'ernah', 'ngelakuin', 'pembayaran', 'itu', 'ini', 'sama', 'saja', 'pencurian', 'mana', 'uang', 'mau', 'buat', 'kebutuhan', 'pula', 'mohon', 'itikat', 'baik', 'nya']","['sumpah', 'lu', 'aplikasi', 'model', 'apan', 'tidak', 'namanya', 'pembelian', 'langganan', 'aplikasi', 'lu', 'ngapin', 'lu', 'ambil', 'saldo', 'dana', 'jt', 'adahl', 'tidak', 'ernah', 'ngelakuin', 'pembayaran', 'pencurian', 'uang', 'kebutuhan', 'mohon', 'itikat', 'nya']",44,28,16,sumpah lu aplikasi model apan tidak nama beli langgan aplikasi lu ngapin lu ambil saldo dana jt adahl tidak ernah ngelakuin bayar curi uang butuh mohon itikat nya,28,28
Bekerja keras &konsisten,positif,2024-06-25,2024,bekerja keras konsisten,3,3,bekerja keras konsisten,3,3,"['bekerja', 'keras', 'konsisten']","['keras', 'konsisten']",3,2,1,keras konsisten,2,2
Bagus bngt bnyk informasi pekerjaan dll,positif,2024-07-23,2024,bagus bngt bnyk informasi pekerjaan dll,6,6,bagus banget banyak informasi pekerjaan dan lain lain,6,8,"['bagus', 'banget', 'banyak', 'informasi', 'pekerjaan', 'dan', 'lain', 'lain']","['bagus', 'banget', 'informasi', 'pekerjaan']",8,4,4,bagus banget informasi kerja,4,4
"Sangat profesional sekali untuk Aplikasi ini. Sangat membantu untuk orang yang ingin tahu ilmu semua jenis pekerjaan. Karena isi didalam jaringan sosial ini,adalah orang-orang penting dan banyak yang baik hati. Orang-orang yg profesional dalam bidangnya masing-masing. Saya salah satunya,orang yang mendapatkan pekerjaan melalui aplikasi ini. Kita bisa menjalin hubungan baik dalam hal profesi,pekerjaan. Sukses selalu untuk Aplikasi LinkedIn dan sehat selalu untuk semua team work nya.",positif,2021-03-05,2021,sangat profesional sekali untuk aplikasi ini sangat membantu untuk orang yang ingin tahu ilmu semua jenis pekerjaan karena isi didalam jaringan sosial ini adalah orang orang penting dan banyak yang baik hati orang orang yg profesional dalam bidangnya masing masing saya salah satunya orang yang mendapatkan pekerjaan melalui aplikasi ini kita bisa menjalin hubungan baik dalam hal profesi pekerjaan sukses selalu untuk aplikasi linkedin dan sehat selalu untuk semua team work nya,66,72,sangat profesional sekali untuk aplikasi ini sangat membantu untuk orang yang ingin tahu ilmu semua jenis pekerjaan karena isi didalam jaringan sosial ini adalah orang orang penting dan banyak yang baik hati orang orang yang profesional dalam bidangnya masing masing saya salah satunya orang yang mendapatkan pekerjaan melalui aplikasi ini kita bisa menjalin hubungan baik dalam hal profesi pekerjaan sukses selalu untuk aplikasi linkedin dan sehat selalu untuk semua team work nya,72,72,"['sangat', 'profesional', 'sekali', 'untuk', 'aplikasi', 'ini', 'sangat', 'membantu', 'untuk', 'orang', 'yang', 'ingin', 'tahu', 'ilmu', 'semua', 'jenis', 'pekerjaan', 'karena', 'isi', 'didalam', 'jaringan', 'sosial', 'ini', 'adalah', 'orang', 'orang', 'penting', 'dan', 'banyak', 'yang', 'baik', 'hati', 'orang', 'orang', 'yang', 'profesional', 'dalam', 'bidangnya', 'masing', 'masing', 'saya', 'salah', 'satunya', 'orang', 'yang', 'mendapatkan', 'pekerjaan', 'melalui', 'aplikasi', 'ini', 'kita', 'bisa', 'menjalin', 'hubungan', 'baik', 'dalam', 'hal', 'profesi', 'pekerjaan', 'sukses', 'selalu', 'untuk', 'aplikasi', 'linkedin', 'dan', 'sehat', 'selalu', 'untuk', 'semua', 'team', 'work', 'nya']","['profesional', 'aplikasi', 'membantu', 'orang', 'ilmu', 'jenis', 'pekerjaan', 'isi', 'didalam', 'jaringan', 'sosial', 'orang', 'orang', 'hati', 'orang', 'orang', 'profesional', 'bidangnya', 'salah', 'satunya', 'orang', 'pekerjaan', 'aplikasi', 'menjalin', 'hubungan', 'profesi', 'pekerjaan', 'sukses', 'aplikasi', 'linkedin', 'sehat', 'team', 'work', 'nya']",72,34,38,profesional aplikasi bantu orang ilmu jenis kerja isi dalam jaring sosial orang orang hati orang orang profesional bidang salah satu orang kerja aplikasi jalin hubung profesi kerja sukses aplikasi linkedin sehat team work nya,34,34
Mau verifikasi aja berjam-jam gk tau yg salahny mana Bagaimana ini gk bisa verifikasi,negatif,2024-07-07,2024,mau verifikasi aja berjam jam gk tau yg salahny mana bagaimana ini gk bisa verifikasi,14,15,mau verifikasi saja berjam jam tidak tahu yang salahny mana bagaimana ini tidak bisa verifikasi,15,15,"['mau', 'verifikasi', 'saja', 'berjam', 'jam', 'tidak', 'tahu', 'yang', 'salahny', 'mana', 'bagaimana', 'ini', 'tidak', 'bisa', 'verifikasi']","['verifikasi', 'berjam', 'jam', 'tidak', 'salahny', 'tidak', 'verifikasi']",15,7,8,verifikasi jam jam tidak salahny tidak verifikasi,7,7
"Aplikasi sdh cukup baik seperti tampilan UI/UX yang menarik pengguna, tp ada beberapa kendala dalam login seperti #verifikasi selalu gagal, #error ketika unggah foto, dan loading yang lama saat pindah menu. tlg diperbaiki . terma ksh",positif,2023-06-25,2023,aplikasi sdh cukup baik seperti tampilan ui ux yang menarik pengguna tp ada beberapa kendala dalam login seperti verifikasi selalu gagal error ketika unggah foto dan loading yang lama saat pindah menu tlg diperbaiki terma ksh,36,36,aplikasi sudah cukup baik seperti tampilan ui ux yang menarik pengguna tapi ada beberapa kendala dalam login seperti verifikasi selalu gagal error ketika unggah foto dan loading yang lama saat pindah menu tlg di perbaiki terma kasih,36,37,"['aplikasi', 'sudah', 'cukup', 'baik', 'seperti', 'tampilan', 'ui', 'ux', 'yang', 'menarik', 'pengguna', 'tapi', 'ada', 'beberapa', 'kendala', 'dalam', 'login', 'seperti', 'verifikasi', 'selalu', 'gagal', 'error', 'ketika', 'unggah', 'foto', 'dan', 'loading', 'yang', 'lama', 'saat', 'pindah', 'menu', 'tlg', 'di', 'perbaiki', 'terma', 'kasih']","['aplikasi', 'tampilan', 'ui', 'ux', 'menarik', 'pengguna', 'kendala', 'login', 'verifikasi', 'gagal', 'error', 'unggah', 'foto', 'loading', 'pindah', 'menu', 'tlg', 'perbaiki', 'terma', 'kasih']",37,20,17,aplikasi tampil ui ux tarik guna kendala login verifikasi gagal error unggah foto loading pindah menu tlg baik terma kasih,20,20
"Tiba2 di bilang pasword salah, padahal tidak pernah mengubah pasword. Langsung klik lupa pasword terus minta kode autentifikasi. Udah pake aplikasi dari google hingga miscrosoft authenticator sesuai penunjuk, kode selalu dinyatakan salah. Gimana ini min. Hub kontak linkedin yang ada malah tidak ada respons.",negatif,2022-06-22,2022,tiba di bilang pasword salah padahal tidak pernah mengubah pasword langsung klik lupa pasword terus minta kode autentifikasi udah pake aplikasi dari google hingga miscrosoft authenticator sesuai penunjuk kode selalu dinyatakan salah gimana ini min hub kontak linkedin yang ada malah tidak ada respons,44,44,tiba di bilang pasword salah padahal tidak pernah mengubah pasword langsung klik lupa pasword terus minta kode autentifikasi sudah pakai aplikasi dari google hingga miscrosoft authenticator sesuai penunjuk kode selalu dinyatakan salah bagaimana ini minimal menghubungi kontak linkedin yang ada bahkan tidak ada respons,44,44,"['tiba', 'di', 'bilang', 'pasword', 'salah', 'padahal', 'tidak', 'pernah', 'mengubah', 'pasword', 'langsung', 'klik', 'lupa', 'pasword', 'terus', 'minta', 'kode', 'autentifikasi', 'sudah', 'pakai', 'aplikasi', 'dari', 'google', 'hingga', 'miscrosoft', 'authenticator', 'sesuai', 'penunjuk', 'kode', 'selalu', 'dinyatakan', 'salah', 'bagaimana', 'ini', 'minimal', 'menghubungi', 'kontak', 'linkedin', 'yang', 'ada', 'bahkan', 'tidak', 'ada', 'respons']","['bilang', 'pasword', 'salah', 'tidak', 'mengubah', 'pasword', 'langsung', 'klik', 'lupa', 'pasword', 'kode', 'autentifikasi', 'pakai', 'aplikasi', 'google', 'miscrosoft', 'authenticator', 'sesuai', 'penunjuk', 'kode', 'dinyatakan', 'salah', 'minimal', 'menghubungi', 'kontak', 'linkedin', 'tidak', 'respons']",44,28,16,bilang pasword salah tidak ubah pasword langsung klik lupa pasword kode autentifikasi pakai aplikasi google miscrosoft authenticator sesuai tunjuk kode nyata salah minimal hubung kontak linkedin tidak respons,28,28
"Saya sangat kecewa karena tidak bisa mengulang kata sandi saya, karena ada opsi ""tidak, ini bukan saya ""iya, ini saya"" Nah saya pencet opsi ""iya, ini saya"" Setelah saya pencet malah ada kedua opsi tersebut lagi, tolonglah LinkedIn perbaiki bug ini.",negatif,2024-04-23,2024,saya sangat kecewa karena tidak bisa mengulang kata sandi saya karena ada opsi tidak ini bukan saya iya ini saya nah saya pencet opsi iya ini saya setelah saya pencet malah ada kedua opsi tersebut lagi tolonglah linkedin perbaiki bug ini,41,41,saya sangat kecewa karena tidak bisa mengulang kata sandi saya karena ada opsi tidak ini bukan saya iya ini saya nah saya tekan opsi iya ini saya setelah saya tekan bahkan ada kedua opsi tersebut lagi tolonglah linkedin perbaikan bug ini,41,41,"['saya', 'sangat', 'kecewa', 'karena', 'tidak', 'bisa', 'mengulang', 'kata', 'sandi', 'saya', 'karena', 'ada', 'opsi', 'tidak', 'ini', 'bukan', 'saya', 'iya', 'ini', 'saya', 'nah', 'saya', 'tekan', 'opsi', 'iya', 'ini', 'saya', 'setelah', 'saya', 'tekan', 'bahkan', 'ada', 'kedua', 'opsi', 'tersebut', 'lagi', 'tolonglah', 'linkedin', 'perbaikan', 'bug', 'ini']","['kecewa', 'tidak', 'mengulang', 'sandi', 'opsi', 'tidak', 'iya', 'tekan', 'opsi', 'iya', 'tekan', 'opsi', 'tolonglah', 'linkedin', 'perbaikan', 'bug']",41,16,25,kecewa tidak ulang sandi opsi tidak iya tekan opsi iya tekan opsi tolong linkedin baik bug,16,16
"Hati hati dengan fitur premium gratis selama sepekan, jika anda menggunakan fitur premium hanya untuk mengetahui fitur yang ada, maka segeralah sesudah mengetahuinya untuk membatalkan fitur premium karena pemotongan tagihan premium bulanan akan secara otomatis terpotong melalui metode pembayaran seperti E wallet dan lainnya tanpa ada konfirmasi terlebih dahulu, sangat disayangkan ketika mengakses pusat bantuan kebijakan pengembalian dana konsumen linked in tidak dapat diakses😪",negatif,2024-04-26,2024,hati hati dengan fitur premium gratis selama sepekan jika anda menggunakan fitur premium hanya untuk mengetahui fitur yang ada maka segeralah sesudah mengetahuinya untuk membatalkan fitur premium karena pemotongan tagihan premium bulanan akan secara otomatis terpotong melalui metode pembayaran seperti e wallet dan lainnya tanpa ada konfirmasi terlebih dahulu sangat disayangkan ketika mengakses pusat bantuan kebijakan pengembalian dana konsumen linked in tidak dapat diakses,64,64,hati hati dengan fitur premium gratis selama sepekan jika anda menggunakan fitur premium hanya untuk mengetahui fitur yang ada maka segeralah sesudah mengetahuinya untuk membatalkan fitur premium karena pemotongan tagihan premium bulanan akan secara otomatis terpotong melalui metode pembayaran seperti e wallet dan lainnya tanpa ada konfirmasi terlebih dahulu sangat disayangkan ketika mengakses pusat bantuan kebijakan pengembalian dana konsumen linked in tidak dapat diakses,64,64,"['hati', 'hati', 'dengan', 'fitur', 'premium', 'gratis', 'selama', 'sepekan', 'jika', 'anda', 'menggunakan', 'fitur', 'premium', 'hanya', 'untuk', 'mengetahui', 'fitur', 'yang', 'ada', 'maka', 'segeralah', 'sesudah', 'mengetahuinya', 'untuk', 'membatalkan', 'fitur', 'premium', 'karena', 'pemotongan', 'tagihan', 'premium', 'bulanan', 'akan', 'secara', 'otomatis', 'terpotong', 'melalui', 'metode', 'pembayaran', 'seperti', 'e', 'wallet', 'dan', 'lainnya', 'tanpa', 'ada', 'konfirmasi', 'terlebih', 'dahulu', 'sangat', 'disayangkan', 'ketika', 'mengakses', 'pusat', 'bantuan', 'kebijakan', 'pengembalian', 'dana', 'konsumen', 'linked', 'in', 'tidak', 'dapat', 'diakses']","['hati', 'hati', 'fitur', 'premium', 'gratis', 'sepekan', 'fitur', 'premium', 'fitur', 'segeralah', 'mengetahuinya', 'membatalkan', 'fitur', 'premium', 'pemotongan', 'tagihan', 'premium', 'bulanan', 'otomatis', 'terpotong', 'metode', 'pembayaran', 'e', 'wallet', 'konfirmasi', 'disayangkan', 'mengakses', 'pusat', 'bantuan', 'kebijakan', 'pengembalian', 'dana', 'konsumen', 'linked', 'in', 'tidak', 'diakses']",64,37,27,hati hati fitur premium gratis pek fitur premium fitur segera tahu batal fitur premium potong tagih premium bulan otomatis potong metode bayar e wallet konfirmasi sayang akses pusat bantu bijak kembali dana konsumen linked in tidak akses,37,37
"Ini saya mau login pake gmail, trs dia minta verifikasi lewat teka teki.. anehnya di jawaban terakhir selalu salah, padahal saya sudah menjawab sudah benar! Lalu pas saya ganti ke verifikasi melalui tebak suara juga sama ketika di akhir muncul tulisan verifikasi tidak valid.. pusing mau login aja sulit",negatif,2024-02-07,2024,ini saya mau login pake gmail trs dia minta verifikasi lewat teka teki anehnya di jawaban terakhir selalu salah padahal saya sudah menjawab sudah benar lalu pas saya ganti ke verifikasi melalui tebak suara juga sama ketika di akhir muncul tulisan verifikasi tidak valid pusing mau login aja sulit,49,49,ini saya mau login pakai gmail terus dia minta verifikasi lewat teka teki anehnya di jawaban terakhir selalu salah padahal saya sudah menjawab sudah benar lalu pas saya ganti ke verifikasi melalui tebak suara juga sama ketika di akhir muncul tulisan verifikasi tidak valid pusing mau login saja sulit,49,49,"['ini', 'saya', 'mau', 'login', 'pakai', 'gmail', 'terus', 'dia', 'minta', 'verifikasi', 'lewat', 'teka', 'teki', 'anehnya', 'di', 'jawaban', 'terakhir', 'selalu', 'salah', 'padahal', 'saya', 'sudah', 'menjawab', 'sudah', 'benar', 'lalu', 'pas', 'saya', 'ganti', 'ke', 'verifikasi', 'melalui', 'tebak', 'suara', 'juga', 'sama', 'ketika', 'di', 'akhir', 'muncul', 'tulisan', 'verifikasi', 'tidak', 'valid', 'pusing', 'mau', 'login', 'saja', 'sulit']","['login', 'pakai', 'gmail', 'verifikasi', 'teka', 'teki', 'anehnya', 'salah', 'pas', 'ganti', 'verifikasi', 'tebak', 'suara', 'muncul', 'tulisan', 'verifikasi', 'tidak', 'valid', 'pusing', 'login', 'sulit']",49,21,28,login pakai gmail verifikasi teka teki aneh salah pas ganti verifikasi tebak suara muncul tulis verifikasi tidak valid pusing login sulit,21,21
"Gatau apa saya aja kali ya, kalo pas mau tambahin media di kolom pendidikan atau pengalaman gitu kaga bisa² di upload dan kaya nya LinkedIn sekarang lemot banget, baru aja kejadian mau upload media dengan metode link gdrive gitu kaga bisa-bisa. Tolong dong bug kaya gini diperbaiki padahal tampilan nya udah bagus tapi lemot nya itu kalo mau upload media",negatif,2022-06-30,2022,gatau apa saya aja kali ya kalo pas mau tambahin media di kolom pendidikan atau pengalaman gitu kaga bisa² di upload dan kaya nya linkedin sekarang lemot banget baru aja kejadian mau upload media dengan metode link gdrive gitu kaga bisa bisa tolong dong bug kaya gini diperbaiki padahal tampilan nya udah bagus tapi lemot nya itu kalo mau upload media,60,61,tidak tahu apa saya saja kali ya kalau pas mau tambahin media di kolom pendidikan atau pengalaman begitu tidak bisa² di unggah dan kayak nya linkedin sekarang lambat banget baru saja kejadian mau unggah media dengan metode link gdrive begitu tidak bisa bisa tolong dong bug kayak begini di perbaiki padahal tampilan nya sudah bagus tapi lambat nya itu kalau mau unggah media,61,63,"['tidak', 'tahu', 'apa', 'saya', 'saja', 'kali', 'ya', 'kalau', 'pas', 'mau', 'tambahin', 'media', 'di', 'kolom', 'pendidikan', 'atau', 'pengalaman', 'begitu', 'tidak', 'bisa²', 'di', 'unggah', 'dan', 'kayak', 'nya', 'linkedin', 'sekarang', 'lambat', 'banget', 'baru', 'saja', 'kejadian', 'mau', 'unggah', 'media', 'dengan', 'metode', 'link', 'gdrive', 'begitu', 'tidak', 'bisa', 'bisa', 'tolong', 'dong', 'bug', 'kayak', 'begini', 'di', 'perbaiki', 'padahal', 'tampilan', 'nya', 'sudah', 'bagus', 'tapi', 'lambat', 'nya', 'itu', 'kalau', 'mau', 'unggah', 'media']","['tidak', 'kali', 'ya', 'pas', 'tambahin', 'media', 'kolom', 'pendidikan', 'pengalaman', 'tidak', 'bisa²', 'unggah', 'kayak', 'nya', 'linkedin', 'lambat', 'banget', 'kejadian', 'unggah', 'media', 'metode', 'link', 'gdrive', 'tidak', 'tolong', 'bug', 'kayak', 'perbaiki', 'tampilan', 'nya', 'bagus', 'lambat', 'nya', 'unggah', 'media']",63,35,28,tidak kali ya pas tambahin media kolom didik alam tidak bisa unggah kayak nya linkedin lambat banget jadi unggah media metode link gdrive tidak tolong bug kayak baik tampil nya bagus lambat nya unggah media,35,35
Saya sangat suka sama ablikasi linkdin untuk menambah wawasan saya,positif,2024-07-07,2024,saya sangat suka sama ablikasi linkdin untuk menambah wawasan saya,10,10,saya sangat suka sama ablikasi linkdin untuk menambah wawasan saya,10,10,"['saya', 'sangat', 'suka', 'sama', 'ablikasi', 'linkdin', 'untuk', 'menambah', 'wawasan', 'saya']","['suka', 'ablikasi', 'linkdin', 'menambah', 'wawasan']",10,5,5,suka ablikasi linkdin tambah wawas,5,5
Aplikasi sampah dengan tingkat keamanan yang sangat buruk. Akun saya di hack sekian lama baru ada pemberitahuan. Padahal udah verifikasi email juga no hp. Kenapa ada verifikasi diluar itu di biarkan sama linkedin . Kan parah tuh,negatif,2023-07-21,2023,aplikasi sampah dengan tingkat keamanan yang sangat buruk akun saya di hack sekian lama baru ada pemberitahuan padahal udah verifikasi email juga no hp kenapa ada verifikasi diluar itu di biarkan sama linkedin kan parah tuh,37,36,aplikasi sampah dengan tingkat keamanan yang sangat buruk akun saya di hack sekian lama baru ada pemberitahuan padahal sudah verifikasi email juga nomor handphone kenapa ada verifikasi diluar itu di biarkan sama linkedin akan parah tuh,36,36,"['aplikasi', 'sampah', 'dengan', 'tingkat', 'keamanan', 'yang', 'sangat', 'buruk', 'akun', 'saya', 'di', 'hack', 'sekian', 'lama', 'baru', 'ada', 'pemberitahuan', 'padahal', 'sudah', 'verifikasi', 'email', 'juga', 'nomor', 'handphone', 'kenapa', 'ada', 'verifikasi', 'diluar', 'itu', 'di', 'biarkan', 'sama', 'linkedin', 'akan', 'parah', 'tuh']","['aplikasi', 'sampah', 'tingkat', 'keamanan', 'buruk', 'akun', 'hack', 'sekian', 'pemberitahuan', 'verifikasi', 'email', 'nomor', 'handphone', 'verifikasi', 'diluar', 'biarkan', 'linkedin', 'parah', 'tuh']",36,19,17,aplikasi sampah tingkat aman buruk akun hack sekian pemberitahuan verifikasi email nomor handphone verifikasi luar biar linkedin parah tuh,19,19
"Hati-hati yang menggunakan Likedin. akun saya sekarang di hack oleh haker, saya sudah mengurus sesuai prosedur di Linkedin namun prosedur meminta saya login dengan akun saya, tapi masalahnya akun saya tidak dapat login karena sudah di ubah oleh haker. Saya sudah coba menghubungi pihak Likedin lewat email dan media sosial, responsnya hanya dari robot otomatis likedin, untuk masuk ke halaman help. Sudah mencoba ganti password dan verifikasi, tetapi selalu gagal verifikasi. Tolong direspon LInkedIn",negatif,2024-07-05,2024,hati hati yang menggunakan likedin akun saya sekarang di hack oleh haker saya sudah mengurus sesuai prosedur di linkedin namun prosedur meminta saya login dengan akun saya tapi masalahnya akun saya tidak dapat login karena sudah di ubah oleh haker saya sudah coba menghubungi pihak likedin lewat email dan media sosial responsnya hanya dari robot otomatis likedin untuk masuk ke halaman help sudah mencoba ganti password dan verifikasi tetapi selalu gagal verifikasi tolong direspon linkedin,74,75,hati hati yang menggunakan likedin akun saya sekarang di hack oleh haker saya sudah mengurus sesuai prosedur di linkedin namun prosedur meminta saya login dengan akun saya tapi masalahnya akun saya tidak dapat login karena sudah di ubah oleh haker saya sudah coba menghubungi pihak likedin lewat email dan media sosial responsnya hanya dari robot otomatis likedin untuk masuk ke halaman help sudah mencoba ganti password dan verifikasi tetapi selalu gagal verifikasi tolong direspons linkedin,75,75,"['hati', 'hati', 'yang', 'menggunakan', 'likedin', 'akun', 'saya', 'sekarang', 'di', 'hack', 'oleh', 'haker', 'saya', 'sudah', 'mengurus', 'sesuai', 'prosedur', 'di', 'linkedin', 'namun', 'prosedur', 'meminta', 'saya', 'login', 'dengan', 'akun', 'saya', 'tapi', 'masalahnya', 'akun', 'saya', 'tidak', 'dapat', 'login', 'karena', 'sudah', 'di', 'ubah', 'oleh', 'haker', 'saya', 'sudah', 'coba', 'menghubungi', 'pihak', 'likedin', 'lewat', 'email', 'dan', 'media', 'sosial', 'responsnya', 'hanya', 'dari', 'robot', 'otomatis', 'likedin', 'untuk', 'masuk', 'ke', 'halaman', 'help', 'sudah', 'mencoba', 'ganti', 'password', 'dan', 'verifikasi', 'tetapi', 'selalu', 'gagal', 'verifikasi', 'tolong', 'direspons', 'linkedin']","['hati', 'hati', 'likedin', 'akun', 'hack', 'haker', 'mengurus', 'sesuai', 'prosedur', 'linkedin', 'prosedur', 'login', 'akun', 'akun', 'tidak', 'login', 'ubah', 'haker', 'coba', 'menghubungi', 'likedin', 'email', 'media', 'sosial', 'responsnya', 'robot', 'otomatis', 'likedin', 'masuk', 'halaman', 'help', 'mencoba', 'ganti', 'password', 'verifikasi', 'gagal', 'verifikasi', 'tolong', 'direspons', 'linkedin']",75,40,35,hati hati likedin akun hack haker urus sesuai prosedur linkedin prosedur login akun akun tidak login ubah haker coba hubung likedin email media sosial respons robot otomatis likedin masuk halaman help coba ganti password verifikasi gagal verifikasi tolong respons linkedin,40,40
Wahh disini adalah tempat pencari kerja saya setelah aplikasi sebelah Aplikasi ini cukup bagus untuk freelance kayak kita,positif,2024-06-18,2024,wahh disini adalah tempat pencari kerja saya setelah aplikasi sebelah aplikasi ini cukup bagus untuk freelance kayak kita,18,18,wah disini adalah tempat pencari kerja saya setelah aplikasi sebelah aplikasi ini cukup bagus untuk freelance kayak kita,18,18,"['wah', 'disini', 'adalah', 'tempat', 'pencari', 'kerja', 'saya', 'setelah', 'aplikasi', 'sebelah', 'aplikasi', 'ini', 'cukup', 'bagus', 'untuk', 'freelance', 'kayak', 'kita']","['pencari', 'kerja', 'aplikasi', 'sebelah', 'aplikasi', 'bagus', 'freelance', 'kayak']",18,8,10,cari kerja aplikasi belah aplikasi bagus freelance kayak,8,8
Tolong hp saya secara teknis mumpuni tp kenapa setiap log in gak bsa tiba2 log out sendiri,negatif,2024-05-13,2024,tolong hp saya secara teknis mumpuni tp kenapa setiap log in gak bsa tiba log out sendiri,17,17,tolong handphone saya secara teknis mumpuni tapi kenapa setiap log in tidak bisa tiba log out sendiri,17,17,"['tolong', 'handphone', 'saya', 'secara', 'teknis', 'mumpuni', 'tapi', 'kenapa', 'setiap', 'log', 'in', 'tidak', 'bisa', 'tiba', 'log', 'out', 'sendiri']","['tolong', 'handphone', 'teknis', 'mumpuni', 'log', 'in', 'tidak', 'log', 'out']",17,9,8,tolong handphone teknis mumpuni log in tidak log out,9,9
"Aplikasinya rumit untuk verivikasi, saya hapus akun, kenapa tidak langsung terhapus ya. Sangat professional app ini.",negatif,2024-08-20,2024,aplikasinya rumit untuk verivikasi saya hapus akun kenapa tidak langsung terhapus ya sangat professional app ini,16,16,aplikasi nya rumit untuk verivikasi saya hapus akun kenapa tidak langsung terhapus ya sangat professional aplikasi ini,16,17,"['aplikasi', 'nya', 'rumit', 'untuk', 'verivikasi', 'saya', 'hapus', 'akun', 'kenapa', 'tidak', 'langsung', 'terhapus', 'ya', 'sangat', 'professional', 'aplikasi', 'ini']","['aplikasi', 'nya', 'rumit', 'verivikasi', 'hapus', 'akun', 'tidak', 'langsung', 'terhapus', 'ya', 'professional', 'aplikasi']",17,12,5,aplikasi nya rumit verivikasi hapus akun tidak langsung hapus ya professional aplikasi,12,12
"namanya sudah saya edit tapi tetap tidak bisa berubah, tidak dapat menambahkan huruf ""s""",negatif,2024-04-19,2024,namanya sudah saya edit tapi tetap tidak bisa berubah tidak dapat menambahkan huruf s,14,14,namanya sudah saya edit tapi tetap tidak bisa berubah tidak dapat menambahkan huruf s,14,14,"['namanya', 'sudah', 'saya', 'edit', 'tapi', 'tetap', 'tidak', 'bisa', 'berubah', 'tidak', 'dapat', 'menambahkan', 'huruf', 's']","['namanya', 'edit', 'tidak', 'berubah', 'tidak', 'huruf', 's']",14,7,7,nama edit tidak ubah tidak huruf s,7,7
"ga ada angin, ga ada hujan tiba² akun saya di batasi padahal gak pernah buat aneh² malah ingin cari kerja. mau verifikasi ribet bgt dan juga sistem UI nya makin berat, nyusahin org",negatif,2024-08-17,2024,ga ada angin ga ada hujan tiba² akun saya di batasi padahal gak pernah buat aneh² malah ingin cari kerja mau verifikasi ribet bgt dan juga sistem ui nya makin berat nyusahin org,33,33,tidak ada angin tidak ada hujan tiba² akun saya di batasi padahal tidak pernah buat aneh² bahkan ingin cari kerja mau verifikasi rumit banget dan juga sistem ui nya makin berat nyusahin orang,33,33,"['tidak', 'ada', 'angin', 'tidak', 'ada', 'hujan', 'tiba²', 'akun', 'saya', 'di', 'batasi', 'padahal', 'tidak', 'pernah', 'buat', 'aneh²', 'bahkan', 'ingin', 'cari', 'kerja', 'mau', 'verifikasi', 'rumit', 'banget', 'dan', 'juga', 'sistem', 'ui', 'nya', 'makin', 'berat', 'nyusahin', 'orang']","['tidak', 'angin', 'tidak', 'hujan', 'tiba²', 'akun', 'batasi', 'tidak', 'aneh²', 'cari', 'kerja', 'verifikasi', 'rumit', 'banget', 'sistem', 'ui', 'nya', 'berat', 'nyusahin', 'orang']",33,20,13,tidak angin tidak hujan tiba akun batas tidak aneh cari kerja verifikasi rumit banget sistem ui nya berat nyusahin orang,20,20
"Udah capek capek buat akun, baru berapa hari pake ke log out sendiri, trus gabisa login kocak bgt",negatif,2024-06-06,2024,udah capek capek buat akun baru berapa hari pake ke log out sendiri trus gabisa login kocak bgt,18,18,sudah capek capek buat akun baru berapa hari pakai ke log out sendiri terus tidak bisa login kocak banget,18,19,"['sudah', 'capek', 'capek', 'buat', 'akun', 'baru', 'berapa', 'hari', 'pakai', 'ke', 'log', 'out', 'sendiri', 'terus', 'tidak', 'bisa', 'login', 'kocak', 'banget']","['capek', 'capek', 'akun', 'pakai', 'log', 'out', 'tidak', 'login', 'kocak', 'banget']",19,10,9,capek capek akun pakai log out tidak login kocak banget,10,10
APLIKASI K000...NNT....00LLLLL.... MAU LOG IN AJA SUSAH AMAT VERIFIKASI NYA,negatif,2024-06-27,2024,aplikasi k nnt lllll mau log in aja susah amat verifikasi nya,10,12,aplikasi ke nanti lllll mau log in saja susah amat verifikasi nya,12,12,"['aplikasi', 'ke', 'nanti', 'lllll', 'mau', 'log', 'in', 'saja', 'susah', 'amat', 'verifikasi', 'nya']","['aplikasi', 'lllll', 'log', 'in', 'susah', 'verifikasi', 'nya']",12,7,5,aplikasi lllll log in susah verifikasi nya,7,7
Kenapa sih saat kita posting suatu hal malah keluar aplikasi? Dan loading penguploadannya ngestuck di angka tertentu mulu....... tolong diperbaiki lagi,negatif,2024-08-13,2024,kenapa sih saat kita posting suatu hal malah keluar aplikasi dan loading penguploadannya ngestuck di angka tertentu mulu tolong diperbaiki lagi,21,21,kenapa sih saat kita posting suatu hal bahkan keluar aplikasi dan loading penguploadannya ngestuck di angka tertentu mulu tolong di perbaiki lagi,21,22,"['kenapa', 'sih', 'saat', 'kita', 'posting', 'suatu', 'hal', 'bahkan', 'keluar', 'aplikasi', 'dan', 'loading', 'penguploadannya', 'ngestuck', 'di', 'angka', 'tertentu', 'mulu', 'tolong', 'di', 'perbaiki', 'lagi']","['sih', 'posting', 'aplikasi', 'loading', 'penguploadannya', 'ngestuck', 'angka', 'mulu', 'tolong', 'perbaiki']",22,10,12,sih posting aplikasi loading penguploadannya ngestuck angka mulu tolong baik,10,10
Membantu saya dalam hal mencari pekerjaan..,positif,2024-08-15,2024,membantu saya dalam hal mencari pekerjaan,6,6,membantu saya dalam hal mencari pekerjaan,6,6,"['membantu', 'saya', 'dalam', 'hal', 'mencari', 'pekerjaan']","['membantu', 'mencari', 'pekerjaan']",6,3,3,bantu cari kerja,3,3
"Mantap, semoga developer linkedin sehat sll",positif,2024-08-15,2024,mantap semoga developer linkedin sehat sll,6,6,mantap semoga developer linkedin sehat selalu,6,6,"['mantap', 'semoga', 'developer', 'linkedin', 'sehat', 'selalu']","['mantap', 'semoga', 'developer', 'linkedin', 'sehat']",6,5,1,mantap moga developer linkedin sehat,5,5
APK APAAN COBA GUA UDAH VERIFIKASI 5X GAGAL SEMUA ANEEEHHHH,negatif,2024-08-28,2024,apk apaan coba gua udah verifikasi x gagal semua aneeehhhh,10,10,aplikasi apa coba saya sudah verifikasi x gagal semua aneeehhhh,10,10,"['aplikasi', 'apa', 'coba', 'saya', 'sudah', 'verifikasi', 'x', 'gagal', 'semua', 'aneeehhhh']","['aplikasi', 'coba', 'verifikasi', 'x', 'gagal', 'aneeehhhh']",10,6,4,aplikasi coba verifikasi x gagal aneeehhhh,6,6
Berita yang sangat menggembirakan,positif,2024-08-11,2024,berita yang sangat menggembirakan,4,4,berita yang sangat menggembirakan,4,4,"['berita', 'yang', 'sangat', 'menggembirakan']","['berita', 'menggembirakan']",4,2,2,berita gembira,2,2
Verifnya susah banget,negatif,2024-08-26,2024,verifnya susah banget,3,3,verifnya susah banget,3,3,"['verifnya', 'susah', 'banget']","['verifnya', 'susah', 'banget']",3,3,0,verifnya susah banget,3,3
Aplikasi yang sangat berguna,positif,2024-08-12,2024,aplikasi yang sangat berguna,4,4,aplikasi yang sangat berguna,4,4,"['aplikasi', 'yang', 'sangat', 'berguna']","['aplikasi', 'berguna']",4,2,2,aplikasi guna,2,2
Mudah mencari jejaring loker,positif,2024-08-24,2024,mudah mencari jejaring loker,4,4,mudah mencari jejaring loker,4,4,"['mudah', 'mencari', 'jejaring', 'loker']","['mudah', 'mencari', 'jejaring', 'loker']",4,4,0,mudah cari jejaring loker,4,4
"Apk busuk dan di browser juga busuk masa harus menunggu lama dan tidak masuk"". Malah notip mari melakukan pemeriksaan keamanan cepat berjam"" menunggu begtu terus bagusan hapus aja apk nya di browser juga di hapus aja",negatif,2024-06-05,2024,apk busuk dan di browser juga busuk masa harus menunggu lama dan tidak masuk malah notip mari melakukan pemeriksaan keamanan cepat berjam menunggu begtu terus bagusan hapus aja apk nya di browser juga di hapus aja,36,36,aplikasi busuk dan di browser juga busuk masa harus menunggu lama dan tidak masuk bahkan notip mari melakukan pemeriksaan keamanan cepat berjam menunggu begtu terus bagusan hapus saja aplikasi nya di browser juga di hapus saja,36,36,"['aplikasi', 'busuk', 'dan', 'di', 'browser', 'juga', 'busuk', 'masa', 'harus', 'menunggu', 'lama', 'dan', 'tidak', 'masuk', 'bahkan', 'notip', 'mari', 'melakukan', 'pemeriksaan', 'keamanan', 'cepat', 'berjam', 'menunggu', 'begtu', 'terus', 'bagusan', 'hapus', 'saja', 'aplikasi', 'nya', 'di', 'browser', 'juga', 'di', 'hapus', 'saja']","['aplikasi', 'busuk', 'browser', 'busuk', 'menunggu', 'tidak', 'masuk', 'notip', 'mari', 'pemeriksaan', 'keamanan', 'cepat', 'berjam', 'menunggu', 'begtu', 'bagusan', 'hapus', 'aplikasi', 'nya', 'browser', 'hapus']",36,21,15,aplikasi busuk browser busuk tunggu tidak masuk notip mari periksa aman cepat jam tunggu begtu bagus hapus aplikasi nya browser hapus,21,21
ga jelas ga bisa login!!!,negatif,2024-07-21,2024,ga jelas ga bisa login,5,5,tidak jelas tidak bisa login,5,5,"['tidak', 'jelas', 'tidak', 'bisa', 'login']","['tidak', 'tidak', 'login']",5,3,2,tidak tidak login,3,3
Bagus sangat membantu,positif,2024-08-25,2024,bagus sangat membantu,3,3,bagus sangat membantu,3,3,"['bagus', 'sangat', 'membantu']","['bagus', 'membantu']",3,2,1,bagus bantu,2,2
"Memang aplikasi tolol, masuk ke akun sendiri aja susahnya minta ampun. Segala verifikasi, dibatasi, entahlah.",negatif,2024-05-21,2024,memang aplikasi tolol masuk ke akun sendiri aja susahnya minta ampun segala verifikasi dibatasi entahlah,15,15,memang aplikasi tolol masuk ke akun sendiri saja susahnya minta ampun segala verifikasi dibatasi entahlah,15,15,"['memang', 'aplikasi', 'tolol', 'masuk', 'ke', 'akun', 'sendiri', 'saja', 'susahnya', 'minta', 'ampun', 'segala', 'verifikasi', 'dibatasi', 'entahlah']","['aplikasi', 'tolol', 'masuk', 'akun', 'susahnya', 'ampun', 'verifikasi', 'dibatasi']",15,8,7,aplikasi tolol masuk akun susah ampun verifikasi batas,8,8
banner nya gmn sih kok jd bulet,negatif,2024-06-24,2024,banner nya gmn sih kok jd bulet,7,7,banner nya bagaimana sih kok jadi bulet,7,7,"['banner', 'nya', 'bagaimana', 'sih', 'kok', 'jadi', 'bulet']","['banner', 'nya', 'sih', 'bulet']",7,4,3,banner nya sih bulet,4,4
Sebel verifikasi domba menghadap ke atas yang kelima nya gagal trus sekali nya beres gagal,negatif,2024-06-25,2024,sebel verifikasi domba menghadap ke atas yang kelima nya gagal trus sekali nya beres gagal,15,15,sebel verifikasi domba menghadap ke atas yang kelima nya gagal terus sekali nya beres gagal,15,15,"['sebel', 'verifikasi', 'domba', 'menghadap', 'ke', 'atas', 'yang', 'kelima', 'nya', 'gagal', 'terus', 'sekali', 'nya', 'beres', 'gagal']","['sebel', 'verifikasi', 'domba', 'menghadap', 'nya', 'gagal', 'nya', 'beres', 'gagal']",15,9,6,sebel verifikasi domba hadap nya gagal nya beres gagal,9,9
KEMBALIIN AKUN GWW!!! GW GA POST KONTEN SENSITIF APAPUN DAN TIBA TIBA DI BATASI? KALIAN INI GIMANA POLA PIKIR NYA!!??,negatif,2024-08-09,2024,kembaliin akun gww gw ga post konten sensitif apapun dan tiba tiba di batasi kalian ini gimana pola pikir nya,20,20,kembaliin akun gww saya tidak post konten sensitif apapun dan tiba tiba di batasi kalian ini bagaimana pola pikir nya,20,20,"['kembaliin', 'akun', 'gww', 'saya', 'tidak', 'post', 'konten', 'sensitif', 'apapun', 'dan', 'tiba', 'tiba', 'di', 'batasi', 'kalian', 'ini', 'bagaimana', 'pola', 'pikir', 'nya']","['kembaliin', 'akun', 'gww', 'tidak', 'post', 'konten', 'sensitif', 'apapun', 'batasi', 'pola', 'pikir', 'nya']",20,12,8,kembaliin akun gww tidak post konten sensitif apa batas pola pikir nya,12,12
Aplikasi banyak membantu terhubung dengan para profesional tapi belum pernah ada yang deal dari jobseeker. Kebanyakan hanya sebagai formalitas saja untuk menggugurkan kewajiban mereka,positif,2024-06-28,2024,aplikasi banyak membantu terhubung dengan para profesional tapi belum pernah ada yang deal dari jobseeker kebanyakan hanya sebagai formalitas saja untuk menggugurkan kewajiban mereka,24,24,aplikasi banyak membantu terhubung dengan para profesional tapi belum pernah ada yang deal dari jobseeker kebanyakan hanya sebagai formalitas saja untuk menggugurkan kewajiban mereka,24,24,"['aplikasi', 'banyak', 'membantu', 'terhubung', 'dengan', 'para', 'profesional', 'tapi', 'belum', 'pernah', 'ada', 'yang', 'deal', 'dari', 'jobseeker', 'kebanyakan', 'hanya', 'sebagai', 'formalitas', 'saja', 'untuk', 'menggugurkan', 'kewajiban', 'mereka']","['aplikasi', 'membantu', 'terhubung', 'profesional', 'deal', 'jobseeker', 'kebanyakan', 'formalitas', 'menggugurkan', 'kewajiban']",24,10,14,aplikasi bantu hubung profesional deal jobseeker banyak formalitas gugur wajib,10,10
"tidak bisa log in dengan email dan nomor ponsel, kofe verification tidak oernah di terima, buruk sekali. sudah di coba puluhan kali tetap tidak bisa, baik itu pakai browers atau aplikasi. ini sangat buruk sekali",negatif,2023-09-17,2023,tidak bisa log in dengan email dan nomor ponsel kofe verification tidak oernah di terima buruk sekali sudah di coba puluhan kali tetap tidak bisa baik itu pakai browers atau aplikasi ini sangat buruk sekali,35,35,tidak bisa log in dengan email dan nomor ponsel kofe verification tidak oernah di terima buruk sekali sudah di coba puluhan kali tetap tidak bisa baik itu pakai browers atau aplikasi ini sangat buruk sekali,35,35,"['tidak', 'bisa', 'log', 'in', 'dengan', 'email', 'dan', 'nomor', 'ponsel', 'kofe', 'verification', 'tidak', 'oernah', 'di', 'terima', 'buruk', 'sekali', 'sudah', 'di', 'coba', 'puluhan', 'kali', 'tetap', 'tidak', 'bisa', 'baik', 'itu', 'pakai', 'browers', 'atau', 'aplikasi', 'ini', 'sangat', 'buruk', 'sekali']","['tidak', 'log', 'in', 'email', 'nomor', 'ponsel', 'kofe', 'verification', 'tidak', 'oernah', 'terima', 'buruk', 'coba', 'puluhan', 'kali', 'tidak', 'pakai', 'browers', 'aplikasi', 'buruk']",35,20,15,tidak log in email nomor ponsel kofe verification tidak oernah terima buruk coba puluh kali tidak pakai browers aplikasi buruk,20,20
"Tolong, saya tidak bisa login sama sekali. Awalnya saya melakukan kesalahan diawal, dan itu terus berlanjut hingga aplikasi tidak dapat dibuka sama sekali, hanya layar putih dengan glitch biru. Apakah ada solusi?",negatif,2024-07-07,2024,tolong saya tidak bisa login sama sekali awalnya saya melakukan kesalahan diawal dan itu terus berlanjut hingga aplikasi tidak dapat dibuka sama sekali hanya layar putih dengan glitch biru apakah ada solusi,32,32,tolong saya tidak bisa login sama sekali awalnya saya melakukan kesalahan diawal dan itu terus berlanjut hingga aplikasi tidak dapat dibuka sama sekali hanya layar putih dengan glitch biru apakah ada solusi,32,32,"['tolong', 'saya', 'tidak', 'bisa', 'login', 'sama', 'sekali', 'awalnya', 'saya', 'melakukan', 'kesalahan', 'diawal', 'dan', 'itu', 'terus', 'berlanjut', 'hingga', 'aplikasi', 'tidak', 'dapat', 'dibuka', 'sama', 'sekali', 'hanya', 'layar', 'putih', 'dengan', 'glitch', 'biru', 'apakah', 'ada', 'solusi']","['tolong', 'tidak', 'login', 'kesalahan', 'diawal', 'berlanjut', 'aplikasi', 'tidak', 'dibuka', 'layar', 'putih', 'glitch', 'biru', 'solusi']",32,14,18,tolong tidak login salah awal lanjut aplikasi tidak buka layar putih glitch biru solusi,14,14
"Hàlo, kenapa saat saya login pakai akun google ga bisa? Kemudian setelah saya coba hapus cache dan data malah ga bisa di buka. Ini kenapa ya?",negatif,2024-05-06,2024,hàlo kenapa saat saya login pakai akun google ga bisa kemudian setelah saya coba hapus cache dan data malah ga bisa di buka ini kenapa ya,26,26,hàlo kenapa saat saya login pakai akun google tidak bisa kemudian setelah saya coba hapus cache dan data bahkan tidak bisa di buka ini kenapa ya,26,26,"['hàlo', 'kenapa', 'saat', 'saya', 'login', 'pakai', 'akun', 'google', 'tidak', 'bisa', 'kemudian', 'setelah', 'saya', 'coba', 'hapus', 'cache', 'dan', 'data', 'bahkan', 'tidak', 'bisa', 'di', 'buka', 'ini', 'kenapa', 'ya']","['hàlo', 'login', 'pakai', 'akun', 'google', 'tidak', 'coba', 'hapus', 'cache', 'data', 'tidak', 'buka', 'ya']",26,13,13,h lo login pakai akun google tidak coba hapus cache data tidak buka ya,13,14
"Kebanyakan iklan,mau balik ke awal susah. Tdk epektif",negatif,2024-06-11,2024,kebanyakan iklan mau balik ke awal susah tdk epektif,8,9,kebanyakan iklan mau balik ke awal susah tidak epektif,9,9,"['kebanyakan', 'iklan', 'mau', 'balik', 'ke', 'awal', 'susah', 'tidak', 'epektif']","['kebanyakan', 'iklan', 'susah', 'tidak', 'epektif']",9,5,4,banyak iklan susah tidak epektif,5,5
"apk ga jelas, ga membantu",negatif,2024-06-28,2024,apk ga jelas ga membantu,5,5,aplikasi tidak jelas tidak membantu,5,5,"['aplikasi', 'tidak', 'jelas', 'tidak', 'membantu']","['aplikasi', 'tidak', 'tidak', 'membantu']",5,4,1,aplikasi tidak tidak bantu,4,4
"Aplikasi yang sangat membantu untuk mendapatkan pekerjaan, thankyouu LinkedIn~",positif,2024-04-26,2024,aplikasi yang sangat membantu untuk mendapatkan pekerjaan thankyouu linkedin,9,9,aplikasi yang sangat membantu untuk mendapatkan pekerjaan terima kasih linkedin,9,10,"['aplikasi', 'yang', 'sangat', 'membantu', 'untuk', 'mendapatkan', 'pekerjaan', 'terima', 'kasih', 'linkedin']","['aplikasi', 'membantu', 'pekerjaan', 'terima', 'kasih', 'linkedin']",10,6,4,aplikasi bantu kerja terima kasih linkedin,6,6
Aplikasi ini aneh kok aku udh 7hari gak login kok tiba-tiba akun saya louot terus saya masukin lagi eh malah suruh bikin akun lagi adeh enakkan bikin konten di Ig gak louot dan Gapang lagi Mana lagi verifikasi nya ribet banget udh kaya PLN mobil 😡,negatif,2024-06-11,2024,aplikasi ini aneh kok aku udh hari gak login kok tiba tiba akun saya louot terus saya masukin lagi eh malah suruh bikin akun lagi adeh enakkan bikin konten di ig gak louot dan gapang lagi mana lagi verifikasi nya ribet banget udh kaya pln mobil,46,46,aplikasi ini aneh kok aku sudah hari tidak login kok tiba tiba akun saya louot terus saya masukkan lagi eh bahkan suruh bikin akun lagi adeh enakkan bikin konten di instagram tidak louot dan gapang lagi mana lagi verifikasi nya rumit banget sudah kayak pln mobil,46,46,"['aplikasi', 'ini', 'aneh', 'kok', 'aku', 'sudah', 'hari', 'tidak', 'login', 'kok', 'tiba', 'tiba', 'akun', 'saya', 'louot', 'terus', 'saya', 'masukkan', 'lagi', 'eh', 'bahkan', 'suruh', 'bikin', 'akun', 'lagi', 'adeh', 'enakkan', 'bikin', 'konten', 'di', 'instagram', 'tidak', 'louot', 'dan', 'gapang', 'lagi', 'mana', 'lagi', 'verifikasi', 'nya', 'rumit', 'banget', 'sudah', 'kayak', 'pln', 'mobil']","['aplikasi', 'aneh', 'tidak', 'login', 'akun', 'louot', 'masukkan', 'eh', 'suruh', 'bikin', 'akun', 'adeh', 'enakkan', 'bikin', 'konten', 'instagram', 'tidak', 'louot', 'gapang', 'verifikasi', 'nya', 'rumit', 'banget', 'kayak', 'pln', 'mobil']",46,26,20,aplikasi aneh tidak login akun louot masuk eh suruh bikin akun adeh enak bikin konten instagram tidak louot gapang verifikasi nya rumit banget kayak pln mobil,26,26
"Mau log in Gx bisa , di persulit gagal terus mau log in padahal sudah ngikutin arahan nya tapi tetep gagal , Lanjut pake FB GX bisa , lanjut pake nomor hp GX bisa, lanjut pake google pun GX bisa ...di suruh masukin kode tapi saya GX Nerima kode SMS atau apapun itu .... Gimna mau log in klo gitu",negatif,2024-06-13,2024,mau log in gx bisa di persulit gagal terus mau log in padahal sudah ngikutin arahan nya tapi tetep gagal lanjut pake fb gx bisa lanjut pake nomor hp gx bisa lanjut pake google pun gx bisa di suruh masukin kode tapi saya gx nerima kode sms atau apapun itu gimna mau log in klo gitu,60,56,mau log in tidak bisa di persulit gagal terus mau log in padahal sudah ngikutin arahan nya tapi tetap gagal lanjut pakai fb tidak bisa lanjut pakai nomor handphone tidak bisa lanjut pakai google pun tidak bisa di suruh masukkan kode tapi saya tidak terima kode sms atau apapun itu bagaimana mau log in kalau begitu,56,56,"['mau', 'log', 'in', 'tidak', 'bisa', 'di', 'persulit', 'gagal', 'terus', 'mau', 'log', 'in', 'padahal', 'sudah', 'ngikutin', 'arahan', 'nya', 'tapi', 'tetap', 'gagal', 'lanjut', 'pakai', 'fb', 'tidak', 'bisa', 'lanjut', 'pakai', 'nomor', 'handphone', 'tidak', 'bisa', 'lanjut', 'pakai', 'google', 'pun', 'tidak', 'bisa', 'di', 'suruh', 'masukkan', 'kode', 'tapi', 'saya', 'tidak', 'terima', 'kode', 'sms', 'atau', 'apapun', 'itu', 'bagaimana', 'mau', 'log', 'in', 'kalau', 'begitu']","['log', 'in', 'tidak', 'persulit', 'gagal', 'log', 'in', 'ngikutin', 'arahan', 'nya', 'gagal', 'pakai', 'fb', 'tidak', 'pakai', 'nomor', 'handphone', 'tidak', 'pakai', 'google', 'tidak', 'suruh', 'masukkan', 'kode', 'tidak', 'terima', 'kode', 'sms', 'apapun', 'log', 'in']",56,31,25,log in tidak sulit gagal log in ngikutin arah nya gagal pakai fb tidak pakai nomor handphone tidak pakai google tidak suruh masuk kode tidak terima kode sms apa log in,31,31
"Apasi lu kesel bgt gua, masuk harus ada puzzle yang kucing warna putih atau ga kodok warna putih yang milih liat keatas udah sejam gue otak atik puzzle itu sampe dibantuin sama pacar guaaa sampe nangis karna kesell, lu ayo maju deh sini, udah bener sekali malah dikasih puzzle teruss MUAK GUE",negatif,2024-06-28,2024,apasi lu kesel bgt gua masuk harus ada puzzle yang kucing warna putih atau ga kodok warna putih yang milih liat keatas udah sejam gue otak atik puzzle itu sampe dibantuin sama pacar guaaa sampe nangis karna kesell lu ayo maju deh sini udah bener sekali malah dikasih puzzle teruss muak gue,52,52,apasi lu kesel banget saya masuk harus ada puzzle yang kucing warna putih atau tidak kodok warna putih yang memilih lihat keatas sudah sejam saya otak atik puzzle itu sampai dibantuin sama pacar guaaa sampai nangis karena kesell lu ayo maju deh sini sudah benar sekali bahkan dikasih puzzle terus muak saya,52,52,"['apasi', 'lu', 'kesel', 'banget', 'saya', 'masuk', 'harus', 'ada', 'puzzle', 'yang', 'kucing', 'warna', 'putih', 'atau', 'tidak', 'kodok', 'warna', 'putih', 'yang', 'memilih', 'lihat', 'keatas', 'sudah', 'sejam', 'saya', 'otak', 'atik', 'puzzle', 'itu', 'sampai', 'dibantuin', 'sama', 'pacar', 'guaaa', 'sampai', 'nangis', 'karena', 'kesell', 'lu', 'ayo', 'maju', 'deh', 'sini', 'sudah', 'benar', 'sekali', 'bahkan', 'dikasih', 'puzzle', 'terus', 'muak', 'saya']","['apasi', 'lu', 'kesel', 'banget', 'masuk', 'puzzle', 'kucing', 'warna', 'putih', 'tidak', 'kodok', 'warna', 'putih', 'memilih', 'lihat', 'keatas', 'sejam', 'otak', 'atik', 'puzzle', 'dibantuin', 'pacar', 'guaaa', 'nangis', 'kesell', 'lu', 'ayo', 'maju', 'deh', 'dikasih', 'puzzle', 'muak']",52,32,20,apas lu kesel banget masuk puzzle kucing warna putih tidak kodok warna putih pilih lihat atas jam otak atik puzzle dibantuin pacar guaaa nang kesell lu ayo maju deh kasih puzzle muak,32,32
"Banyak bug, upload video ada glitch, malah balik ke menu utama. Komen sebagai company ribet Heran, ini kan aplikasinya Microsoft, tapi bug dan fiturnya masih kurang optimal",negatif,2020-09-18,2020,banyak bug upload video ada glitch malah balik ke menu utama komen sebagai company ribet heran ini kan aplikasinya microsoft tapi bug dan fiturnya masih kurang optimal,27,27,banyak bug unggah video ada glitch bahkan balik ke menu utama komen sebagai perusahaan rumit heran ini akan aplikasi nya microsoft tapi bug dan fitur nya masih kurang optimal,27,29,"['banyak', 'bug', 'unggah', 'video', 'ada', 'glitch', 'bahkan', 'balik', 'ke', 'menu', 'utama', 'komen', 'sebagai', 'perusahaan', 'rumit', 'heran', 'ini', 'akan', 'aplikasi', 'nya', 'microsoft', 'tapi', 'bug', 'dan', 'fitur', 'nya', 'masih', 'kurang', 'optimal']","['bug', 'unggah', 'video', 'glitch', 'menu', 'utama', 'komen', 'perusahaan', 'rumit', 'heran', 'aplikasi', 'nya', 'microsoft', 'bug', 'fitur', 'nya', 'optimal']",29,17,12,bug unggah video glitch menu utama komen usaha rumit heran aplikasi nya microsoft bug fitur nya optimal,17,17
"Aplikasi buruk! Aku sudah buat akun baru dengan google awalnya, lancar aja, pas beberapa hari malah suruh login lagi. Loginnya gak nyambung-nyambung , gue udah login udah upload ktp malah balikin mulu ke menu login. Kalo bukan karena tugas univ ya gak peduli",negatif,2023-08-09,2023,aplikasi buruk aku sudah buat akun baru dengan google awalnya lancar aja pas beberapa hari malah suruh login lagi loginnya gak nyambung nyambung gue udah login udah upload ktp malah balikin mulu ke menu login kalo bukan karena tugas univ ya gak peduli,43,43,aplikasi buruk aku sudah buat akun baru dengan google awalnya lancar saja pas beberapa hari bahkan suruh login lagi loginnya tidak nyambung nyambung saya sudah login sudah unggah ktp bahkan balikin mulu ke menu login kalau bukan karena tugas univ ya tidak peduli,43,43,"['aplikasi', 'buruk', 'aku', 'sudah', 'buat', 'akun', 'baru', 'dengan', 'google', 'awalnya', 'lancar', 'saja', 'pas', 'beberapa', 'hari', 'bahkan', 'suruh', 'login', 'lagi', 'loginnya', 'tidak', 'nyambung', 'nyambung', 'saya', 'sudah', 'login', 'sudah', 'unggah', 'ktp', 'bahkan', 'balikin', 'mulu', 'ke', 'menu', 'login', 'kalau', 'bukan', 'karena', 'tugas', 'univ', 'ya', 'tidak', 'peduli']","['aplikasi', 'buruk', 'akun', 'google', 'lancar', 'pas', 'suruh', 'login', 'loginnya', 'tidak', 'nyambung', 'nyambung', 'login', 'unggah', 'ktp', 'balikin', 'mulu', 'menu', 'login', 'tugas', 'univ', 'ya', 'tidak', 'peduli']",43,24,19,aplikasi buruk akun google lancar pas suruh login loginnya tidak nyambung nyambung login unggah ktp balikin mulu menu login tugas univ ya tidak peduli,24,24
"Saya sudah pilih email selain default waktu daftar, tapi yang terisi malah email default. Hasilnya banyak lamaran yang cocok tapi cuma dilihat karena email berbeda dengan di cv dan kurang profesional. Mohon dibenahi lagi, terutama bug seperti ini yang sangat krusial bagi pelamar",negatif,2023-08-30,2023,saya sudah pilih email selain default waktu daftar tapi yang terisi malah email default hasilnya banyak lamaran yang cocok tapi cuma dilihat karena email berbeda dengan di cv dan kurang profesional mohon dibenahi lagi terutama bug seperti ini yang sangat krusial bagi pelamar,43,43,saya sudah pilih email selain default waktu daftar tapi yang terisi bahkan email default hasilnya banyak lamaran yang cocok tapi cuma dilihat karena email berbeda dengan di cv dan kurang profesional mohon dibenahi lagi terutama bug seperti ini yang sangat krusial bagi pelamar,43,43,"['saya', 'sudah', 'pilih', 'email', 'selain', 'default', 'waktu', 'daftar', 'tapi', 'yang', 'terisi', 'bahkan', 'email', 'default', 'hasilnya', 'banyak', 'lamaran', 'yang', 'cocok', 'tapi', 'cuma', 'dilihat', 'karena', 'email', 'berbeda', 'dengan', 'di', 'cv', 'dan', 'kurang', 'profesional', 'mohon', 'dibenahi', 'lagi', 'terutama', 'bug', 'seperti', 'ini', 'yang', 'sangat', 'krusial', 'bagi', 'pelamar']","['pilih', 'email', 'default', 'daftar', 'terisi', 'email', 'default', 'hasilnya', 'lamaran', 'cocok', 'email', 'berbeda', 'cv', 'profesional', 'mohon', 'dibenahi', 'bug', 'krusial', 'pelamar']",43,19,24,pilih email default daftar isi email default hasil lamar cocok email beda cv profesional mohon benah bug krusial lamar,19,19
"Aplikasi yang hanya memandang orang sebelah mata, dia kaya, cantik, apalagi smart udh pasti dipanggil, lain hal nya saya yg juga profesional tapi belom terkenal. Memang blm punya karya mana pernah dipandang. Emanng pilih kasih perusahaan yg terdaftar di linked ini. Kasian bagi org yg baru lulus nyari kerja. Tp ga pernah dilirik. Kecewa sih... Sangat kecewwaaaa.....",negatif,2022-02-11,2022,aplikasi yang hanya memandang orang sebelah mata dia kaya cantik apalagi smart udh pasti dipanggil lain hal nya saya yg juga profesional tapi belom terkenal memang blm punya karya mana pernah dipandang emanng pilih kasih perusahaan yg terdaftar di linked ini kasian bagi org yg baru lulus nyari kerja tp ga pernah dilirik kecewa sih sangat kecewwaaaa,57,57,aplikasi yang hanya memandang orang sebelah mata dia kayak cantik apalagi smart sudah pasti dipanggil lain hal nya saya yang juga profesional tapi belum terkenal memang belum punya karya mana pernah dipandang emanng pilih kasih perusahaan yang terdaftar di linked ini kasian bagi orang yang baru lulus mencari kerja tapi tidak pernah dilirik kecewa sih sangat kecewwaaaa,57,57,"['aplikasi', 'yang', 'hanya', 'memandang', 'orang', 'sebelah', 'mata', 'dia', 'kayak', 'cantik', 'apalagi', 'smart', 'sudah', 'pasti', 'dipanggil', 'lain', 'hal', 'nya', 'saya', 'yang', 'juga', 'profesional', 'tapi', 'belum', 'terkenal', 'memang', 'belum', 'punya', 'karya', 'mana', 'pernah', 'dipandang', 'emanng', 'pilih', 'kasih', 'perusahaan', 'yang', 'terdaftar', 'di', 'linked', 'ini', 'kasian', 'bagi', 'orang', 'yang', 'baru', 'lulus', 'mencari', 'kerja', 'tapi', 'tidak', 'pernah', 'dilirik', 'kecewa', 'sih', 'sangat', 'kecewwaaaa']","['aplikasi', 'memandang', 'orang', 'sebelah', 'mata', 'kayak', 'cantik', 'smart', 'dipanggil', 'nya', 'profesional', 'terkenal', 'karya', 'dipandang', 'emanng', 'pilih', 'kasih', 'perusahaan', 'terdaftar', 'linked', 'kasian', 'orang', 'lulus', 'mencari', 'kerja', 'tidak', 'dilirik', 'kecewa', 'sih', 'kecewwaaaa']",57,30,27,aplikasi pandang orang belah mata kayak cantik smart panggil nya profesional kenal karya pandang emanng pilih kasih usaha daftar linked kasi orang lulus cari kerja tidak lirik kecewa sih kecewwaaaa,30,30
"Halo linkedin, kenapa ya aplikasi saya terus mendebit ATM, langganan setiap bulan ? Padahal sudah saya unconnect kartu debitnya, dan settimg aplikasi google saya pun.. tidak berlangganan akun linkedin.. sia sia. saya sekali rasanya setiap 29 dollar padahal masa resesi seperti ini.. Tolong di respon donk..",negatif,2020-09-02,2020,halo linkedin kenapa ya aplikasi saya terus mendebit atm langganan setiap bulan padahal sudah saya unconnect kartu debitnya dan settimg aplikasi google saya pun tidak berlangganan akun linkedin sia sia saya sekali rasanya setiap dollar padahal masa resesi seperti ini tolong di respon donk,46,44,halo linkedin kenapa ya aplikasi saya terus mendebit atm langganan setiap bulan padahal sudah saya unconnect kartu debitnya dan settimg aplikasi google saya pun tidak berlangganan akun linkedin sia sia saya sekali rasanya setiap dollar padahal masa resesi seperti ini tolong di respons dong,44,44,"['halo', 'linkedin', 'kenapa', 'ya', 'aplikasi', 'saya', 'terus', 'mendebit', 'atm', 'langganan', 'setiap', 'bulan', 'padahal', 'sudah', 'saya', 'unconnect', 'kartu', 'debitnya', 'dan', 'settimg', 'aplikasi', 'google', 'saya', 'pun', 'tidak', 'berlangganan', 'akun', 'linkedin', 'sia', 'sia', 'saya', 'sekali', 'rasanya', 'setiap', 'dollar', 'padahal', 'masa', 'resesi', 'seperti', 'ini', 'tolong', 'di', 'respons', 'dong']","['halo', 'linkedin', 'ya', 'aplikasi', 'mendebit', 'atm', 'langganan', 'unconnect', 'kartu', 'debitnya', 'settimg', 'aplikasi', 'google', 'tidak', 'berlangganan', 'akun', 'linkedin', 'sia', 'sia', 'dollar', 'resesi', 'tolong', 'respons']",44,23,21,halo linkedin ya aplikasi debit atm langgan unconnect kartu debit settimg aplikasi google tidak langgan akun linkedin sia sia dollar resesi tolong respons,23,23
"Mau log in aja susah banget, bikin verifikas log ini nya gausah ribet ribet lah, ""pilih gambar yang menghadap ke atas"" Udah bener juga salah mulu gabisa log in. Mending di bikin verifikasi masukan kata aja sih, gak ribet simpel",negatif,2023-06-06,2023,mau log in aja susah banget bikin verifikas log ini nya gausah ribet ribet lah pilih gambar yang menghadap ke atas udah bener juga salah mulu gabisa log in mending di bikin verifikasi masukan kata aja sih gak ribet simpel,40,40,mau log in saja susah banget bikin verifikas log ini nya tidak perlu rumit rumit lah pilih gambar yang menghadap ke atas sudah benar juga salah mulu tidak bisa log in mending di bikin verifikasi masukan kata saja sih tidak rumit simpel,40,42,"['mau', 'log', 'in', 'saja', 'susah', 'banget', 'bikin', 'verifikas', 'log', 'ini', 'nya', 'tidak', 'perlu', 'rumit', 'rumit', 'lah', 'pilih', 'gambar', 'yang', 'menghadap', 'ke', 'atas', 'sudah', 'benar', 'juga', 'salah', 'mulu', 'tidak', 'bisa', 'log', 'in', 'mending', 'di', 'bikin', 'verifikasi', 'masukan', 'kata', 'saja', 'sih', 'tidak', 'rumit', 'simpel']","['log', 'in', 'susah', 'banget', 'bikin', 'verifikas', 'log', 'nya', 'tidak', 'rumit', 'rumit', 'pilih', 'gambar', 'menghadap', 'salah', 'mulu', 'tidak', 'log', 'in', 'mending', 'bikin', 'verifikasi', 'masukan', 'sih', 'tidak', 'rumit', 'simpel']",42,27,15,log in susah banget bikin verifikas log nya tidak rumit rumit pilih gambar hadap salah mulu tidak log in mending bikin verifikasi masuk sih tidak rumit simpel,27,27
"LinkedIn sangant membantu untuk para jobseeker mencari informasi, namun ada yg saya sayangkan terkadang koneksi internet tersendat padahal koneksi internet saya bagus. Sedikit saran untuk memperbaiki koneksi yg tersendat agar diperbaiki lg. Terimakasih",positif,2021-11-15,2021,linkedin sangant membantu untuk para jobseeker mencari informasi namun ada yg saya sayangkan terkadang koneksi internet tersendat padahal koneksi internet saya bagus sedikit saran untuk memperbaiki koneksi yg tersendat agar diperbaiki lg terimakasih,33,33,linkedin sangat membantu untuk para jobseeker mencari informasi namun ada yang saya sayangkan terkadang koneksi internet tersendat padahal koneksi internet saya bagus sedikit saran untuk memperbaiki koneksi yang tersendat agar di perbaiki lagi terima kasih,33,35,"['linkedin', 'sangat', 'membantu', 'untuk', 'para', 'jobseeker', 'mencari', 'informasi', 'namun', 'ada', 'yang', 'saya', 'sayangkan', 'terkadang', 'koneksi', 'internet', 'tersendat', 'padahal', 'koneksi', 'internet', 'saya', 'bagus', 'sedikit', 'saran', 'untuk', 'memperbaiki', 'koneksi', 'yang', 'tersendat', 'agar', 'di', 'perbaiki', 'lagi', 'terima', 'kasih']","['linkedin', 'membantu', 'jobseeker', 'mencari', 'informasi', 'sayangkan', 'terkadang', 'koneksi', 'internet', 'tersendat', 'koneksi', 'internet', 'bagus', 'saran', 'memperbaiki', 'koneksi', 'tersendat', 'perbaiki', 'terima', 'kasih']",35,20,15,linkedin bantu jobseeker cari informasi sayang terkadang koneksi internet sendat koneksi internet bagus saran baik koneksi sendat baik terima kasih,20,20
"Ada apa dengan Linked???????kemarin nge refresh status ga bisa, coba logout sampe uninstal dan di instal kembali, di minta login ehhhhh kenapa ga bisa Tidak bisa Login Kembali.....bahkan untuk mengganti Password pun ga bisa?????apa yang salah dalam beberapa hari ini",negatif,2020-12-25,2020,ada apa dengan linked kemarin nge refresh status ga bisa coba logout sampe uninstal dan di instal kembali di minta login ehhhhh kenapa ga bisa tidak bisa login kembali bahkan untuk mengganti password pun ga bisa apa yang salah dalam beberapa hari ini,40,43,ada apa dengan linked kemarin nge refresh status tidak bisa coba logout sampai hapus instalan dan di memasang kembali di minta login ehhhhh kenapa tidak bisa tidak bisa login kembali bahkan untuk mengganti password pun tidak bisa apa yang salah dalam beberapa hari ini,43,44,"['ada', 'apa', 'dengan', 'linked', 'kemarin', 'nge', 'refresh', 'status', 'tidak', 'bisa', 'coba', 'logout', 'sampai', 'hapus', 'instalan', 'dan', 'di', 'memasang', 'kembali', 'di', 'minta', 'login', 'ehhhhh', 'kenapa', 'tidak', 'bisa', 'tidak', 'bisa', 'login', 'kembali', 'bahkan', 'untuk', 'mengganti', 'password', 'pun', 'tidak', 'bisa', 'apa', 'yang', 'salah', 'dalam', 'beberapa', 'hari', 'ini']","['linked', 'kemarin', 'nge', 'refresh', 'status', 'tidak', 'coba', 'logout', 'hapus', 'instalan', 'memasang', 'login', 'ehhhhh', 'tidak', 'tidak', 'login', 'mengganti', 'password', 'tidak', 'salah']",44,20,24,linked kemarin nge refresh status tidak coba logout hapus instalan pasang login ehhhhh tidak tidak login ganti password tidak salah,20,20
"masih sangat teramat banyak loker abal2 palsu yg muncul , apa dari sistim , IT nya ga verivikasi ke komplit an / ke absah an dari PT / CV nya , dan juga dipilih domisili A , yg nongol daerah lain , jauh2 pula , lucu banget ini aplikasi .. IT nya newbie ya ??",negatif,2021-08-29,2021,masih sangat teramat banyak loker abal palsu yg muncul apa dari sistim it nya ga verivikasi ke komplit an ke absah an dari pt cv nya dan juga dipilih domisili a yg nongol daerah lain jauh pula lucu banget ini aplikasi it nya newbie ya,55,45,masih sangat amat banyak loker abal palsu yang muncul apa dari sistem it nya tidak verivikasi ke komplet an ke absah an dari perseroan terbatas cv nya dan juga dipilih domisili a yang nongol daerah lain jauh pula lucu banget ini aplikasi it nya newbie ya,45,46,"['masih', 'sangat', 'amat', 'banyak', 'loker', 'abal', 'palsu', 'yang', 'muncul', 'apa', 'dari', 'sistem', 'it', 'nya', 'tidak', 'verivikasi', 'ke', 'komplet', 'an', 'ke', 'absah', 'an', 'dari', 'perseroan', 'terbatas', 'cv', 'nya', 'dan', 'juga', 'dipilih', 'domisili', 'a', 'yang', 'nongol', 'daerah', 'lain', 'jauh', 'pula', 'lucu', 'banget', 'ini', 'aplikasi', 'it', 'nya', 'newbie', 'ya']","['loker', 'abal', 'palsu', 'muncul', 'sistem', 'it', 'nya', 'tidak', 'verivikasi', 'komplet', 'an', 'absah', 'an', 'perseroan', 'terbatas', 'cv', 'nya', 'dipilih', 'domisili', 'a', 'nongol', 'daerah', 'lucu', 'banget', 'aplikasi', 'it', 'nya', 'newbie', 'ya']",46,29,17,loker abal palsu muncul sistem it nya tidak verivikasi komplet an absah an persero batas cv nya pilih domisili a nongol daerah lucu banget aplikasi it nya newbie ya,29,29
"Untuk proses log in sangat sulit sekali, ketika lupa password. Tetapi ketika password sudah benar malah di nonaktifkan akunnya. Payah sekali linkedln",negatif,2021-12-17,2021,untuk proses log in sangat sulit sekali ketika lupa password tetapi ketika password sudah benar malah di nonaktifkan akunnya payah sekali linkedln,22,22,untuk proses log in sangat sulit sekali ketika lupa password tetapi ketika password sudah benar bahkan di nonaktifkan akunnya payah sekali linkedln,22,22,"['untuk', 'proses', 'log', 'in', 'sangat', 'sulit', 'sekali', 'ketika', 'lupa', 'password', 'tetapi', 'ketika', 'password', 'sudah', 'benar', 'bahkan', 'di', 'nonaktifkan', 'akunnya', 'payah', 'sekali', 'linkedln']","['proses', 'log', 'in', 'sulit', 'lupa', 'password', 'password', 'nonaktifkan', 'akunnya', 'payah', 'linkedln']",22,11,11,proses log in sulit lupa password password nonaktif akun payah linkedln,11,11
"Sangat membantu dalam mencari pekerjaan, relasi dan pengetahuan serta menyalurkan ilmu, bakat, usaha yg dapat mempermudah setiap orang di dunia untuk saling mengisi dan menimpa ilmu setiap individu yg berkarakter maju, unggul, tangguh yg berkepribadian kuat. Saya sungguh takjub dgn aplikasih ini yg begitu akurat, terpercaya, yg banyak dipercaya oleh manusia untuk mengembangkan setiap bakat, ilmu, talenta, ekonomi, tekhnologi, kemanusian dan masih banyak lagi. Semoga aplikasi ini tetap salalu ada",positif,2020-06-20,2020,sangat membantu dalam mencari pekerjaan relasi dan pengetahuan serta menyalurkan ilmu bakat usaha yg dapat mempermudah setiap orang di dunia untuk saling mengisi dan menimpa ilmu setiap individu yg berkarakter maju unggul tangguh yg berkepribadian kuat saya sungguh takjub dgn aplikasih ini yg begitu akurat terpercaya yg banyak dipercaya oleh manusia untuk mengembangkan setiap bakat ilmu talenta ekonomi tekhnologi kemanusian dan masih banyak lagi semoga aplikasi ini tetap salalu ada,70,70,sangat membantu dalam mencari pekerjaan relasi dan pengetahuan serta menyalurkan ilmu bakat usaha yang dapat mempermudah setiap orang di dunia untuk saling mengisi dan menimpa ilmu setiap individu yang berkarakter maju unggul tangguh yang berkepribadian kuat saya sungguh takjub dengan aplikasih ini yang begitu akurat terpercaya yang banyak dipercaya oleh manusia untuk mengembangkan setiap bakat ilmu talenta ekonomi tekhnologi kemanusian dan masih banyak lagi semoga aplikasi ini tetap salalu ada,70,70,"['sangat', 'membantu', 'dalam', 'mencari', 'pekerjaan', 'relasi', 'dan', 'pengetahuan', 'serta', 'menyalurkan', 'ilmu', 'bakat', 'usaha', 'yang', 'dapat', 'mempermudah', 'setiap', 'orang', 'di', 'dunia', 'untuk', 'saling', 'mengisi', 'dan', 'menimpa', 'ilmu', 'setiap', 'individu', 'yang', 'berkarakter', 'maju', 'unggul', 'tangguh', 'yang', 'berkepribadian', 'kuat', 'saya', 'sungguh', 'takjub', 'dengan', 'aplikasih', 'ini', 'yang', 'begitu', 'akurat', 'terpercaya', 'yang', 'banyak', 'dipercaya', 'oleh', 'manusia', 'untuk', 'mengembangkan', 'setiap', 'bakat', 'ilmu', 'talenta', 'ekonomi', 'tekhnologi', 'kemanusian', 'dan', 'masih', 'banyak', 'lagi', 'semoga', 'aplikasi', 'ini', 'tetap', 'salalu', 'ada']","['membantu', 'mencari', 'pekerjaan', 'relasi', 'pengetahuan', 'menyalurkan', 'ilmu', 'bakat', 'usaha', 'mempermudah', 'orang', 'dunia', 'mengisi', 'menimpa', 'ilmu', 'individu', 'berkarakter', 'maju', 'unggul', 'tangguh', 'berkepribadian', 'kuat', 'sungguh', 'takjub', 'aplikasih', 'akurat', 'terpercaya', 'dipercaya', 'manusia', 'mengembangkan', 'bakat', 'ilmu', 'talenta', 'ekonomi', 'tekhnologi', 'kemanusian', 'semoga', 'aplikasi', 'salalu']",70,39,31,bantu cari kerja relasi tahu salur ilmu bakat usaha mudah orang dunia isi timpa ilmu individu karakter maju unggul tangguh pribadi kuat sungguh takjub aplikasih akurat percaya percaya manusia kembang bakat ilmu talenta ekonomi tekhnologi kemanusian moga aplikasi salalu,39,39
"Meskipun memakai tidak terlalu sering,saya pakak linkedin merasa profesional dalam bidang saya. Fitur lengkap dan ringkas. Tapi, untuk loker kadang masih membuka link yang baru terkadang membuat binggung",negatif,2021-04-21,2021,meskipun memakai tidak terlalu sering saya pakak linkedin merasa profesional dalam bidang saya fitur lengkap dan ringkas tapi untuk loker kadang masih membuka link yang baru terkadang membuat binggung,28,29,meskipun memakai tidak terlalu sering saya pakak linkedin merasa profesional dalam bidang saya fitur lengkap dan ringkas tapi untuk loker kadang masih membuka link yang baru terkadang membuat binggung,29,29,"['meskipun', 'memakai', 'tidak', 'terlalu', 'sering', 'saya', 'pakak', 'linkedin', 'merasa', 'profesional', 'dalam', 'bidang', 'saya', 'fitur', 'lengkap', 'dan', 'ringkas', 'tapi', 'untuk', 'loker', 'kadang', 'masih', 'membuka', 'link', 'yang', 'baru', 'terkadang', 'membuat', 'binggung']","['memakai', 'tidak', 'pakak', 'linkedin', 'profesional', 'bidang', 'fitur', 'lengkap', 'ringkas', 'loker', 'kadang', 'membuka', 'link', 'terkadang', 'binggung']",29,15,14,pakai tidak pakak linkedin profesional bidang fitur lengkap ringkas loker kadang buka link terkadang binggung,15,15
"Tolong dong, untuk lowongan yang sudah di apply / sudah dilamar (direspon/tidak oleh perusahaan), tolong agar tidak ditampilkan lagi di beranda/pencarian dan tidak perlu lagi di email pemberitahuan pekerjaan baru. Lebih baik di infokan pekerjaan baru yang belum pernah di apply sebelum nya, Terima Kasih.",negatif,2022-04-18,2022,tolong dong untuk lowongan yang sudah di apply sudah dilamar direspon tidak oleh perusahaan tolong agar tidak ditampilkan lagi di beranda pencarian dan tidak perlu lagi di email pemberitahuan pekerjaan baru lebih baik di infokan pekerjaan baru yang belum pernah di apply sebelum nya terima kasih,45,46,tolong dong untuk lowongan yang sudah di apply sudah dilamar direspons tidak oleh perusahaan tolong agar tidak ditampilkan lagi di beranda pencarian dan tidak perlu lagi di email pemberitahuan pekerjaan baru lebih baik di informasikan pekerjaan baru yang belum pernah di apply sebelum nya terima kasih,46,46,"['tolong', 'dong', 'untuk', 'lowongan', 'yang', 'sudah', 'di', 'apply', 'sudah', 'dilamar', 'direspons', 'tidak', 'oleh', 'perusahaan', 'tolong', 'agar', 'tidak', 'ditampilkan', 'lagi', 'di', 'beranda', 'pencarian', 'dan', 'tidak', 'perlu', 'lagi', 'di', 'email', 'pemberitahuan', 'pekerjaan', 'baru', 'lebih', 'baik', 'di', 'informasikan', 'pekerjaan', 'baru', 'yang', 'belum', 'pernah', 'di', 'apply', 'sebelum', 'nya', 'terima', 'kasih']","['tolong', 'lowongan', 'apply', 'dilamar', 'direspons', 'tidak', 'perusahaan', 'tolong', 'tidak', 'ditampilkan', 'beranda', 'pencarian', 'tidak', 'email', 'pemberitahuan', 'pekerjaan', 'informasikan', 'pekerjaan', 'apply', 'nya', 'terima', 'kasih']",46,22,24,tolong lowong apply lamar respons tidak usaha tolong tidak tampil beranda cari tidak email pemberitahuan kerja informasi kerja apply nya terima kasih,22,22
Verifikasi ya kok semakin ribet Udh d jawab dengan suara berhasil lalu d alihkan ke tebak gambar dengan cepat sudah di jawab salah lagi dan sudah berkali kali masih salah. Uninstall lagi lah. Ribet...,negatif,2021-09-18,2021,verifikasi ya kok semakin ribet udh d jawab dengan suara berhasil lalu d alihkan ke tebak gambar dengan cepat sudah di jawab salah lagi dan sudah berkali kali masih salah uninstall lagi lah ribet,34,34,verifikasi ya kok semakin rumit sudah di jawab dengan suara berhasil lalu di alihkan ke tebak gambar dengan cepat sudah di jawab salah lagi dan sudah berkali kali masih salah uninstall lagi lah rumit,34,34,"['verifikasi', 'ya', 'kok', 'semakin', 'rumit', 'sudah', 'di', 'jawab', 'dengan', 'suara', 'berhasil', 'lalu', 'di', 'alihkan', 'ke', 'tebak', 'gambar', 'dengan', 'cepat', 'sudah', 'di', 'jawab', 'salah', 'lagi', 'dan', 'sudah', 'berkali', 'kali', 'masih', 'salah', 'uninstall', 'lagi', 'lah', 'rumit']","['verifikasi', 'ya', 'rumit', 'suara', 'berhasil', 'alihkan', 'tebak', 'gambar', 'cepat', 'salah', 'berkali', 'kali', 'salah', 'uninstall', 'rumit']",34,15,19,verifikasi ya rumit suara hasil alih tebak gambar cepat salah kali kali salah uninstall rumit,15,15
Baru aja download. Pengguna baru. Baru sampe verifikasi nomor telepon lama banget. Sampai berulang kali pencet kirim kode lagi tapi ga dikirim2. Sampe loading apps nya dan keulang di awal. Pakai nomor yang sama gabisa. Ganti nomor tetep aja verifikasi lambat.,negatif,2023-03-01,2023,baru aja download pengguna baru baru sampe verifikasi nomor telepon lama banget sampai berulang kali pencet kirim kode lagi tapi ga dikirim sampe loading apps nya dan keulang di awal pakai nomor yang sama gabisa ganti nomor tetep aja verifikasi lambat,41,41,baru saja unduh pengguna baru baru sampai verifikasi nomor telpon lama banget sampai berulang kali tekan kirim kode lagi tapi tidak dikirim sampai loading aplikasi nya dan keulang di awal pakai nomor yang sama tidak bisa ganti nomor tetap saja verifikasi lambat,41,42,"['baru', 'saja', 'unduh', 'pengguna', 'baru', 'baru', 'sampai', 'verifikasi', 'nomor', 'telpon', 'lama', 'banget', 'sampai', 'berulang', 'kali', 'tekan', 'kirim', 'kode', 'lagi', 'tapi', 'tidak', 'dikirim', 'sampai', 'loading', 'aplikasi', 'nya', 'dan', 'keulang', 'di', 'awal', 'pakai', 'nomor', 'yang', 'sama', 'tidak', 'bisa', 'ganti', 'nomor', 'tetap', 'saja', 'verifikasi', 'lambat']","['unduh', 'pengguna', 'verifikasi', 'nomor', 'telpon', 'banget', 'berulang', 'kali', 'tekan', 'kirim', 'kode', 'tidak', 'dikirim', 'loading', 'aplikasi', 'nya', 'keulang', 'pakai', 'nomor', 'tidak', 'ganti', 'nomor', 'verifikasi', 'lambat']",42,24,18,unduh guna verifikasi nomor telpon banget ulang kali tekan kirim kode tidak kirim loading aplikasi nya ulang pakai nomor tidak ganti nomor verifikasi lambat,24,24
"Setiap mau masuk harus verifikasi terus, tapi okelah itu kandemi keamanan. Tapi kenapa setiap beres verif ko malah balik lagi ke hal log in. Log in lagi, verif lagi. Terus aja ngulang disitu ga masuk masuk",negatif,2022-10-08,2022,setiap mau masuk harus verifikasi terus tapi okelah itu kandemi keamanan tapi kenapa setiap beres verif ko malah balik lagi ke hal log in log in lagi verif lagi terus aja ngulang disitu ga masuk masuk,36,36,setiap mau masuk harus verifikasi terus tapi okelah itu kandemi keamanan tapi kenapa setiap beres verif kok bahkan balik lagi ke hal log in log in lagi verif lagi terus saja mengulang disitu tidak masuk masuk,36,36,"['setiap', 'mau', 'masuk', 'harus', 'verifikasi', 'terus', 'tapi', 'okelah', 'itu', 'kandemi', 'keamanan', 'tapi', 'kenapa', 'setiap', 'beres', 'verif', 'kok', 'bahkan', 'balik', 'lagi', 'ke', 'hal', 'log', 'in', 'log', 'in', 'lagi', 'verif', 'lagi', 'terus', 'saja', 'mengulang', 'disitu', 'tidak', 'masuk', 'masuk']","['masuk', 'verifikasi', 'okelah', 'kandemi', 'keamanan', 'beres', 'verif', 'log', 'in', 'log', 'in', 'verif', 'mengulang', 'disitu', 'tidak', 'masuk', 'masuk']",36,17,19,masuk verifikasi oke kandemi aman beres verif log in log in verif ulang situ tidak masuk masuk,17,17
"Aplikasinya udah bagus tapi pas plis lah keamanannya jangan begitu, verifikasi melaui email juga bisa jangan pake tebak gambar. udah berkali kali ngejawab tetep aja salah gimana nasib linkedin saya kalo saya gak bisa login garagara gak bisa nebak gambar:""(",negatif,2021-03-14,2021,aplikasinya udah bagus tapi pas plis lah keamanannya jangan begitu verifikasi melaui email juga bisa jangan pake tebak gambar udah berkali kali ngejawab tetep aja salah gimana nasib linkedin saya kalo saya gak bisa login garagara gak bisa nebak gambar,40,40,aplikasi nya sudah bagus tapi pas tolong lah keamanannya jangan begitu verifikasi melaui email juga bisa jangan pakai tebak gambar sudah berkali kali ngejawab tetap saja salah bagaimana nasib linkedin saya kalau saya tidak bisa login garagara tidak bisa nebak gambar,40,41,"['aplikasi', 'nya', 'sudah', 'bagus', 'tapi', 'pas', 'tolong', 'lah', 'keamanannya', 'jangan', 'begitu', 'verifikasi', 'melaui', 'email', 'juga', 'bisa', 'jangan', 'pakai', 'tebak', 'gambar', 'sudah', 'berkali', 'kali', 'ngejawab', 'tetap', 'saja', 'salah', 'bagaimana', 'nasib', 'linkedin', 'saya', 'kalau', 'saya', 'tidak', 'bisa', 'login', 'garagara', 'tidak', 'bisa', 'nebak', 'gambar']","['aplikasi', 'nya', 'bagus', 'pas', 'tolong', 'keamanannya', 'verifikasi', 'melaui', 'email', 'pakai', 'tebak', 'gambar', 'berkali', 'kali', 'ngejawab', 'salah', 'nasib', 'linkedin', 'tidak', 'login', 'garagara', 'tidak', 'nebak', 'gambar']",41,24,17,aplikasi nya bagus pas tolong aman verifikasi melaui email pakai tebak gambar kali kali ngejawab salah nasib linkedin tidak login garagara tidak nebak gambar,24,24
"Sumpah kesel banget😭niat hati mau daftar ke LinkedIn tapi jadi ngga mood, banyak problem di aplikasi nya. Pertama saya mau daftar lewat website nya tapi pas tahap verifikasi gagal terus padahal sudah sesuai tapi gagal terus sampe pegel nih. Kedua niat hati download aplikasinya supaya lebih mudah eh malah nambah kesel karena ngga bisa daftar terus stuck pas daftarkan email dan password. Ini tolong dong sebagai pengguna baru saya sangat kecewa. Tolong diperbaiki yah dari pihak LinkedIn 🙏.",negatif,2022-05-20,2022,sumpah kesel bangetniat hati mau daftar ke linkedin tapi jadi ngga mood banyak problem di aplikasi nya pertama saya mau daftar lewat website nya tapi pas tahap verifikasi gagal terus padahal sudah sesuai tapi gagal terus sampe pegel nih kedua niat hati download aplikasinya supaya lebih mudah eh malah nambah kesel karena ngga bisa daftar terus stuck pas daftarkan email dan password ini tolong dong sebagai pengguna baru saya sangat kecewa tolong diperbaiki yah dari pihak linkedin,78,77,sumpah kesel bangetniat hati mau daftar ke linkedin tapi jadi tidak mood banyak masalah di aplikasi nya pertama saya mau daftar lewat website nya tapi pas tahap verifikasi gagal terus padahal sudah sesuai tapi gagal terus sampai pegel nih kedua niat hati unduh aplikasi nya supaya lebih mudah eh bahkan nambah kesel karena tidak bisa daftar terus stuck pas daftarkan email dan password ini tolong dong sebagai pengguna baru saya sangat kecewa tolong di perbaiki ya dari pihak linkedin,77,79,"['sumpah', 'kesel', 'bangetniat', 'hati', 'mau', 'daftar', 'ke', 'linkedin', 'tapi', 'jadi', 'tidak', 'mood', 'banyak', 'masalah', 'di', 'aplikasi', 'nya', 'pertama', 'saya', 'mau', 'daftar', 'lewat', 'website', 'nya', 'tapi', 'pas', 'tahap', 'verifikasi', 'gagal', 'terus', 'padahal', 'sudah', 'sesuai', 'tapi', 'gagal', 'terus', 'sampai', 'pegel', 'nih', 'kedua', 'niat', 'hati', 'unduh', 'aplikasi', 'nya', 'supaya', 'lebih', 'mudah', 'eh', 'bahkan', 'nambah', 'kesel', 'karena', 'tidak', 'bisa', 'daftar', 'terus', 'stuck', 'pas', 'daftarkan', 'email', 'dan', 'password', 'ini', 'tolong', 'dong', 'sebagai', 'pengguna', 'baru', 'saya', 'sangat', 'kecewa', 'tolong', 'di', 'perbaiki', 'ya', 'dari', 'pihak', 'linkedin']","['sumpah', 'kesel', 'bangetniat', 'hati', 'daftar', 'linkedin', 'tidak', 'mood', 'aplikasi', 'nya', 'daftar', 'website', 'nya', 'pas', 'tahap', 'verifikasi', 'gagal', 'sesuai', 'gagal', 'pegel', 'nih', 'niat', 'hati', 'unduh', 'aplikasi', 'nya', 'mudah', 'eh', 'nambah', 'kesel', 'tidak', 'daftar', 'stuck', 'pas', 'daftarkan', 'email', 'password', 'tolong', 'pengguna', 'kecewa', 'tolong', 'perbaiki', 'ya', 'linkedin']",79,44,35,sumpah kesel bangetniat hati daftar linkedin tidak mood aplikasi nya daftar website nya pas tahap verifikasi gagal sesuai gagal gel nih niat hati unduh aplikasi nya mudah eh nambah kesel tidak daftar stuck pas daftar email password tolong guna kecewa tolong baik ya linkedin,44,44
Sejauh ini sangat membantu saya mendapatakan kandidat yang sesuai qualifikasi.. Meskipun akun saya bukan premium. Untuk biaya langganan akun Premium saya rasa itu sangat tinggi sekali. bagi saya seorang recruiiter baru.,positif,2022-01-08,2022,sejauh ini sangat membantu saya mendapatakan kandidat yang sesuai qualifikasi meskipun akun saya bukan premium untuk biaya langganan akun premium saya rasa itu sangat tinggi sekali bagi saya seorang recruiiter baru,31,31,sejauh ini sangat membantu saya mendapatakan kandidat yang sesuai qualifikasi meskipun akun saya bukan premium untuk biaya langganan akun premium saya rasa itu sangat tinggi sekali bagi saya seorang recruiiter baru,31,31,"['sejauh', 'ini', 'sangat', 'membantu', 'saya', 'mendapatakan', 'kandidat', 'yang', 'sesuai', 'qualifikasi', 'meskipun', 'akun', 'saya', 'bukan', 'premium', 'untuk', 'biaya', 'langganan', 'akun', 'premium', 'saya', 'rasa', 'itu', 'sangat', 'tinggi', 'sekali', 'bagi', 'saya', 'seorang', 'recruiiter', 'baru']","['membantu', 'mendapatakan', 'kandidat', 'sesuai', 'qualifikasi', 'akun', 'premium', 'biaya', 'langganan', 'akun', 'premium', 'recruiiter']",31,12,19,bantu mendapatakan kandidat sesuai qualifikasi akun premium biaya langgan akun premium recruiiter,12,12
"Aplikasi game ini sangat bagus bagi teman2 yg suka dengan permainan BTC bertaut sangat unik dan mudah untuk bermain kasih bintang 5, sy tinggal tunggu pencairan ke Dana sudah proses mudah mudahan ini menjadi pengalaman pertama dengan hasil yang memuaskan",positif,2022-07-03,2022,aplikasi game ini sangat bagus bagi teman yg suka dengan permainan btc bertaut sangat unik dan mudah untuk bermain kasih bintang sy tinggal tunggu pencairan ke dana sudah proses mudah mudahan ini menjadi pengalaman pertama dengan hasil yang memuaskan,40,39,aplikasi game ini sangat bagus bagi teman yang suka dengan permainan btc bertaut sangat unik dan mudah untuk bermain kasih bintang saya tinggal tunggu pencairan ke dana sudah proses mudah mudahan ini menjadi pengalaman pertama dengan hasil yang memuaskan,39,39,"['aplikasi', 'game', 'ini', 'sangat', 'bagus', 'bagi', 'teman', 'yang', 'suka', 'dengan', 'permainan', 'btc', 'bertaut', 'sangat', 'unik', 'dan', 'mudah', 'untuk', 'bermain', 'kasih', 'bintang', 'saya', 'tinggal', 'tunggu', 'pencairan', 'ke', 'dana', 'sudah', 'proses', 'mudah', 'mudahan', 'ini', 'menjadi', 'pengalaman', 'pertama', 'dengan', 'hasil', 'yang', 'memuaskan']","['aplikasi', 'game', 'bagus', 'teman', 'suka', 'permainan', 'btc', 'bertaut', 'unik', 'mudah', 'bermain', 'kasih', 'bintang', 'tinggal', 'tunggu', 'pencairan', 'dana', 'proses', 'mudah', 'mudahan', 'pengalaman', 'hasil', 'memuaskan']",39,23,16,aplikasi game bagus teman suka main btc taut unik mudah main kasih bintang tinggal tunggu cair dana proses mudah mudah alam hasil muas,23,23
"Aplikasimu ini siapa yang buat?? Saya sudah login dengan akun benar email benar tapi katanya tidak ada akun dengan alamat email tersebut.. ,, ngaco banget sih.. benerin tuh aplikasimu.. saya mau hub ke siapa ini??? Masa saya bikin akun lagi.. yang bener aja lah.. saya cek email saya masih ada email dari lingkedln yang menandakan bahwa email yang saya gunakan memang email akun saya benerin lah sistemnya gimana sih...",negatif,2021-03-04,2021,aplikasimu ini siapa yang buat saya sudah login dengan akun benar email benar tapi katanya tidak ada akun dengan alamat email tersebut ngaco banget sih benerin tuh aplikasimu saya mau hub ke siapa ini masa saya bikin akun lagi yang bener aja lah saya cek email saya masih ada email dari lingkedln yang menandakan bahwa email yang saya gunakan memang email akun saya benerin lah sistemnya gimana sih,69,68,aplikasimu ini siapa yang buat saya sudah login dengan akun benar email benar tapi katanya tidak ada akun dengan alamat email tersebut ngaco banget sih benerin tuh aplikasimu saya mau menghubungi ke siapa ini masa saya bikin akun lagi yang benar saja lah saya cek email saya masih ada email dari lingkedln yang menandakan bahwa email yang saya gunakan memang email akun saya benerin lah sistemnya bagaimana sih,68,68,"['aplikasimu', 'ini', 'siapa', 'yang', 'buat', 'saya', 'sudah', 'login', 'dengan', 'akun', 'benar', 'email', 'benar', 'tapi', 'katanya', 'tidak', 'ada', 'akun', 'dengan', 'alamat', 'email', 'tersebut', 'ngaco', 'banget', 'sih', 'benerin', 'tuh', 'aplikasimu', 'saya', 'mau', 'menghubungi', 'ke', 'siapa', 'ini', 'masa', 'saya', 'bikin', 'akun', 'lagi', 'yang', 'benar', 'saja', 'lah', 'saya', 'cek', 'email', 'saya', 'masih', 'ada', 'email', 'dari', 'lingkedln', 'yang', 'menandakan', 'bahwa', 'email', 'yang', 'saya', 'gunakan', 'memang', 'email', 'akun', 'saya', 'benerin', 'lah', 'sistemnya', 'bagaimana', 'sih']","['aplikasimu', 'login', 'akun', 'email', 'tidak', 'akun', 'alamat', 'email', 'ngaco', 'banget', 'sih', 'benerin', 'tuh', 'aplikasimu', 'menghubungi', 'bikin', 'akun', 'cek', 'email', 'email', 'lingkedln', 'menandakan', 'email', 'email', 'akun', 'benerin', 'sistemnya', 'sih']",68,28,40,aplikasi login akun email tidak akun alamat email ngaco banget sih benerin tuh aplikasi hubung bikin akun cek email email lingkedln tanda email email akun benerin sistem sih,28,28
"Ini aplikasi bukan nya membantu para pencari kerja tapi malah mepersulit org dgn verifikasi yg ga jelas dan ga penting. Berkali2 coba SDH puluhan kali tetap salah Mulu itu gambar kodok nya. Lah mana kita Taw dia mau ngadep ke depan kiri kanan belakang suka2 Lo dah. Menyebalkan. Maaf saya uninstall, app jelek tidak berguna.",negatif,2021-10-28,2021,ini aplikasi bukan nya membantu para pencari kerja tapi malah mepersulit org dgn verifikasi yg ga jelas dan ga penting berkali coba sdh puluhan kali tetap salah mulu itu gambar kodok nya lah mana kita taw dia mau ngadep ke depan kiri kanan belakang suka lo dah menyebalkan maaf saya uninstall app jelek tidak berguna,55,55,ini aplikasi bukan nya membantu para pencari kerja tapi bahkan mepersulit orang dengan verifikasi yang tidak jelas dan tidak penting berkali coba sudah puluhan kali tetap salah mulu itu gambar kodok nya lah mana kita tahu dia mau ngadep ke depan kiri kanan belakang suka lo sudah menyebalkan maaf saya uninstall aplikasi jelek tidak berguna,55,55,"['ini', 'aplikasi', 'bukan', 'nya', 'membantu', 'para', 'pencari', 'kerja', 'tapi', 'bahkan', 'mepersulit', 'orang', 'dengan', 'verifikasi', 'yang', 'tidak', 'jelas', 'dan', 'tidak', 'penting', 'berkali', 'coba', 'sudah', 'puluhan', 'kali', 'tetap', 'salah', 'mulu', 'itu', 'gambar', 'kodok', 'nya', 'lah', 'mana', 'kita', 'tahu', 'dia', 'mau', 'ngadep', 'ke', 'depan', 'kiri', 'kanan', 'belakang', 'suka', 'lo', 'sudah', 'menyebalkan', 'maaf', 'saya', 'uninstall', 'aplikasi', 'jelek', 'tidak', 'berguna']","['aplikasi', 'nya', 'membantu', 'pencari', 'kerja', 'mepersulit', 'orang', 'verifikasi', 'tidak', 'tidak', 'berkali', 'coba', 'puluhan', 'kali', 'salah', 'mulu', 'gambar', 'kodok', 'nya', 'ngadep', 'kiri', 'kanan', 'suka', 'lo', 'menyebalkan', 'maaf', 'uninstall', 'aplikasi', 'jelek', 'tidak', 'berguna']",55,31,24,aplikasi nya bantu cari kerja mepersulit orang verifikasi tidak tidak kali coba puluh kali salah mulu gambar kodok nya ngadep kiri kanan suka lo sebal maaf uninstall aplikasi jelek tidak guna,31,31
Saya sudah lama memiliki akun dan memiliki banyak koneksi dan tiba-tiba akun tersebut oleh pihak LinkedIn dengan alasan melakukan otomatisasi pengikut. Padahal saya tidak melakukan tersebut. Saya sangat kecewa atas keputusan LinkedIn yang tidak sesuai prosedur.,negatif,2022-12-14,2022,saya sudah lama memiliki akun dan memiliki banyak koneksi dan tiba tiba akun tersebut oleh pihak linkedin dengan alasan melakukan otomatisasi pengikut padahal saya tidak melakukan tersebut saya sangat kecewa atas keputusan linkedin yang tidak sesuai prosedur,36,37,saya sudah lama memiliki akun dan memiliki banyak koneksi dan tiba tiba akun tersebut oleh pihak linkedin dengan alasan melakukan otomatisasi pengikut padahal saya tidak melakukan tersebut saya sangat kecewa atas keputusan linkedin yang tidak sesuai prosedur,37,37,"['saya', 'sudah', 'lama', 'memiliki', 'akun', 'dan', 'memiliki', 'banyak', 'koneksi', 'dan', 'tiba', 'tiba', 'akun', 'tersebut', 'oleh', 'pihak', 'linkedin', 'dengan', 'alasan', 'melakukan', 'otomatisasi', 'pengikut', 'padahal', 'saya', 'tidak', 'melakukan', 'tersebut', 'saya', 'sangat', 'kecewa', 'atas', 'keputusan', 'linkedin', 'yang', 'tidak', 'sesuai', 'prosedur']","['memiliki', 'akun', 'memiliki', 'koneksi', 'akun', 'linkedin', 'alasan', 'otomatisasi', 'pengikut', 'tidak', 'kecewa', 'keputusan', 'linkedin', 'tidak', 'sesuai', 'prosedur']",37,16,21,milik akun milik koneksi akun linkedin alas otomatisasi ikut tidak kecewa putus linkedin tidak sesuai prosedur,16,16
"Aneh...ini aplikasi jejaring sosial tapi ketika follow atau mengundang teman banyak malah di blokir dengan keterangan akun di tangguhkan krna penggunaan alat otomatisasi, sementara saya tidak menggunakan alat otomatisasi. Yg namanya jejaring sosial harusnya bebas donk mau menambahkan sebanyak banyaknya teman kenapa harus di batasi.",negatif,2020-08-04,2020,aneh ini aplikasi jejaring sosial tapi ketika follow atau mengundang teman banyak malah di blokir dengan keterangan akun di tangguhkan krna penggunaan alat otomatisasi sementara saya tidak menggunakan alat otomatisasi yg namanya jejaring sosial harusnya bebas donk mau menambahkan sebanyak banyaknya teman kenapa harus di batasi,45,46,aneh ini aplikasi jejaring sosial tapi ketika follow atau mengundang teman banyak bahkan di blokir dengan keterangan akun di tangguhkan karena penggunaan alat otomatisasi sementara saya tidak menggunakan alat otomatisasi yang namanya jejaring sosial harusnya bebas dong mau menambahkan sebanyak banyaknya teman kenapa harus di batasi,46,46,"['aneh', 'ini', 'aplikasi', 'jejaring', 'sosial', 'tapi', 'ketika', 'follow', 'atau', 'mengundang', 'teman', 'banyak', 'bahkan', 'di', 'blokir', 'dengan', 'keterangan', 'akun', 'di', 'tangguhkan', 'karena', 'penggunaan', 'alat', 'otomatisasi', 'sementara', 'saya', 'tidak', 'menggunakan', 'alat', 'otomatisasi', 'yang', 'namanya', 'jejaring', 'sosial', 'harusnya', 'bebas', 'dong', 'mau', 'menambahkan', 'sebanyak', 'banyaknya', 'teman', 'kenapa', 'harus', 'di', 'batasi']","['aneh', 'aplikasi', 'jejaring', 'sosial', 'follow', 'mengundang', 'teman', 'blokir', 'keterangan', 'akun', 'tangguhkan', 'penggunaan', 'alat', 'otomatisasi', 'tidak', 'alat', 'otomatisasi', 'namanya', 'jejaring', 'sosial', 'bebas', 'banyaknya', 'teman', 'batasi']",46,24,22,aneh aplikasi jejaring sosial follow undang teman blokir terang akun tangguh guna alat otomatisasi tidak alat otomatisasi nama jejaring sosial bebas banyak teman batas,24,24
"Tombol back pada hp membuat kembali ke tampilan awal, bukan halaman sblmnya. Mohon diperbaiki. Sehingga kita tidak perlu input jenis pekerjaan + berbagai filternya",negatif,2022-07-27,2022,tombol back pada hp membuat kembali ke tampilan awal bukan halaman sblmnya mohon diperbaiki sehingga kita tidak perlu input jenis pekerjaan berbagai filternya,24,23,tombol back pada handphone membuat kembali ke tampilan awal bukan halaman sblmnya mohon di perbaiki sehingga kita tidak perlu input jenis pekerjaan berbagai filternya,23,24,"['tombol', 'back', 'pada', 'handphone', 'membuat', 'kembali', 'ke', 'tampilan', 'awal', 'bukan', 'halaman', 'sblmnya', 'mohon', 'di', 'perbaiki', 'sehingga', 'kita', 'tidak', 'perlu', 'input', 'jenis', 'pekerjaan', 'berbagai', 'filternya']","['tombol', 'back', 'handphone', 'tampilan', 'halaman', 'sblmnya', 'mohon', 'perbaiki', 'tidak', 'input', 'jenis', 'pekerjaan', 'filternya']",24,13,11,tombol back handphone tampil halaman sblmnya mohon baik tidak input jenis kerja filter,13,13
"Sejak 2016 / 2017 lalu aku sudah pakai jaringan profesional ini. Jaringan medsos yg sangat berbeda dibandingkan jaringan lain. Disini kita bisa sharing sehubungan dgn dunia kerja, perush, apapun itu pokoknya yg sifatnya positif. Teman, rekan yg hanya kenal via linkedin jadi kenal didunia nyata. Dari linkedin juga, saya pernah mendapatkan pekerjaan yg sesuai dgn yg saya mau. Masya Allah... Semoga linkedin semakin sukses & terus berkembang. Aamiin.",positif,2020-07-01,2020,sejak lalu aku sudah pakai jaringan profesional ini jaringan medsos yg sangat berbeda dibandingkan jaringan lain disini kita bisa sharing sehubungan dgn dunia kerja perush apapun itu pokoknya yg sifatnya positif teman rekan yg hanya kenal via linkedin jadi kenal didunia nyata dari linkedin juga saya pernah mendapatkan pekerjaan yg sesuai dgn yg saya mau masya allah semoga linkedin semakin sukses terus berkembang aamiin,68,64,sejak lalu aku sudah pakai jaringan profesional ini jaringan media sosial yang sangat berbeda dibandingkan jaringan lain disini kita bisa sharing sehubungan dengan dunia kerja perush apapun itu pokoknya yang sifatnya positif teman rekan yang hanya kenal melalui linkedin jadi kenal didunia nyata dari linkedin juga saya pernah mendapatkan pekerjaan yang sesuai dengan yang saya mau masya allah semoga linkedin semakin sukses terus berkembang aamiin,64,65,"['sejak', 'lalu', 'aku', 'sudah', 'pakai', 'jaringan', 'profesional', 'ini', 'jaringan', 'media', 'sosial', 'yang', 'sangat', 'berbeda', 'dibandingkan', 'jaringan', 'lain', 'disini', 'kita', 'bisa', 'sharing', 'sehubungan', 'dengan', 'dunia', 'kerja', 'perush', 'apapun', 'itu', 'pokoknya', 'yang', 'sifatnya', 'positif', 'teman', 'rekan', 'yang', 'hanya', 'kenal', 'melalui', 'linkedin', 'jadi', 'kenal', 'didunia', 'nyata', 'dari', 'linkedin', 'juga', 'saya', 'pernah', 'mendapatkan', 'pekerjaan', 'yang', 'sesuai', 'dengan', 'yang', 'saya', 'mau', 'masya', 'allah', 'semoga', 'linkedin', 'semakin', 'sukses', 'terus', 'berkembang', 'aamiin']","['pakai', 'jaringan', 'profesional', 'jaringan', 'media', 'sosial', 'berbeda', 'dibandingkan', 'jaringan', 'sharing', 'sehubungan', 'dunia', 'kerja', 'perush', 'apapun', 'pokoknya', 'sifatnya', 'positif', 'teman', 'rekan', 'kenal', 'linkedin', 'kenal', 'didunia', 'nyata', 'linkedin', 'pekerjaan', 'sesuai', 'masya', 'allah', 'semoga', 'linkedin', 'sukses', 'berkembang', 'aamiin']",65,35,30,pakai jaring profesional jaring media sosial beda banding jaring sharing hubung dunia kerja perush apa pokok sifat positif teman rekan kenal linkedin kenal dunia nyata linkedin kerja sesuai masya allah moga linkedin sukses kembang aamiin,35,35
"Setiap buka aplikasi linked ataupun dari website pasti selalu postingan yg sudah lama dan berulang yg ada di laman utama, mohon diperbaiki agar postingan yg tampil selalu yg terbaru ,padahal koneksi saya ribuan tapi yg muncul itu lg itu lg dan yg berminggu2 postingannya masih muncul juga",negatif,2020-12-05,2020,setiap buka aplikasi linked ataupun dari website pasti selalu postingan yg sudah lama dan berulang yg ada di laman utama mohon diperbaiki agar postingan yg tampil selalu yg terbaru padahal koneksi saya ribuan tapi yg muncul itu lg itu lg dan yg berminggu postingannya masih muncul juga,47,47,setiap buka aplikasi linked ataupun dari website pasti selalu postingan yang sudah lama dan berulang yang ada di laman utama mohon di perbaiki agar postingan yang tampil selalu yang terbaru padahal koneksi saya ribuan tapi yang muncul itu lagi itu lagi dan yang berminggu postingannya masih muncul juga,47,48,"['setiap', 'buka', 'aplikasi', 'linked', 'ataupun', 'dari', 'website', 'pasti', 'selalu', 'postingan', 'yang', 'sudah', 'lama', 'dan', 'berulang', 'yang', 'ada', 'di', 'laman', 'utama', 'mohon', 'di', 'perbaiki', 'agar', 'postingan', 'yang', 'tampil', 'selalu', 'yang', 'terbaru', 'padahal', 'koneksi', 'saya', 'ribuan', 'tapi', 'yang', 'muncul', 'itu', 'lagi', 'itu', 'lagi', 'dan', 'yang', 'berminggu', 'postingannya', 'masih', 'muncul', 'juga']","['buka', 'aplikasi', 'linked', 'website', 'postingan', 'berulang', 'laman', 'utama', 'mohon', 'perbaiki', 'postingan', 'tampil', 'terbaru', 'koneksi', 'ribuan', 'muncul', 'berminggu', 'postingannya', 'muncul']",48,19,29,buka aplikasi linked website postingan ulang laman utama mohon baik postingan tampil baru koneksi ribu muncul minggu postingannya muncul,19,19
"Aplikasi ini adalah aplikasi yg tepat utk para pencari kerja khususnya bagi Freshgraduate ataupun bagi experience dan para rekruiter. Sangat banyak manfaat positif yg didapat tergantung kita sendiri yg ""mengolahnya"". Terimakasih LinkedIn.",positif,2021-10-17,2021,aplikasi ini adalah aplikasi yg tepat utk para pencari kerja khususnya bagi freshgraduate ataupun bagi experience dan para rekruiter sangat banyak manfaat positif yg didapat tergantung kita sendiri yg mengolahnya terimakasih linkedin,32,32,aplikasi ini adalah aplikasi yang tepat untuk para pencari kerja khususnya bagi freshgraduate ataupun bagi experience dan para rekruiter sangat banyak manfaat positif yang didapat tergantung kita sendiri yang mengolahnya terima kasih linkedin,32,33,"['aplikasi', 'ini', 'adalah', 'aplikasi', 'yang', 'tepat', 'untuk', 'para', 'pencari', 'kerja', 'khususnya', 'bagi', 'freshgraduate', 'ataupun', 'bagi', 'experience', 'dan', 'para', 'rekruiter', 'sangat', 'banyak', 'manfaat', 'positif', 'yang', 'didapat', 'tergantung', 'kita', 'sendiri', 'yang', 'mengolahnya', 'terima', 'kasih', 'linkedin']","['aplikasi', 'aplikasi', 'pencari', 'kerja', 'freshgraduate', 'experience', 'rekruiter', 'manfaat', 'positif', 'tergantung', 'mengolahnya', 'terima', 'kasih', 'linkedin']",33,14,19,aplikasi aplikasi cari kerja freshgraduate experience rekruiter manfaat positif gantung olah terima kasih linkedin,14,14
"Di bagian verfikasi ratusan kali ttp gak bisa malah diulang ulang...verifikasi dgn pertanyaan bodoh..tunjukan gambar yg menghadap ke atas yg bener sya klik gambar bnr malah diulang²i lagi pertanyaan nya, sya coba klik gambar yg salah juga gak bisa..",negatif,2022-12-11,2022,di bagian verfikasi ratusan kali ttp gak bisa malah diulang ulang verifikasi dgn pertanyaan bodoh tunjukan gambar yg menghadap ke atas yg bener sya klik gambar bnr malah diulang²i lagi pertanyaan nya sya coba klik gambar yg salah juga gak bisa,39,41,di bagian verfikasi ratusan kali tetap tidak bisa bahkan diulang ulang verifikasi dengan pertanyaan bodoh tunjukan gambar yang menghadap ke atas yang benar saya klik gambar benar bahkan diulang²i lagi pertanyaan nya saya coba klik gambar yang salah juga tidak bisa,41,41,"['di', 'bagian', 'verfikasi', 'ratusan', 'kali', 'tetap', 'tidak', 'bisa', 'bahkan', 'diulang', 'ulang', 'verifikasi', 'dengan', 'pertanyaan', 'bodoh', 'tunjukan', 'gambar', 'yang', 'menghadap', 'ke', 'atas', 'yang', 'benar', 'saya', 'klik', 'gambar', 'benar', 'bahkan', 'diulang²i', 'lagi', 'pertanyaan', 'nya', 'saya', 'coba', 'klik', 'gambar', 'yang', 'salah', 'juga', 'tidak', 'bisa']","['verfikasi', 'ratusan', 'kali', 'tidak', 'diulang', 'ulang', 'verifikasi', 'bodoh', 'tunjukan', 'gambar', 'menghadap', 'klik', 'gambar', 'diulang²i', 'nya', 'coba', 'klik', 'gambar', 'salah', 'tidak']",41,20,21,verfikasi ratus kali tidak ulang ulang verifikasi bodoh tunjuk gambar hadap klik gambar ulang i nya coba klik gambar salah tidak,20,21
"Ga jelas aplikasinya, pas masuk pake Gmail ga bisa2 di verifikasi, udah nyoba 5x nebak gambar tetap salah. Pas make nomor sekali percobaan langsung masuk, tapi pas di suruh ngirim kode, udah dikirim udah dimasukan kode nya, eh malah kayak gitu lagi, mesti ngirim ulang kode nya lagi. Saya kasih bintang 2 dulu.",negatif,2022-02-05,2022,ga jelas aplikasinya pas masuk pake gmail ga bisa di verifikasi udah nyoba x nebak gambar tetap salah pas make nomor sekali percobaan langsung masuk tapi pas di suruh ngirim kode udah dikirim udah dimasukan kode nya eh malah kayak gitu lagi mesti ngirim ulang kode nya lagi saya kasih bintang dulu,53,52,tidak jelas aplikasi nya pas masuk pakai gmail tidak bisa di verifikasi sudah mencoba x nebak gambar tetap salah pas make nomor sekali percobaan langsung masuk tapi pas di suruh mengirim kode sudah dikirim sudah dimasukan kode nya eh bahkan kayak begitu lagi mesti mengirim ulang kode nya lagi saya kasih bintang dahulu,52,53,"['tidak', 'jelas', 'aplikasi', 'nya', 'pas', 'masuk', 'pakai', 'gmail', 'tidak', 'bisa', 'di', 'verifikasi', 'sudah', 'mencoba', 'x', 'nebak', 'gambar', 'tetap', 'salah', 'pas', 'make', 'nomor', 'sekali', 'percobaan', 'langsung', 'masuk', 'tapi', 'pas', 'di', 'suruh', 'mengirim', 'kode', 'sudah', 'dikirim', 'sudah', 'dimasukan', 'kode', 'nya', 'eh', 'bahkan', 'kayak', 'begitu', 'lagi', 'mesti', 'mengirim', 'ulang', 'kode', 'nya', 'lagi', 'saya', 'kasih', 'bintang', 'dahulu']","['tidak', 'aplikasi', 'nya', 'pas', 'masuk', 'pakai', 'gmail', 'tidak', 'verifikasi', 'mencoba', 'x', 'nebak', 'gambar', 'salah', 'pas', 'make', 'nomor', 'percobaan', 'langsung', 'masuk', 'pas', 'suruh', 'mengirim', 'kode', 'dikirim', 'dimasukan', 'kode', 'nya', 'eh', 'kayak', 'mesti', 'mengirim', 'ulang', 'kode', 'nya', 'kasih', 'bintang']",53,37,16,tidak aplikasi nya pas masuk pakai gmail tidak verifikasi coba x nebak gambar salah pas make nomor coba langsung masuk pas suruh kirim kode kirim masuk kode nya eh kayak mesti kirim ulang kode nya kasih bintang,37,37
"Saya sangat kecewa dengan situs dan aplikasi ini, saya penggunan lama dari situs dan aplikasi ini, akun saya 2x tidak bisa digunakan di nonaktifkan tanpa pemberitahuan, padahal saya tidak pernah mengunggah atau meposting hal-hal yang bertindak kriminal , kejahatan dan diluar undang-undang, materi postingan saya tentang menjual property, bahkan banyak akun lain pun sama menjual memposting property namun mereka tidak di nonaktifkan, bahkan saya sudah mengirim verifikasi ktp saya, hasil nya nol",negatif,2021-06-22,2021,saya sangat kecewa dengan situs dan aplikasi ini saya penggunan lama dari situs dan aplikasi ini akun saya x tidak bisa digunakan di nonaktifkan tanpa pemberitahuan padahal saya tidak pernah mengunggah atau meposting hal hal yang bertindak kriminal kejahatan dan diluar undang undang materi postingan saya tentang menjual property bahkan banyak akun lain pun sama menjual memposting property namun mereka tidak di nonaktifkan bahkan saya sudah mengirim verifikasi ktp saya hasil nya nol,72,73,saya sangat kecewa dengan situs dan aplikasi ini saya penggunan lama dari situs dan aplikasi ini akun saya x tidak bisa digunakan di nonaktifkan tanpa pemberitahuan padahal saya tidak pernah mengunggah atau meposting hal hal yang bertindak kriminal kejahatan dan diluar undang undang materi postingan saya tentang menjual property bahkan banyak akun lain pun sama menjual memposting property namun mereka tidak di nonaktifkan bahkan saya sudah mengirim verifikasi ktp saya hasil nya nol,73,73,"['saya', 'sangat', 'kecewa', 'dengan', 'situs', 'dan', 'aplikasi', 'ini', 'saya', 'penggunan', 'lama', 'dari', 'situs', 'dan', 'aplikasi', 'ini', 'akun', 'saya', 'x', 'tidak', 'bisa', 'digunakan', 'di', 'nonaktifkan', 'tanpa', 'pemberitahuan', 'padahal', 'saya', 'tidak', 'pernah', 'mengunggah', 'atau', 'meposting', 'hal', 'hal', 'yang', 'bertindak', 'kriminal', 'kejahatan', 'dan', 'diluar', 'undang', 'undang', 'materi', 'postingan', 'saya', 'tentang', 'menjual', 'property', 'bahkan', 'banyak', 'akun', 'lain', 'pun', 'sama', 'menjual', 'memposting', 'property', 'namun', 'mereka', 'tidak', 'di', 'nonaktifkan', 'bahkan', 'saya', 'sudah', 'mengirim', 'verifikasi', 'ktp', 'saya', 'hasil', 'nya', 'nol']","['kecewa', 'situs', 'aplikasi', 'penggunan', 'situs', 'aplikasi', 'akun', 'x', 'tidak', 'nonaktifkan', 'pemberitahuan', 'tidak', 'mengunggah', 'meposting', 'bertindak', 'kriminal', 'kejahatan', 'diluar', 'undang', 'undang', 'materi', 'postingan', 'menjual', 'property', 'akun', 'menjual', 'memposting', 'property', 'tidak', 'nonaktifkan', 'mengirim', 'verifikasi', 'ktp', 'hasil', 'nya', 'nol']",73,36,37,kecewa situs aplikasi gun situs aplikasi akun x tidak nonaktif pemberitahuan tidak unggah meposting tindak kriminal jahat luar undang undang materi postingan jual property akun jual memposting property tidak nonaktif kirim verifikasi ktp hasil nya nol,36,36
"Mau bikin company page gabisa mulu, interface nya juga bikin bingung, udh nyari cara bikin company page di menu help dan udh diikutin instruksi nya tapi tetep aja gabisa, menu di instruksi sama di interface aplikasinya gak sama.",negatif,2020-07-29,2020,mau bikin company page gabisa mulu interface nya juga bikin bingung udh nyari cara bikin company page di menu help dan udh diikutin instruksi nya tapi tetep aja gabisa menu di instruksi sama di interface aplikasinya gak sama,38,38,mau bikin perusahaan page tidak bisa mulu interface nya juga bikin bingung sudah mencari cara bikin perusahaan page di menu help dan sudah diikutin instruksi nya tapi tetap saja tidak bisa menu di instruksi sama di interface aplikasi nya tidak sama,38,41,"['mau', 'bikin', 'perusahaan', 'page', 'tidak', 'bisa', 'mulu', 'interface', 'nya', 'juga', 'bikin', 'bingung', 'sudah', 'mencari', 'cara', 'bikin', 'perusahaan', 'page', 'di', 'menu', 'help', 'dan', 'sudah', 'diikutin', 'instruksi', 'nya', 'tapi', 'tetap', 'saja', 'tidak', 'bisa', 'menu', 'di', 'instruksi', 'sama', 'di', 'interface', 'aplikasi', 'nya', 'tidak', 'sama']","['bikin', 'perusahaan', 'page', 'tidak', 'mulu', 'interface', 'nya', 'bikin', 'bingung', 'mencari', 'bikin', 'perusahaan', 'page', 'menu', 'help', 'diikutin', 'instruksi', 'nya', 'tidak', 'menu', 'instruksi', 'interface', 'aplikasi', 'nya', 'tidak']",41,25,16,bikin usaha page tidak mulu interface nya bikin bingung cari bikin usaha page menu help diikutin instruksi nya tidak menu instruksi interface aplikasi nya tidak,25,25
"Apps yg recommended. Topik yg diangkat seputar dunia kerja, jadi akan sangat bermanfaat bagi perkembangan diri atau bisa jadi karir. Disamping kesempatan untuk open networking, off course.",positif,2020-10-12,2020,apps yg recommended topik yg diangkat seputar dunia kerja jadi akan sangat bermanfaat bagi perkembangan diri atau bisa jadi karir disamping kesempatan untuk open networking off course,27,27,aplikasi yang rekomendasi topik yang diangkat seputar dunia kerja jadi akan sangat bermanfaat bagi perkembangan diri atau bisa jadi karir disamping kesempatan untuk open networking off course,27,27,"['aplikasi', 'yang', 'rekomendasi', 'topik', 'yang', 'diangkat', 'seputar', 'dunia', 'kerja', 'jadi', 'akan', 'sangat', 'bermanfaat', 'bagi', 'perkembangan', 'diri', 'atau', 'bisa', 'jadi', 'karir', 'disamping', 'kesempatan', 'untuk', 'open', 'networking', 'off', 'course']","['aplikasi', 'rekomendasi', 'topik', 'diangkat', 'seputar', 'dunia', 'kerja', 'bermanfaat', 'perkembangan', 'karir', 'disamping', 'kesempatan', 'open', 'networking', 'off', 'course']",27,16,11,aplikasi rekomendasi topik angkat putar dunia kerja manfaat kembang karir samping sempat open networking off course,16,16
"Makasih udah nyediain aplikasi seperti ini... Saya jadi mendapatkan informasi yang sangat luas yang mungkin tak pernah tersebar luas di masyarakat... Udah 9 tahun pakai aplikasi ini dan Alhamdulillah skrng udah dapat perkerjaan yang sesuai dengan spesialisasi saya... Saran buat pemula harus sabar ya, karna nggk ada yang instan dan harus selalu update untuk mencari informasi dan lowongan di aplikasi ini",positif,2021-05-03,2021,makasih udah nyediain aplikasi seperti ini saya jadi mendapatkan informasi yang sangat luas yang mungkin tak pernah tersebar luas di masyarakat udah tahun pakai aplikasi ini dan alhamdulillah skrng udah dapat perkerjaan yang sesuai dengan spesialisasi saya saran buat pemula harus sabar ya karna nggk ada yang instan dan harus selalu update untuk mencari informasi dan lowongan di aplikasi ini,61,60,terima kasih sudah nyediain aplikasi seperti ini saya jadi mendapatkan informasi yang sangat luas yang mungkin tidak pernah tersebar luas di masyarakat sudah tahun pakai aplikasi ini dan alhamdulillah sekarang sudah dapat perkerjaan yang sesuai dengan spesialisasi saya saran buat pemula harus sabar ya karena tidak ada yang instan dan harus selalu diperbarui untuk mencari informasi dan lowongan di aplikasi ini,60,61,"['terima', 'kasih', 'sudah', 'nyediain', 'aplikasi', 'seperti', 'ini', 'saya', 'jadi', 'mendapatkan', 'informasi', 'yang', 'sangat', 'luas', 'yang', 'mungkin', 'tidak', 'pernah', 'tersebar', 'luas', 'di', 'masyarakat', 'sudah', 'tahun', 'pakai', 'aplikasi', 'ini', 'dan', 'alhamdulillah', 'sekarang', 'sudah', 'dapat', 'perkerjaan', 'yang', 'sesuai', 'dengan', 'spesialisasi', 'saya', 'saran', 'buat', 'pemula', 'harus', 'sabar', 'ya', 'karena', 'tidak', 'ada', 'yang', 'instan', 'dan', 'harus', 'selalu', 'diperbarui', 'untuk', 'mencari', 'informasi', 'dan', 'lowongan', 'di', 'aplikasi', 'ini']","['terima', 'kasih', 'nyediain', 'aplikasi', 'informasi', 'luas', 'tidak', 'tersebar', 'luas', 'masyarakat', 'pakai', 'aplikasi', 'alhamdulillah', 'perkerjaan', 'sesuai', 'spesialisasi', 'saran', 'pemula', 'sabar', 'ya', 'tidak', 'instan', 'diperbarui', 'mencari', 'informasi', 'lowongan', 'aplikasi']",61,27,34,terima kasih nyediain aplikasi informasi luas tidak sebar luas masyarakat pakai aplikasi alhamdulillah kerja sesuai spesialisasi saran mula sabar ya tidak instan baru cari informasi lowong aplikasi,27,27
"Aplikasi ini cukup bagus untuk menambah relasi mendapat informasi yang tidak pernah terjangkau sebelumnya berbeda dengan aplikasi lainnya seperti Instagram Facebook Twitter dan lain-lain link in diharuskan untuk hal-hal yang berkaitan dengan dunia pekerjaan ditambah lagi dengan adanya fitur Jobs, course yang bisa menambah skill dan pengalaman.",positif,2021-06-11,2021,aplikasi ini cukup bagus untuk menambah relasi mendapat informasi yang tidak pernah terjangkau sebelumnya berbeda dengan aplikasi lainnya seperti instagram facebook twitter dan lain lain link in diharuskan untuk hal hal yang berkaitan dengan dunia pekerjaan ditambah lagi dengan adanya fitur jobs course yang bisa menambah skill dan pengalaman,47,49,aplikasi ini cukup bagus untuk menambah relasi mendapat informasi yang tidak pernah terjangkau sebelumnya berbeda dengan aplikasi lainnya seperti instagram facebook twitter dan lain lain link in diharuskan untuk hal hal yang berkaitan dengan dunia pekerjaan ditambah lagi dengan adanya fitur jobs course yang bisa menambah skill dan pengalaman,49,49,"['aplikasi', 'ini', 'cukup', 'bagus', 'untuk', 'menambah', 'relasi', 'mendapat', 'informasi', 'yang', 'tidak', 'pernah', 'terjangkau', 'sebelumnya', 'berbeda', 'dengan', 'aplikasi', 'lainnya', 'seperti', 'instagram', 'facebook', 'twitter', 'dan', 'lain', 'lain', 'link', 'in', 'diharuskan', 'untuk', 'hal', 'hal', 'yang', 'berkaitan', 'dengan', 'dunia', 'pekerjaan', 'ditambah', 'lagi', 'dengan', 'adanya', 'fitur', 'jobs', 'course', 'yang', 'bisa', 'menambah', 'skill', 'dan', 'pengalaman']","['aplikasi', 'bagus', 'menambah', 'relasi', 'informasi', 'tidak', 'terjangkau', 'berbeda', 'aplikasi', 'instagram', 'facebook', 'twitter', 'link', 'in', 'diharuskan', 'berkaitan', 'dunia', 'pekerjaan', 'ditambah', 'fitur', 'jobs', 'course', 'menambah', 'skill', 'pengalaman']",49,25,24,aplikasi bagus tambah relasi informasi tidak jangkau beda aplikasi instagram facebook twitter link in harus kait dunia kerja tambah fitur jobs course tambah skill alam,25,25
"Verifikasinya sangat mudah, sampai di coba berulang kali tidak bisa. 👍👍 Padahal, model aplikasi keuangan kelas atas dan google saja tidak serumit ini. Orang baru yang akan menggunakan aplikasi semacam LinkedIn jelas putar balik.",negatif,2023-02-20,2023,verifikasinya sangat mudah sampai di coba berulang kali tidak bisa padahal model aplikasi keuangan kelas atas dan google saja tidak serumit ini orang baru yang akan menggunakan aplikasi semacam linkedin jelas putar balik,34,33,verifikasinya sangat mudah sampai di coba berulang kali tidak bisa padahal model aplikasi keuangan kelas atas dan google saja tidak serumit ini orang baru yang akan menggunakan aplikasi semacam linkedin jelas putar balik,33,33,"['verifikasinya', 'sangat', 'mudah', 'sampai', 'di', 'coba', 'berulang', 'kali', 'tidak', 'bisa', 'padahal', 'model', 'aplikasi', 'keuangan', 'kelas', 'atas', 'dan', 'google', 'saja', 'tidak', 'serumit', 'ini', 'orang', 'baru', 'yang', 'akan', 'menggunakan', 'aplikasi', 'semacam', 'linkedin', 'jelas', 'putar', 'balik']","['verifikasinya', 'mudah', 'coba', 'berulang', 'kali', 'tidak', 'model', 'aplikasi', 'keuangan', 'kelas', 'google', 'tidak', 'serumit', 'orang', 'aplikasi', 'linkedin', 'putar']",33,17,16,verifikasi mudah coba ulang kali tidak model aplikasi uang kelas google tidak rumit orang aplikasi linkedin putar,17,17
"Jujur saya salut dengan pembuat aplikasi ini, aplikasi ini sangat banyak membantu bagi lulusan mahasiswa dalam mencari pekerjaan. Tapi sayang sekali saya masih SMA kelas 1 jadi belum bisa menggunakan akun ini untuk kebutuhan saya. Terus berkembang dan bantu negara mencapai cita-citanya dalam memerangi kemiskinan.",positif,2020-02-15,2020,jujur saya salut dengan pembuat aplikasi ini aplikasi ini sangat banyak membantu bagi lulusan mahasiswa dalam mencari pekerjaan tapi sayang sekali saya masih sma kelas jadi belum bisa menggunakan akun ini untuk kebutuhan saya terus berkembang dan bantu negara mencapai cita citanya dalam memerangi kemiskinan,45,45,jujur saya salut dengan pembuat aplikasi ini aplikasi ini sangat banyak membantu bagi lulusan mahasiswa dalam mencari pekerjaan tapi sayang sekali saya masih sama kelas jadi belum bisa menggunakan akun ini untuk kebutuhan saya terus berkembang dan bantu negara mencapai cita citanya dalam memerangi kemiskinan,45,45,"['jujur', 'saya', 'salut', 'dengan', 'pembuat', 'aplikasi', 'ini', 'aplikasi', 'ini', 'sangat', 'banyak', 'membantu', 'bagi', 'lulusan', 'mahasiswa', 'dalam', 'mencari', 'pekerjaan', 'tapi', 'sayang', 'sekali', 'saya', 'masih', 'sama', 'kelas', 'jadi', 'belum', 'bisa', 'menggunakan', 'akun', 'ini', 'untuk', 'kebutuhan', 'saya', 'terus', 'berkembang', 'dan', 'bantu', 'negara', 'mencapai', 'cita', 'citanya', 'dalam', 'memerangi', 'kemiskinan']","['jujur', 'salut', 'pembuat', 'aplikasi', 'aplikasi', 'membantu', 'lulusan', 'mahasiswa', 'mencari', 'pekerjaan', 'sayang', 'kelas', 'akun', 'kebutuhan', 'berkembang', 'bantu', 'negara', 'mencapai', 'cita', 'citanya', 'memerangi', 'kemiskinan']",45,22,23,jujur salut buat aplikasi aplikasi bantu lulus mahasiswa cari kerja sayang kelas akun butuh kembang bantu negara capai cita cita rang miskin,22,22
"Min tolonggggggggg 10x lebih coba verivikasi gagal terus help!!!!!!!!!!!!!!!!, ""Mari kita lakukan pemeriksaan keamanan cepat"", ini mah gak cepat udah 2 hari belum bisa dibuka-buka Padahal udah jelas-jelas bener tapi gagal terus ini servernya bermasalah.",negatif,2022-06-17,2022,min tolonggggggggg x lebih coba verivikasi gagal terus help mari kita lakukan pemeriksaan keamanan cepat ini mah gak cepat udah hari belum bisa dibuka buka padahal udah jelas jelas bener tapi gagal terus ini servernya bermasalah,35,36,minimal tolonggggggggg x lebih coba verivikasi gagal terus help mari kita lakukan pemeriksaan keamanan cepat ini mah tidak cepat sudah hari belum bisa dibuka buka padahal sudah jelas jelas benar tapi gagal terus ini server nya bermasalah,36,37,"['minimal', 'tolonggggggggg', 'x', 'lebih', 'coba', 'verivikasi', 'gagal', 'terus', 'help', 'mari', 'kita', 'lakukan', 'pemeriksaan', 'keamanan', 'cepat', 'ini', 'mah', 'tidak', 'cepat', 'sudah', 'hari', 'belum', 'bisa', 'dibuka', 'buka', 'padahal', 'sudah', 'jelas', 'jelas', 'benar', 'tapi', 'gagal', 'terus', 'ini', 'server', 'nya', 'bermasalah']","['minimal', 'tolonggggggggg', 'x', 'coba', 'verivikasi', 'gagal', 'help', 'mari', 'lakukan', 'pemeriksaan', 'keamanan', 'cepat', 'mah', 'tidak', 'cepat', 'dibuka', 'buka', 'gagal', 'server', 'nya', 'bermasalah']",37,21,16,minimal tolonggggggggg x coba verivikasi gagal help mari laku periksa aman cepat mah tidak cepat buka buka gagal server nya masalah,21,21
"Capek banget sama Linkedin, udah dari tahun 2021 akun saya verifikasi terus statusnya, beberapa kali saya cek masih kek gitu. Barusan saya coba lg dikirain ada peningkatan minimal bisa login, dimintanya foto KTP udah ikutin smua syaratnya masih jg gak bisa. Yah gimana dong gambar foto saya di KTP mmg blur. Mau hubungin call center, infonya Linkedin gak menyediakan call center! Au ahh, uninstall lg aja, kecewa bgtlah. Tiba"" akun saya gak bisa diakses dari 2021 ckckckk!",negatif,2023-01-04,2023,capek banget sama linkedin udah dari tahun akun saya verifikasi terus statusnya beberapa kali saya cek masih kek gitu barusan saya coba lg dikirain ada peningkatan minimal bisa login dimintanya foto ktp udah ikutin smua syaratnya masih jg gak bisa yah gimana dong gambar foto saya di ktp mmg blur mau hubungin call center infonya linkedin gak menyediakan call center au ahh uninstall lg aja kecewa bgtlah tiba akun saya gak bisa diakses dari ckckckk,77,75,capek banget sama linkedin sudah dari tahun akun saya verifikasi terus statusnya beberapa kali saya cek masih seperti begitu barusan saya coba lagi dikirain ada peningkatan minimal bisa login dimintanya foto ktp sudah ikutin semua syaratnya masih juga tidak bisa ya bagaimana dong gambar foto saya di ktp memang blur mau hubungin call center informasinya linkedin tidak menyediakan call center au ahh uninstall lagi saja kecewa bgtlah tiba akun saya tidak bisa diakses dari ckckckk,75,75,"['capek', 'banget', 'sama', 'linkedin', 'sudah', 'dari', 'tahun', 'akun', 'saya', 'verifikasi', 'terus', 'statusnya', 'beberapa', 'kali', 'saya', 'cek', 'masih', 'seperti', 'begitu', 'barusan', 'saya', 'coba', 'lagi', 'dikirain', 'ada', 'peningkatan', 'minimal', 'bisa', 'login', 'dimintanya', 'foto', 'ktp', 'sudah', 'ikutin', 'semua', 'syaratnya', 'masih', 'juga', 'tidak', 'bisa', 'ya', 'bagaimana', 'dong', 'gambar', 'foto', 'saya', 'di', 'ktp', 'memang', 'blur', 'mau', 'hubungin', 'call', 'center', 'informasinya', 'linkedin', 'tidak', 'menyediakan', 'call', 'center', 'au', 'ahh', 'uninstall', 'lagi', 'saja', 'kecewa', 'bgtlah', 'tiba', 'akun', 'saya', 'tidak', 'bisa', 'diakses', 'dari', 'ckckckk']","['capek', 'banget', 'linkedin', 'akun', 'verifikasi', 'statusnya', 'kali', 'cek', 'barusan', 'coba', 'dikirain', 'peningkatan', 'minimal', 'login', 'dimintanya', 'foto', 'ktp', 'ikutin', 'syaratnya', 'tidak', 'ya', 'gambar', 'foto', 'ktp', 'blur', 'hubungin', 'call', 'center', 'informasinya', 'linkedin', 'tidak', 'menyediakan', 'call', 'center', 'au', 'ahh', 'uninstall', 'kecewa', 'bgtlah', 'akun', 'tidak', 'diakses', 'ckckckk']",75,43,32,capek banget linkedin akun verifikasi status kali cek barusan coba dikirain tingkat minimal login minta foto ktp ikutin syarat tidak ya gambar foto ktp blur hubungin call center informasi linkedin tidak sedia call center au ahh uninstall kecewa bgtlah akun tidak akses ckckckk,43,43
Aplikasi yang sangat bagus kita bisa mengenal orang orang yg sdh banyak sukses di dunia kerja juga dapat mereperensikan orang agar dapat pekerjaan dan kita bisa mengenal orang dari berbagai karakter. Semoga apk ini bisa lebih baik unatuk membantu orang orang yg butuh dengan relasi untuk mendapat peluang kerja.,positif,2020-10-25,2020,aplikasi yang sangat bagus kita bisa mengenal orang orang yg sdh banyak sukses di dunia kerja juga dapat mereperensikan orang agar dapat pekerjaan dan kita bisa mengenal orang dari berbagai karakter semoga apk ini bisa lebih baik unatuk membantu orang orang yg butuh dengan relasi untuk mendapat peluang kerja,49,49,aplikasi yang sangat bagus kita bisa mengenal orang orang yang sudah banyak sukses di dunia kerja juga dapat mereperensikan orang agar dapat pekerjaan dan kita bisa mengenal orang dari berbagai karakter semoga aplikasi ini bisa lebih baik unatuk membantu orang orang yang butuh dengan relasi untuk mendapat peluang kerja,49,49,"['aplikasi', 'yang', 'sangat', 'bagus', 'kita', 'bisa', 'mengenal', 'orang', 'orang', 'yang', 'sudah', 'banyak', 'sukses', 'di', 'dunia', 'kerja', 'juga', 'dapat', 'mereperensikan', 'orang', 'agar', 'dapat', 'pekerjaan', 'dan', 'kita', 'bisa', 'mengenal', 'orang', 'dari', 'berbagai', 'karakter', 'semoga', 'aplikasi', 'ini', 'bisa', 'lebih', 'baik', 'unatuk', 'membantu', 'orang', 'orang', 'yang', 'butuh', 'dengan', 'relasi', 'untuk', 'mendapat', 'peluang', 'kerja']","['aplikasi', 'bagus', 'mengenal', 'orang', 'orang', 'sukses', 'dunia', 'kerja', 'mereperensikan', 'orang', 'pekerjaan', 'mengenal', 'orang', 'karakter', 'semoga', 'aplikasi', 'unatuk', 'membantu', 'orang', 'orang', 'butuh', 'relasi', 'peluang', 'kerja']",49,24,25,aplikasi bagus kenal orang orang sukses dunia kerja mereperensikan orang kerja kenal orang karakter moga aplikasi unatuk bantu orang orang butuh relasi peluang kerja,24,24
"apk apa ini, apk anj**g, verifikasi gambar salah terus padahal yg pertama sampai 4 sembarang benar semua, lalu suara, suara sepertintv tidak ada saluran juga salah. gila apk ini, gk jelas abisi quota aja",negatif,2021-01-26,2021,apk apa ini apk anj g verifikasi gambar salah terus padahal yg pertama sampai sembarang benar semua lalu suara suara sepertintv tidak ada saluran juga salah gila apk ini gk jelas abisi quota aja,34,34,aplikasi apa ini aplikasi anj tidak verifikasi gambar salah terus padahal yang pertama sampai sembarang benar semua lalu suara suara sepertintv tidak ada saluran juga salah gila aplikasi ini tidak jelas abisi quota saja,34,34,"['aplikasi', 'apa', 'ini', 'aplikasi', 'anj', 'tidak', 'verifikasi', 'gambar', 'salah', 'terus', 'padahal', 'yang', 'pertama', 'sampai', 'sembarang', 'benar', 'semua', 'lalu', 'suara', 'suara', 'sepertintv', 'tidak', 'ada', 'saluran', 'juga', 'salah', 'gila', 'aplikasi', 'ini', 'tidak', 'jelas', 'abisi', 'quota', 'saja']","['aplikasi', 'aplikasi', 'anj', 'tidak', 'verifikasi', 'gambar', 'salah', 'sembarang', 'suara', 'suara', 'sepertintv', 'tidak', 'saluran', 'salah', 'gila', 'aplikasi', 'tidak', 'abisi', 'quota']",34,19,15,aplikasi aplikasi anj tidak verifikasi gambar salah sembarang suara suara sepertintv tidak salur salah gila aplikasi tidak abis quota,19,19
"Beberapa tahun off, mencoba masuk lagi ternyata masih bisa di gunakan akun saya dengan aman & nyaman. Kenapa ada yg koment tidak bisa masuk, saya baru saja download & login lagi tetap bisa login dengan mudah walaupun beberapa tahun tidak login",positif,2020-12-23,2020,beberapa tahun off mencoba masuk lagi ternyata masih bisa di gunakan akun saya dengan aman nyaman kenapa ada yg koment tidak bisa masuk saya baru saja download login lagi tetap bisa login dengan mudah walaupun beberapa tahun tidak login,41,39,beberapa tahun off mencoba masuk lagi ternyata masih bisa di gunakan akun saya dengan aman nyaman kenapa ada yang koment tidak bisa masuk saya baru saja unduh login lagi tetap bisa login dengan mudah walaupun beberapa tahun tidak login,39,39,"['beberapa', 'tahun', 'off', 'mencoba', 'masuk', 'lagi', 'ternyata', 'masih', 'bisa', 'di', 'gunakan', 'akun', 'saya', 'dengan', 'aman', 'nyaman', 'kenapa', 'ada', 'yang', 'koment', 'tidak', 'bisa', 'masuk', 'saya', 'baru', 'saja', 'unduh', 'login', 'lagi', 'tetap', 'bisa', 'login', 'dengan', 'mudah', 'walaupun', 'beberapa', 'tahun', 'tidak', 'login']","['off', 'mencoba', 'masuk', 'akun', 'aman', 'nyaman', 'koment', 'tidak', 'masuk', 'unduh', 'login', 'login', 'mudah', 'tidak', 'login']",39,15,24,off coba masuk akun aman nyaman koment tidak masuk unduh login login mudah tidak login,15,15
"Buat yg nanya cara verifikasi nya, makanya fokus baca baik, kalau verifikasi aja males gmn kedepannya Yg dimaksud menghadap keatas itu gambar yg posisinya berdiri, bukan yg kesamping/kebawah, kalau masih ga paham berarti otaknya beneran di dengkul",positif,2022-06-16,2022,buat yg nanya cara verifikasi nya makanya fokus baca baik kalau verifikasi aja males gmn kedepannya yg dimaksud menghadap keatas itu gambar yg posisinya berdiri bukan yg kesamping kebawah kalau masih ga paham berarti otaknya beneran di dengkul,37,38,buat yang bertanya cara verifikasi nya makanya fokus baca baik kalau verifikasi saja malas bagaimana kedepannya yang dimaksud menghadap keatas itu gambar yang posisinya berdiri bukan yang kesamping kebawah kalau masih tidak paham berarti otaknya benaran di dengkul,38,38,"['buat', 'yang', 'bertanya', 'cara', 'verifikasi', 'nya', 'makanya', 'fokus', 'baca', 'baik', 'kalau', 'verifikasi', 'saja', 'malas', 'bagaimana', 'kedepannya', 'yang', 'dimaksud', 'menghadap', 'keatas', 'itu', 'gambar', 'yang', 'posisinya', 'berdiri', 'bukan', 'yang', 'kesamping', 'kebawah', 'kalau', 'masih', 'tidak', 'paham', 'berarti', 'otaknya', 'benaran', 'di', 'dengkul']","['verifikasi', 'nya', 'fokus', 'baca', 'verifikasi', 'malas', 'kedepannya', 'menghadap', 'keatas', 'gambar', 'posisinya', 'berdiri', 'kesamping', 'kebawah', 'tidak', 'paham', 'otaknya', 'benaran', 'dengkul']",38,19,19,verifikasi nya fokus baca verifikasi malas depan hadap atas gambar posisi diri samping bawah tidak paham otak benar dengkul,19,19
Saya sangat kecewa dengan linkedin!!! Saya tidak melakukan tindakan yang dianggap melanggar tetapi akun linkedin saya dibatasi. Mohon pemecahan masalahnya segera!!!😡 Linkedin sangat mengecewakan!!! Respon untuk masalah pembatasan akun sangat lambat bahkan tidak ada respon sama sekali. Hal ini merugikan saya sehingga tidak dapat menggunakan aplikasi linkedin dengan akun yang saya gunakan!!!😡😡,negatif,2022-02-20,2022,saya sangat kecewa dengan linkedin saya tidak melakukan tindakan yang dianggap melanggar tetapi akun linkedin saya dibatasi mohon pemecahan masalahnya segera linkedin sangat mengecewakan respon untuk masalah pembatasan akun sangat lambat bahkan tidak ada respon sama sekali hal ini merugikan saya sehingga tidak dapat menggunakan aplikasi linkedin dengan akun yang saya gunakan,52,52,saya sangat kecewa dengan linkedin saya tidak melakukan tindakan yang dianggap melanggar tetapi akun linkedin saya dibatasi mohon pemecahan masalahnya segera linkedin sangat mengecewakan respons untuk masalah pembatasan akun sangat lambat bahkan tidak ada respons sama sekali hal ini merugikan saya sehingga tidak dapat menggunakan aplikasi linkedin dengan akun yang saya gunakan,52,52,"['saya', 'sangat', 'kecewa', 'dengan', 'linkedin', 'saya', 'tidak', 'melakukan', 'tindakan', 'yang', 'dianggap', 'melanggar', 'tetapi', 'akun', 'linkedin', 'saya', 'dibatasi', 'mohon', 'pemecahan', 'masalahnya', 'segera', 'linkedin', 'sangat', 'mengecewakan', 'respons', 'untuk', 'masalah', 'pembatasan', 'akun', 'sangat', 'lambat', 'bahkan', 'tidak', 'ada', 'respons', 'sama', 'sekali', 'hal', 'ini', 'merugikan', 'saya', 'sehingga', 'tidak', 'dapat', 'menggunakan', 'aplikasi', 'linkedin', 'dengan', 'akun', 'yang', 'saya', 'gunakan']","['kecewa', 'linkedin', 'tidak', 'tindakan', 'dianggap', 'melanggar', 'akun', 'linkedin', 'dibatasi', 'mohon', 'pemecahan', 'linkedin', 'mengecewakan', 'respons', 'pembatasan', 'akun', 'lambat', 'tidak', 'respons', 'merugikan', 'tidak', 'aplikasi', 'linkedin', 'akun']",52,24,28,kecewa linkedin tidak tindak anggap langgar akun linkedin batas mohon pecah linkedin kecewa respons batas akun lambat tidak respons rugi tidak aplikasi linkedin akun,24,24
"Ini bagaimana sih?setiap mau login udah punya akun sebelumnya,tidak bisa katanya akun dinonaktifkan.Setelah sudah diperbaharui aplikasinya tetap tidak bisa akun dininaktifkan.Sebenarnya salah akun saya apa?Tolong segera ditindaklanjuti.",negatif,2020-04-08,2020,ini bagaimana sih setiap mau login udah punya akun sebelumnya tidak bisa katanya akun dinonaktifkan setelah sudah diperbaharui aplikasinya tetap tidak bisa akun dininaktifkan sebenarnya salah akun saya apa tolong segera ditindaklanjuti,27,32,ini bagaimana sih setiap mau login sudah punya akun sebelumnya tidak bisa katanya akun dinonaktifkan setelah sudah pembaruan aplikasi nya tetap tidak bisa akun dininaktifkan sebenarnya salah akun saya apa tolong segera di tindak lanjut,32,35,"['ini', 'bagaimana', 'sih', 'setiap', 'mau', 'login', 'sudah', 'punya', 'akun', 'sebelumnya', 'tidak', 'bisa', 'katanya', 'akun', 'dinonaktifkan', 'setelah', 'sudah', 'pembaruan', 'aplikasi', 'nya', 'tetap', 'tidak', 'bisa', 'akun', 'dininaktifkan', 'sebenarnya', 'salah', 'akun', 'saya', 'apa', 'tolong', 'segera', 'di', 'tindak', 'lanjut']","['sih', 'login', 'akun', 'tidak', 'akun', 'dinonaktifkan', 'pembaruan', 'aplikasi', 'nya', 'tidak', 'akun', 'dininaktifkan', 'salah', 'akun', 'tolong', 'tindak']",35,16,19,sih login akun tidak akun nonaktif baru aplikasi nya tidak akun dininaktifkan salah akun tolong tindak,16,16
TDK suka dengan verifikasi keamanannya. Mending diberi teka teki tunjuk sebuah benda seperi verifikasi keamanan google untuk menghindari robot. Kenapa harus cari gambar² hewan menghadap ke atas?? Ujung-ujungnya salah terus. Mohon diperbaiki,negatif,2022-05-29,2022,tdk suka dengan verifikasi keamanannya mending diberi teka teki tunjuk sebuah benda seperi verifikasi keamanan google untuk menghindari robot kenapa harus cari gambar² hewan menghadap ke atas ujung ujungnya salah terus mohon diperbaiki,32,33,tidak suka dengan verifikasi keamanannya mending diberi teka teki tunjuk sebuah benda seperi verifikasi keamanan google untuk menghindari robot kenapa harus cari gambar² hewan menghadap ke atas ujung ujungnya salah terus mohon di perbaiki,33,34,"['tidak', 'suka', 'dengan', 'verifikasi', 'keamanannya', 'mending', 'diberi', 'teka', 'teki', 'tunjuk', 'sebuah', 'benda', 'seperi', 'verifikasi', 'keamanan', 'google', 'untuk', 'menghindari', 'robot', 'kenapa', 'harus', 'cari', 'gambar²', 'hewan', 'menghadap', 'ke', 'atas', 'ujung', 'ujungnya', 'salah', 'terus', 'mohon', 'di', 'perbaiki']","['tidak', 'suka', 'verifikasi', 'keamanannya', 'mending', 'teka', 'teki', 'benda', 'seperi', 'verifikasi', 'keamanan', 'google', 'menghindari', 'robot', 'cari', 'gambar²', 'hewan', 'menghadap', 'ujung', 'ujungnya', 'salah', 'mohon', 'perbaiki']",34,23,11,tidak suka verifikasi aman mending teka teki benda per verifikasi aman google hindar robot cari gambar hewan hadap ujung ujung salah mohon baik,23,23
"LinkedIn aneh parah, verifikasi nya gakjelas lhi. Udah nyoba berulang ulang yg verifikasi suara dan sudah bener semua. Soalnya sudah ada tulisan ""Terimakasih sudah memverifikasi bahwa anda benar manusia"" tapi setelah itu malah disuruh verifikasi verifikasi terus dan hasilnya sama diulang gak ada hasilnya.GAJELAS",negatif,2023-08-16,2023,linkedin aneh parah verifikasi nya gakjelas lhi udah nyoba berulang ulang yg verifikasi suara dan sudah bener semua soalnya sudah ada tulisan terimakasih sudah memverifikasi bahwa anda benar manusia tapi setelah itu malah disuruh verifikasi verifikasi terus dan hasilnya sama diulang gak ada hasilnya gajelas,44,45,linkedin aneh parah verifikasi nya gakjelas lhi sudah mencoba berulang ulang yang verifikasi suara dan sudah benar semua soalnya sudah ada tulisan terima kasih sudah memverifikasi bahwa anda benar manusia tapi setelah itu bahkan disuruh verifikasi verifikasi terus dan hasilnya sama diulang tidak ada hasilnya tidak jelas,45,47,"['linkedin', 'aneh', 'parah', 'verifikasi', 'nya', 'gakjelas', 'lhi', 'sudah', 'mencoba', 'berulang', 'ulang', 'yang', 'verifikasi', 'suara', 'dan', 'sudah', 'benar', 'semua', 'soalnya', 'sudah', 'ada', 'tulisan', 'terima', 'kasih', 'sudah', 'memverifikasi', 'bahwa', 'anda', 'benar', 'manusia', 'tapi', 'setelah', 'itu', 'bahkan', 'disuruh', 'verifikasi', 'verifikasi', 'terus', 'dan', 'hasilnya', 'sama', 'diulang', 'tidak', 'ada', 'hasilnya', 'tidak', 'jelas']","['linkedin', 'aneh', 'parah', 'verifikasi', 'nya', 'gakjelas', 'lhi', 'mencoba', 'berulang', 'ulang', 'verifikasi', 'suara', 'tulisan', 'terima', 'kasih', 'memverifikasi', 'manusia', 'disuruh', 'verifikasi', 'verifikasi', 'hasilnya', 'diulang', 'tidak', 'hasilnya', 'tidak']",47,25,22,linkedin aneh parah verifikasi nya gakjelas lhi coba ulang ulang verifikasi suara tulis terima kasih verifikasi manusia suruh verifikasi verifikasi hasil ulang tidak hasil tidak,25,25
"Tolong jangan buat aplikasi seberguna ini jadi sampah, susah untuk login dengan verifikasi yang tidak jelas. Website nya juga sama aja makin nyusahin. Tolong developer nya bisa cepat di fix, sudah lama banget lo masalah ini, udah banyak juga orang yang berkomentar yang sama",negatif,2024-02-26,2024,tolong jangan buat aplikasi seberguna ini jadi sampah susah untuk login dengan verifikasi yang tidak jelas website nya juga sama aja makin nyusahin tolong developer nya bisa cepat di fix sudah lama banget lo masalah ini udah banyak juga orang yang berkomentar yang sama,44,44,tolong jangan buat aplikasi seberguna ini jadi sampah susah untuk login dengan verifikasi yang tidak jelas website nya juga sama saja makin nyusahin tolong developer nya bisa cepat di fix sudah lama banget lo masalah ini sudah banyak juga orang yang berkomentar yang sama,44,44,"['tolong', 'jangan', 'buat', 'aplikasi', 'seberguna', 'ini', 'jadi', 'sampah', 'susah', 'untuk', 'login', 'dengan', 'verifikasi', 'yang', 'tidak', 'jelas', 'website', 'nya', 'juga', 'sama', 'saja', 'makin', 'nyusahin', 'tolong', 'developer', 'nya', 'bisa', 'cepat', 'di', 'fix', 'sudah', 'lama', 'banget', 'lo', 'masalah', 'ini', 'sudah', 'banyak', 'juga', 'orang', 'yang', 'berkomentar', 'yang', 'sama']","['tolong', 'aplikasi', 'seberguna', 'sampah', 'susah', 'login', 'verifikasi', 'tidak', 'website', 'nya', 'nyusahin', 'tolong', 'developer', 'nya', 'cepat', 'fix', 'banget', 'lo', 'orang', 'berkomentar']",44,20,24,tolong aplikasi guna sampah susah login verifikasi tidak website nya nyusahin tolong developer nya cepat fix banget lo orang komentar,20,20
Mau daftar pas minta kode verivikasinya kok yg ngirim nomer verifikasinya nomer hp personal ya. +62xxxxx gitu. Biasanya setiap program resmi aplikasi meminta kode ferivikasi yg mengirim resmi dari aplikasinya dan tidak ada nomer hpnya. Jadi takut jaman skrg bnyk hacker2 tak bertanggung jawab.,negatif,2020-11-20,2020,mau daftar pas minta kode verivikasinya kok yg ngirim nomer verifikasinya nomer hp personal ya xxxxx gitu biasanya setiap program resmi aplikasi meminta kode ferivikasi yg mengirim resmi dari aplikasinya dan tidak ada nomer hpnya jadi takut jaman skrg bnyk hacker tak bertanggung jawab,44,44,mau daftar pas minta kode verivikasinya kok yang mengirim nomor verifikasinya nomor handphone personal ya xxxxx begitu biasanya setiap program resmi aplikasi meminta kode ferivikasi yang mengirim resmi dari aplikasi nya dan tidak ada nomor hpnya jadi takut jaman sekarang banyak hacker tidak bertanggung jawab,44,45,"['mau', 'daftar', 'pas', 'minta', 'kode', 'verivikasinya', 'kok', 'yang', 'mengirim', 'nomor', 'verifikasinya', 'nomor', 'handphone', 'personal', 'ya', 'xxxxx', 'begitu', 'biasanya', 'setiap', 'program', 'resmi', 'aplikasi', 'meminta', 'kode', 'ferivikasi', 'yang', 'mengirim', 'resmi', 'dari', 'aplikasi', 'nya', 'dan', 'tidak', 'ada', 'nomor', 'hpnya', 'jadi', 'takut', 'jaman', 'sekarang', 'banyak', 'hacker', 'tidak', 'bertanggung', 'jawab']","['daftar', 'pas', 'kode', 'verivikasinya', 'mengirim', 'nomor', 'verifikasinya', 'nomor', 'handphone', 'personal', 'ya', 'xxxxx', 'program', 'resmi', 'aplikasi', 'kode', 'ferivikasi', 'mengirim', 'resmi', 'aplikasi', 'nya', 'tidak', 'nomor', 'hpnya', 'takut', 'jaman', 'hacker', 'tidak', 'bertanggung']",45,29,16,daftar pas kode verivikasinya kirim nomor verifikasi nomor handphone personal ya xxxxx program resmi aplikasi kode ferivikasi kirim resmi aplikasi nya tidak nomor hpnya takut jaman hacker tidak tanggung,29,29
Aplikasi sampah...daftar akun aja susah sekali... Verifikasi error... Disuruh pilih gambar arah keatas selalu salah padahal sudah dipastikan benar... Berulang kali salah terus .. Ku coba jawab selalu salah di akhir .. Kucuriga ini emang kesengajaan...ku test jawab asal dan bener sampe ditahap akhir salah lagi... Jadi kesimpulan nya verifikasi nya rada gila ...dijawan bener ttp salah dijawab salah apalagi,negatif,2023-10-09,2023,aplikasi sampah daftar akun aja susah sekali verifikasi error disuruh pilih gambar arah keatas selalu salah padahal sudah dipastikan benar berulang kali salah terus ku coba jawab selalu salah di akhir kucuriga ini emang kesengajaan ku test jawab asal dan bener sampe ditahap akhir salah lagi jadi kesimpulan nya verifikasi nya rada gila dijawan bener ttp salah dijawab salah apalagi,60,60,aplikasi sampah daftar akun saja susah sekali verifikasi error disuruh pilih gambar arah keatas selalu salah padahal sudah dipastikan benar berulang kali salah terus saya coba jawab selalu salah di akhir kucuriga ini memang kesengajaan saya test jawab asal dan benar sampai ditahap akhir salah lagi jadi kesimpulan nya verifikasi nya rada gila dijawan benar tetap salah dijawab salah apalagi,60,60,"['aplikasi', 'sampah', 'daftar', 'akun', 'saja', 'susah', 'sekali', 'verifikasi', 'error', 'disuruh', 'pilih', 'gambar', 'arah', 'keatas', 'selalu', 'salah', 'padahal', 'sudah', 'dipastikan', 'benar', 'berulang', 'kali', 'salah', 'terus', 'saya', 'coba', 'jawab', 'selalu', 'salah', 'di', 'akhir', 'kucuriga', 'ini', 'memang', 'kesengajaan', 'saya', 'test', 'jawab', 'asal', 'dan', 'benar', 'sampai', 'ditahap', 'akhir', 'salah', 'lagi', 'jadi', 'kesimpulan', 'nya', 'verifikasi', 'nya', 'rada', 'gila', 'dijawan', 'benar', 'tetap', 'salah', 'dijawab', 'salah', 'apalagi']","['aplikasi', 'sampah', 'daftar', 'akun', 'susah', 'verifikasi', 'error', 'disuruh', 'pilih', 'gambar', 'arah', 'keatas', 'salah', 'berulang', 'kali', 'salah', 'coba', 'salah', 'kucuriga', 'kesengajaan', 'test', 'ditahap', 'salah', 'kesimpulan', 'nya', 'verifikasi', 'nya', 'rada', 'gila', 'dijawan', 'salah', 'salah']",60,32,28,aplikasi sampah daftar akun susah verifikasi error suruh pilih gambar arah atas salah ulang kali salah coba salah curiga sengaja test tahap salah simpul nya verifikasi nya rada gila dijawan salah salah,32,32
"Saat verifikasi gambar dan sudah memilih gambar yang tepat, berikutnya akan muncul notif merah berkata kode recaptcha missing atau invalid dan akan terjadi perulangan minta human verifikasi tanpa ujung.",negatif,2023-06-07,2023,saat verifikasi gambar dan sudah memilih gambar yang tepat berikutnya akan muncul notif merah berkata kode recaptcha missing atau invalid dan akan terjadi perulangan minta human verifikasi tanpa ujung,29,29,saat verifikasi gambar dan sudah memilih gambar yang tepat berikutnya akan muncul notif merah berkata kode recaptcha missing atau invalid dan akan terjadi perulangan minta human verifikasi tanpa ujung,29,29,"['saat', 'verifikasi', 'gambar', 'dan', 'sudah', 'memilih', 'gambar', 'yang', 'tepat', 'berikutnya', 'akan', 'muncul', 'notif', 'merah', 'berkata', 'kode', 'recaptcha', 'missing', 'atau', 'invalid', 'dan', 'akan', 'terjadi', 'perulangan', 'minta', 'human', 'verifikasi', 'tanpa', 'ujung']","['verifikasi', 'gambar', 'memilih', 'gambar', 'muncul', 'notif', 'merah', 'kode', 'recaptcha', 'missing', 'invalid', 'perulangan', 'human', 'verifikasi', 'ujung']",29,15,14,verifikasi gambar pilih gambar muncul notif merah kode recaptcha missing invalid ulang human verifikasi ujung,15,15
"Saya telah menggunakan LinkedIn selama beberapa tahun sekarang, dan saya harus mengatakan bahwa ini adalah aplikasi yang benar-benar luar biasa untuk para profesional. Sebagai seorang pengulas profesional, saya melihat LinkedIn sebagai platform yang tak tertandingi dalam membantu memperluas jaringan profesional dan mencari peluang karir yang menarik.",positif,2023-07-15,2023,saya telah menggunakan linkedin selama beberapa tahun sekarang dan saya harus mengatakan bahwa ini adalah aplikasi yang benar benar luar biasa untuk para profesional sebagai seorang pengulas profesional saya melihat linkedin sebagai platform yang tak tertandingi dalam membantu memperluas jaringan profesional dan mencari peluang karir yang menarik,46,47,saya telah menggunakan linkedin selama beberapa tahun sekarang dan saya harus mengatakan bahwa ini adalah aplikasi yang benar benar luar biasa untuk para profesional sebagai seorang pengulas profesional saya melihat linkedin sebagai platform yang tidak tertandingi dalam membantu memperluas jaringan profesional dan mencari peluang karir yang menarik,47,47,"['saya', 'telah', 'menggunakan', 'linkedin', 'selama', 'beberapa', 'tahun', 'sekarang', 'dan', 'saya', 'harus', 'mengatakan', 'bahwa', 'ini', 'adalah', 'aplikasi', 'yang', 'benar', 'benar', 'luar', 'biasa', 'untuk', 'para', 'profesional', 'sebagai', 'seorang', 'pengulas', 'profesional', 'saya', 'melihat', 'linkedin', 'sebagai', 'platform', 'yang', 'tidak', 'tertandingi', 'dalam', 'membantu', 'memperluas', 'jaringan', 'profesional', 'dan', 'mencari', 'peluang', 'karir', 'yang', 'menarik']","['linkedin', 'aplikasi', 'profesional', 'pengulas', 'profesional', 'linkedin', 'platform', 'tidak', 'tertandingi', 'membantu', 'memperluas', 'jaringan', 'profesional', 'mencari', 'peluang', 'karir', 'menarik']",47,17,30,linkedin aplikasi profesional ulas profesional linkedin platform tidak tanding bantu luas jaring profesional cari peluang karir tarik,17,17
"Dulu suka bgt sama aplikasi ini, tapi nth kenapa bukannya kinerjanya tambah bagus malah nambah menurun. Permasalahan login dan aplikasi yang sering tidak dapat dibuka sungguh itu mengganggu pengguna banget 😭",negatif,2024-01-04,2024,dulu suka bgt sama aplikasi ini tapi nth kenapa bukannya kinerjanya tambah bagus malah nambah menurun permasalahan login dan aplikasi yang sering tidak dapat dibuka sungguh itu mengganggu pengguna banget,31,30,dahulu suka banget sama aplikasi ini tapi nth kenapa bukannya kinerjanya tambah bagus bahkan nambah menurun permasalahan login dan aplikasi yang sering tidak dapat dibuka sungguh itu mengganggu pengguna banget,30,30,"['dahulu', 'suka', 'banget', 'sama', 'aplikasi', 'ini', 'tapi', 'nth', 'kenapa', 'bukannya', 'kinerjanya', 'tambah', 'bagus', 'bahkan', 'nambah', 'menurun', 'permasalahan', 'login', 'dan', 'aplikasi', 'yang', 'sering', 'tidak', 'dapat', 'dibuka', 'sungguh', 'itu', 'mengganggu', 'pengguna', 'banget']","['suka', 'banget', 'aplikasi', 'nth', 'kinerjanya', 'bagus', 'nambah', 'menurun', 'permasalahan', 'login', 'aplikasi', 'tidak', 'dibuka', 'sungguh', 'mengganggu', 'pengguna', 'banget']",30,17,13,suka banget aplikasi nth kerja bagus nambah turun masalah login aplikasi tidak buka sungguh ganggu guna banget,17,17
"Saya berharap aplikasi ini lebih fleksibel dalam pencarian lowongan pekerjaan, terutama keyword yang lebih relevan, dan relevansi hasil pencarian yang lebih sesuai dengan skill yang dikuasai. Saya berharap ada fitur filter lowongan pekerjaan yang tidak mengharuskan menguasai bahasa Inggris.",negatif,2023-09-21,2023,saya berharap aplikasi ini lebih fleksibel dalam pencarian lowongan pekerjaan terutama keyword yang lebih relevan dan relevansi hasil pencarian yang lebih sesuai dengan skill yang dikuasai saya berharap ada fitur filter lowongan pekerjaan yang tidak mengharuskan menguasai bahasa inggris,39,39,saya berharap aplikasi ini lebih fleksibel dalam pencarian lowongan pekerjaan terutama kata kunci yang lebih relevan dan relevansi hasil pencarian yang lebih sesuai dengan skill yang dikuasai saya berharap ada fitur filter lowongan pekerjaan yang tidak mengharuskan menguasai bahasa inggris,39,40,"['saya', 'berharap', 'aplikasi', 'ini', 'lebih', 'fleksibel', 'dalam', 'pencarian', 'lowongan', 'pekerjaan', 'terutama', 'kata', 'kunci', 'yang', 'lebih', 'relevan', 'dan', 'relevansi', 'hasil', 'pencarian', 'yang', 'lebih', 'sesuai', 'dengan', 'skill', 'yang', 'dikuasai', 'saya', 'berharap', 'ada', 'fitur', 'filter', 'lowongan', 'pekerjaan', 'yang', 'tidak', 'mengharuskan', 'menguasai', 'bahasa', 'inggris']","['berharap', 'aplikasi', 'fleksibel', 'pencarian', 'lowongan', 'pekerjaan', 'kunci', 'relevan', 'relevansi', 'hasil', 'pencarian', 'sesuai', 'skill', 'dikuasai', 'berharap', 'fitur', 'filter', 'lowongan', 'pekerjaan', 'tidak', 'mengharuskan', 'menguasai', 'bahasa', 'inggris']",40,24,16,harap aplikasi fleksibel cari lowong kerja kunci relevan relevansi hasil cari sesuai skill asai harap fitur filter lowong kerja tidak harus kuasa bahasa inggris,24,24
"Sekarang linkedin kacau, banyak banget scammer asal india yang buka lowongan kerja, gue ketik kolom pencarian bagian (postingan) lowongan video editor indonesia, yang keluar malah orang india yang buka lowongan kerja ! Risih woy, tolong lah perbaiki algoritma kolom pencarian nya trutama untuk bagian (postingan) agar pas di ketik seseorang dari negara manapun sesuai dengan domisili asal negara orang tersebut tinggal !! Bukan ngasal gini, tinggal di indonesia malah yang keluar loker india !!",negatif,2023-11-18,2023,sekarang linkedin kacau banyak banget scammer asal india yang buka lowongan kerja gue ketik kolom pencarian bagian postingan lowongan video editor indonesia yang keluar malah orang india yang buka lowongan kerja risih woy tolong lah perbaiki algoritma kolom pencarian nya trutama untuk bagian postingan agar pas di ketik seseorang dari negara manapun sesuai dengan domisili asal negara orang tersebut tinggal bukan ngasal gini tinggal di indonesia malah yang keluar loker india,74,71,sekarang linkedin kacau banyak banget scammer asal india yang buka lowongan kerja saya ketik kolom pencarian bagian postingan lowongan video editor indonesia yang keluar bahkan orang india yang buka lowongan kerja risih woy tolong lah perbaikan algoritma kolom pencarian nya terutama untuk bagian postingan agar pas di ketik seseorang dari negara manapun sesuai dengan domisili asal negara orang tersebut tinggal bukan ngasal begini tinggal di indonesia bahkan yang keluar loker india,71,71,"['sekarang', 'linkedin', 'kacau', 'banyak', 'banget', 'scammer', 'asal', 'india', 'yang', 'buka', 'lowongan', 'kerja', 'saya', 'ketik', 'kolom', 'pencarian', 'bagian', 'postingan', 'lowongan', 'video', 'editor', 'indonesia', 'yang', 'keluar', 'bahkan', 'orang', 'india', 'yang', 'buka', 'lowongan', 'kerja', 'risih', 'woy', 'tolong', 'lah', 'perbaikan', 'algoritma', 'kolom', 'pencarian', 'nya', 'terutama', 'untuk', 'bagian', 'postingan', 'agar', 'pas', 'di', 'ketik', 'seseorang', 'dari', 'negara', 'manapun', 'sesuai', 'dengan', 'domisili', 'asal', 'negara', 'orang', 'tersebut', 'tinggal', 'bukan', 'ngasal', 'begini', 'tinggal', 'di', 'indonesia', 'bahkan', 'yang', 'keluar', 'loker', 'india']","['linkedin', 'kacau', 'banget', 'scammer', 'india', 'buka', 'lowongan', 'kerja', 'ketik', 'kolom', 'pencarian', 'postingan', 'lowongan', 'video', 'editor', 'indonesia', 'orang', 'india', 'buka', 'lowongan', 'kerja', 'risih', 'woy', 'tolong', 'perbaikan', 'algoritma', 'kolom', 'pencarian', 'nya', 'postingan', 'pas', 'ketik', 'negara', 'manapun', 'sesuai', 'domisili', 'negara', 'orang', 'tinggal', 'ngasal', 'tinggal', 'indonesia', 'loker', 'india']",71,44,27,linkedin kacau banget scammer india buka lowong kerja ketik kolom cari postingan lowong video editor indonesia orang india buka lowong kerja risih woy tolong baik algoritma kolom cari nya postingan pas ketik negara mana sesuai domisili negara orang tinggal ngasal tinggal indonesia loker india,44,44
"Harga untuk premium terlalu mahal, jadi para jobseeker susah untuk mencari pekerjaan. Saya harap harga untuk premium ini tolong dipertimbangkan lagi. Apalagi bagi para jobseeker menengah kebawah terlalu berat untuk berlangganan, termasuk saya sendiri :)",negatif,2023-10-27,2023,harga untuk premium terlalu mahal jadi para jobseeker susah untuk mencari pekerjaan saya harap harga untuk premium ini tolong dipertimbangkan lagi apalagi bagi para jobseeker menengah kebawah terlalu berat untuk berlangganan termasuk saya sendiri,35,34,harga untuk premium terlalu mahal jadi para jobseeker susah untuk mencari pekerjaan saya harap harga untuk premium ini tolong dipertimbangkan lagi apalagi bagi para jobseeker menengah kebawah terlalu berat untuk berlangganan termasuk saya sendiri,34,34,"['harga', 'untuk', 'premium', 'terlalu', 'mahal', 'jadi', 'para', 'jobseeker', 'susah', 'untuk', 'mencari', 'pekerjaan', 'saya', 'harap', 'harga', 'untuk', 'premium', 'ini', 'tolong', 'dipertimbangkan', 'lagi', 'apalagi', 'bagi', 'para', 'jobseeker', 'menengah', 'kebawah', 'terlalu', 'berat', 'untuk', 'berlangganan', 'termasuk', 'saya', 'sendiri']","['harga', 'premium', 'mahal', 'jobseeker', 'susah', 'mencari', 'pekerjaan', 'harap', 'harga', 'premium', 'tolong', 'dipertimbangkan', 'jobseeker', 'menengah', 'kebawah', 'berat', 'berlangganan']",34,17,17,harga premium mahal jobseeker susah cari kerja harap harga premium tolong timbang jobseeker tengah bawah berat langgan,17,17
"NYUSAHIN. Pas di bagian security cek ga jelas, di Surah sentuh gambar yang menghadap ke atas, tapi pas milih gambar yang mengahadap ke atas malah salah terus. Udah ada kali 10x lebih tapi salah mulu",negatif,2024-01-02,2024,nyusahin pas di bagian security cek ga jelas di surah sentuh gambar yang menghadap ke atas tapi pas milih gambar yang mengahadap ke atas malah salah terus udah ada kali x lebih tapi salah mulu,35,35,nyusahin pas di bagian security cek tidak jelas di surah sentuh gambar yang menghadap ke atas tapi pas memilih gambar yang mengahadap ke atas bahkan salah terus sudah ada kali x lebih tapi salah mulu,35,35,"['nyusahin', 'pas', 'di', 'bagian', 'security', 'cek', 'tidak', 'jelas', 'di', 'surah', 'sentuh', 'gambar', 'yang', 'menghadap', 'ke', 'atas', 'tapi', 'pas', 'memilih', 'gambar', 'yang', 'mengahadap', 'ke', 'atas', 'bahkan', 'salah', 'terus', 'sudah', 'ada', 'kali', 'x', 'lebih', 'tapi', 'salah', 'mulu']","['nyusahin', 'pas', 'security', 'cek', 'tidak', 'surah', 'sentuh', 'gambar', 'menghadap', 'pas', 'memilih', 'gambar', 'mengahadap', 'salah', 'kali', 'x', 'salah', 'mulu']",35,18,17,nyusahin pas security cek tidak surah sentuh gambar hadap pas pilih gambar mengahadap salah kali x salah mulu,18,18
"Saya calon pengguna baru, pas saat Security Check, disana Error terus, Captcha nya Error di bilang saya belum mengisi, padahal sudah 3 jam saya coba terus, keluar masuk aplikasi siapa tau bisa terkonfirmasi ternyata tetap Error, jadi saya Uninstall kembali.",negatif,2023-12-23,2023,saya calon pengguna baru pas saat security check disana error terus captcha nya error di bilang saya belum mengisi padahal sudah jam saya coba terus keluar masuk aplikasi siapa tau bisa terkonfirmasi ternyata tetap error jadi saya uninstall kembali,40,39,saya calon pengguna baru pas saat security cek disana error terus captcha nya error di bilang saya belum mengisi padahal sudah jam saya coba terus keluar masuk aplikasi siapa tahu bisa terkonfirmasi ternyata tetap error jadi saya uninstall kembali,39,39,"['saya', 'calon', 'pengguna', 'baru', 'pas', 'saat', 'security', 'cek', 'disana', 'error', 'terus', 'captcha', 'nya', 'error', 'di', 'bilang', 'saya', 'belum', 'mengisi', 'padahal', 'sudah', 'jam', 'saya', 'coba', 'terus', 'keluar', 'masuk', 'aplikasi', 'siapa', 'tahu', 'bisa', 'terkonfirmasi', 'ternyata', 'tetap', 'error', 'jadi', 'saya', 'uninstall', 'kembali']","['calon', 'pengguna', 'pas', 'security', 'cek', 'disana', 'error', 'captcha', 'nya', 'error', 'bilang', 'mengisi', 'jam', 'coba', 'masuk', 'aplikasi', 'terkonfirmasi', 'error', 'uninstall']",39,19,20,calon guna pas security cek sana error captcha nya error bilang isi jam coba masuk aplikasi konfirmasi error uninstall,19,19
"Ini aplikasi udah bangkrut kali ya.. semua ulasan saya lihat keluhan nya sama.. ga bisa login dan bermasalah di captcha.. saya coba login dari sebulan yang lalu jawabannya sama, verifikasi terus, ga beres beres sampe lebaran jerapah.. aplikasi ga jelas !",negatif,2024-01-16,2024,ini aplikasi udah bangkrut kali ya semua ulasan saya lihat keluhan nya sama ga bisa login dan bermasalah di captcha saya coba login dari sebulan yang lalu jawabannya sama verifikasi terus ga beres beres sampe lebaran jerapah aplikasi ga jelas,41,40,ini aplikasi sudah bangkrut kali ya semua ulasan saya lihat keluhan nya sama tidak bisa login dan bermasalah di captcha saya coba login dari sebulan yang lalu jawabannya sama verifikasi terus tidak beres beres sampai lebaran jerapah aplikasi tidak jelas,40,40,"['ini', 'aplikasi', 'sudah', 'bangkrut', 'kali', 'ya', 'semua', 'ulasan', 'saya', 'lihat', 'keluhan', 'nya', 'sama', 'tidak', 'bisa', 'login', 'dan', 'bermasalah', 'di', 'captcha', 'saya', 'coba', 'login', 'dari', 'sebulan', 'yang', 'lalu', 'jawabannya', 'sama', 'verifikasi', 'terus', 'tidak', 'beres', 'beres', 'sampai', 'lebaran', 'jerapah', 'aplikasi', 'tidak', 'jelas']","['aplikasi', 'bangkrut', 'kali', 'ya', 'ulasan', 'lihat', 'keluhan', 'nya', 'tidak', 'login', 'bermasalah', 'captcha', 'coba', 'login', 'sebulan', 'jawabannya', 'verifikasi', 'tidak', 'beres', 'beres', 'lebaran', 'jerapah', 'aplikasi', 'tidak']",40,24,16,aplikasi bangkrut kali ya ulas lihat keluh nya tidak login masalah captcha coba login bulan jawab verifikasi tidak beres beres lebaran jerapah aplikasi tidak,24,24
"Akun pertama saya tiba-tiba dibatasi, setiap mau login harus verifikasi terlebih dahulu, lalu seminggu kemudian saya membuat akun baru, 2 hari setelahnya ketika saya ingin masuk ke linkedin lagi, akun ke 2 saya tiba-tiba dibatasi lagi, saya tidak paham mengapa begitu, padahal saya tidak memposting apa-apa, bahkan komentar yang aneh-aneh juga tidak, saya buka linkedin hanya untuk mencari lowongan pekerjaan",negatif,2023-09-29,2023,akun pertama saya tiba tiba dibatasi setiap mau login harus verifikasi terlebih dahulu lalu seminggu kemudian saya membuat akun baru hari setelahnya ketika saya ingin masuk ke linkedin lagi akun ke saya tiba tiba dibatasi lagi saya tidak paham mengapa begitu padahal saya tidak memposting apa apa bahkan komentar yang aneh aneh juga tidak saya buka linkedin hanya untuk mencari lowongan pekerjaan,60,62,akun pertama saya tiba tiba dibatasi setiap mau login harus verifikasi terlebih dahulu lalu seminggu kemudian saya membuat akun baru hari setelahnya ketika saya ingin masuk ke linkedin lagi akun ke saya tiba tiba dibatasi lagi saya tidak paham mengapa begitu padahal saya tidak memposting apa apa bahkan komentar yang aneh aneh juga tidak saya buka linkedin hanya untuk mencari lowongan pekerjaan,62,62,"['akun', 'pertama', 'saya', 'tiba', 'tiba', 'dibatasi', 'setiap', 'mau', 'login', 'harus', 'verifikasi', 'terlebih', 'dahulu', 'lalu', 'seminggu', 'kemudian', 'saya', 'membuat', 'akun', 'baru', 'hari', 'setelahnya', 'ketika', 'saya', 'ingin', 'masuk', 'ke', 'linkedin', 'lagi', 'akun', 'ke', 'saya', 'tiba', 'tiba', 'dibatasi', 'lagi', 'saya', 'tidak', 'paham', 'mengapa', 'begitu', 'padahal', 'saya', 'tidak', 'memposting', 'apa', 'apa', 'bahkan', 'komentar', 'yang', 'aneh', 'aneh', 'juga', 'tidak', 'saya', 'buka', 'linkedin', 'hanya', 'untuk', 'mencari', 'lowongan', 'pekerjaan']","['akun', 'dibatasi', 'login', 'verifikasi', 'seminggu', 'akun', 'setelahnya', 'masuk', 'linkedin', 'akun', 'dibatasi', 'tidak', 'paham', 'tidak', 'memposting', 'komentar', 'aneh', 'aneh', 'tidak', 'buka', 'linkedin', 'mencari', 'lowongan', 'pekerjaan']",62,24,38,akun batas login verifikasi minggu akun telah masuk linkedin akun batas tidak paham tidak memposting komentar aneh aneh tidak buka linkedin cari lowong kerja,24,24
"Parah ni aplikasi, susah bgt buat verifikasi ngulang terus padahal udah bener, Kedepan harus ditingkatin lgi untuk bisa dipermudah dalam proses login nya tolong.",negatif,2023-10-22,2023,parah ni aplikasi susah bgt buat verifikasi ngulang terus padahal udah bener kedepan harus ditingkatin lgi untuk bisa dipermudah dalam proses login nya tolong,24,24,parah ini aplikasi susah banget buat verifikasi mengulang terus padahal sudah benar kedepan harus ditingkatkan lagi untuk bisa dipermudah dalam proses login nya tolong,24,24,"['parah', 'ini', 'aplikasi', 'susah', 'banget', 'buat', 'verifikasi', 'mengulang', 'terus', 'padahal', 'sudah', 'benar', 'kedepan', 'harus', 'ditingkatkan', 'lagi', 'untuk', 'bisa', 'dipermudah', 'dalam', 'proses', 'login', 'nya', 'tolong']","['parah', 'aplikasi', 'susah', 'banget', 'verifikasi', 'mengulang', 'kedepan', 'ditingkatkan', 'dipermudah', 'proses', 'login', 'nya', 'tolong']",24,13,11,parah aplikasi susah banget verifikasi ulang depan tingkat mudah proses login nya tolong,13,13
"Dulu aplikasinya bagus, makin kesini ko masih ngga bagus ya gabisa login dan terus menerus meminta verifikasi sudah berulang kali masukin kode yang benar masih aja harus ngulang sampe bosen coba berjam jam buang waktu jadinya",negatif,2024-02-08,2024,dulu aplikasinya bagus makin kesini ko masih ngga bagus ya gabisa login dan terus menerus meminta verifikasi sudah berulang kali masukin kode yang benar masih aja harus ngulang sampe bosen coba berjam jam buang waktu jadinya,36,36,dahulu aplikasi nya bagus makin kesini kok masih tidak bagus ya tidak bisa login dan terus menerus meminta verifikasi sudah berulang kali masukkan kode yang benar masih saja harus mengulang sampai bosen coba berjam jam buang waktu jadinya,36,38,"['dahulu', 'aplikasi', 'nya', 'bagus', 'makin', 'kesini', 'kok', 'masih', 'tidak', 'bagus', 'ya', 'tidak', 'bisa', 'login', 'dan', 'terus', 'menerus', 'meminta', 'verifikasi', 'sudah', 'berulang', 'kali', 'masukkan', 'kode', 'yang', 'benar', 'masih', 'saja', 'harus', 'mengulang', 'sampai', 'bosen', 'coba', 'berjam', 'jam', 'buang', 'waktu', 'jadinya']","['aplikasi', 'nya', 'bagus', 'kesini', 'tidak', 'bagus', 'ya', 'tidak', 'login', 'menerus', 'verifikasi', 'berulang', 'kali', 'masukkan', 'kode', 'mengulang', 'bosen', 'coba', 'berjam', 'jam', 'buang']",38,21,17,aplikasi nya bagus kesini tidak bagus ya tidak login terus verifikasi ulang kali masuk kode ulang bosen coba jam jam buang,21,21
"Kenapa ya setiap membuat akun baru selalu terkena kendala tidak dapat masuk, padahal sudah verifikasi. Sudah membuat akun lagi masih tetap seperti itu, belum juga sehari. Tidak juga saya membuat pelanggaran apapun, eh kena blokir semenjak dari akun pertama. Ayolah developer yang benar aja",negatif,2024-02-13,2024,kenapa ya setiap membuat akun baru selalu terkena kendala tidak dapat masuk padahal sudah verifikasi sudah membuat akun lagi masih tetap seperti itu belum juga sehari tidak juga saya membuat pelanggaran apapun eh kena blokir semenjak dari akun pertama ayolah developer yang benar aja,44,44,kenapa ya setiap membuat akun baru selalu terkena kendala tidak dapat masuk padahal sudah verifikasi sudah membuat akun lagi masih tetap seperti itu belum juga sehari tidak juga saya membuat pelanggaran apapun eh kena blokir semenjak dari akun pertama ayolah developer yang benar saja,44,44,"['kenapa', 'ya', 'setiap', 'membuat', 'akun', 'baru', 'selalu', 'terkena', 'kendala', 'tidak', 'dapat', 'masuk', 'padahal', 'sudah', 'verifikasi', 'sudah', 'membuat', 'akun', 'lagi', 'masih', 'tetap', 'seperti', 'itu', 'belum', 'juga', 'sehari', 'tidak', 'juga', 'saya', 'membuat', 'pelanggaran', 'apapun', 'eh', 'kena', 'blokir', 'semenjak', 'dari', 'akun', 'pertama', 'ayolah', 'developer', 'yang', 'benar', 'saja']","['ya', 'akun', 'terkena', 'kendala', 'tidak', 'masuk', 'verifikasi', 'akun', 'sehari', 'tidak', 'pelanggaran', 'apapun', 'eh', 'kena', 'blokir', 'semenjak', 'akun', 'ayolah', 'developer']",44,19,25,ya akun kena kendala tidak masuk verifikasi akun hari tidak langgar apa eh kena blokir semenjak akun ayo developer,19,19
"asplikasinya sangat mudah digunakan dan sangat membantu dalam mencari pekerjaan, bagi jalian yg ingin cepat mendapatkan pekerjaan coba deh disini nih tempat nya banyak sekali info² loker yg sesuai untuk kriterian skil kamu👍👍",positif,2023-09-17,2023,asplikasinya sangat mudah digunakan dan sangat membantu dalam mencari pekerjaan bagi jalian yg ingin cepat mendapatkan pekerjaan coba deh disini nih tempat nya banyak sekali info² loker yg sesuai untuk kriterian skil kamu,33,33,asplikasinya sangat mudah digunakan dan sangat membantu dalam mencari pekerjaan bagi jalian yang ingin cepat mendapatkan pekerjaan coba deh disini nih tempat nya banyak sekali info² loker yang sesuai untuk kriterian skil kamu,33,33,"['asplikasinya', 'sangat', 'mudah', 'digunakan', 'dan', 'sangat', 'membantu', 'dalam', 'mencari', 'pekerjaan', 'bagi', 'jalian', 'yang', 'ingin', 'cepat', 'mendapatkan', 'pekerjaan', 'coba', 'deh', 'disini', 'nih', 'tempat', 'nya', 'banyak', 'sekali', 'info²', 'loker', 'yang', 'sesuai', 'untuk', 'kriterian', 'skil', 'kamu']","['asplikasinya', 'mudah', 'membantu', 'mencari', 'pekerjaan', 'jalian', 'cepat', 'pekerjaan', 'coba', 'deh', 'nih', 'nya', 'info²', 'loker', 'sesuai', 'kriterian', 'skil']",33,17,16,asplikasinya mudah bantu cari kerja jali cepat kerja coba deh nih nya info loker sesuai kriterian skil,17,17
"Verifikasi susah amat woy, ktp udah di hadapkan yang benar tapi masih salah. Daftar baru nomor sama tidak boleh pake nomor itu, cari kerja susah di tambah masuk aplikasi loker juga susah indonesia emang apa2 susah",negatif,2024-02-19,2024,verifikasi susah amat woy ktp udah di hadapkan yang benar tapi masih salah daftar baru nomor sama tidak boleh pake nomor itu cari kerja susah di tambah masuk aplikasi loker juga susah indonesia emang apa susah,36,36,verifikasi susah amat woy ktp sudah di hadapkan yang benar tapi masih salah daftar baru nomor sama tidak boleh pakai nomor itu cari kerja susah di tambah masuk aplikasi loker juga susah indonesia memang apa susah,36,36,"['verifikasi', 'susah', 'amat', 'woy', 'ktp', 'sudah', 'di', 'hadapkan', 'yang', 'benar', 'tapi', 'masih', 'salah', 'daftar', 'baru', 'nomor', 'sama', 'tidak', 'boleh', 'pakai', 'nomor', 'itu', 'cari', 'kerja', 'susah', 'di', 'tambah', 'masuk', 'aplikasi', 'loker', 'juga', 'susah', 'indonesia', 'memang', 'apa', 'susah']","['verifikasi', 'susah', 'woy', 'ktp', 'hadapkan', 'salah', 'daftar', 'nomor', 'tidak', 'pakai', 'nomor', 'cari', 'kerja', 'susah', 'masuk', 'aplikasi', 'loker', 'susah', 'indonesia', 'susah']",36,20,16,verifikasi susah woy ktp hadap salah daftar nomor tidak pakai nomor cari kerja susah masuk aplikasi loker susah indonesia susah,20,20
"Log in berkali kali tidak bisa, berjam jam hanya disuruh verifikasi terus. Jawaban benar tetap suruh jawab pertanyaan terus sampek berjam2 coba ganti dihari lain tetap seperti itu. Tidak bisa log in",negatif,2023-11-28,2023,log in berkali kali tidak bisa berjam jam hanya disuruh verifikasi terus jawaban benar tetap suruh jawab pertanyaan terus sampek berjam coba ganti dihari lain tetap seperti itu tidak bisa log in,32,32,log in berkali kali tidak bisa berjam jam hanya disuruh verifikasi terus jawaban benar tetap suruh jawab pertanyaan terus sampai berjam coba ganti dihari lain tetap seperti itu tidak bisa log in,32,32,"['log', 'in', 'berkali', 'kali', 'tidak', 'bisa', 'berjam', 'jam', 'hanya', 'disuruh', 'verifikasi', 'terus', 'jawaban', 'benar', 'tetap', 'suruh', 'jawab', 'pertanyaan', 'terus', 'sampai', 'berjam', 'coba', 'ganti', 'dihari', 'lain', 'tetap', 'seperti', 'itu', 'tidak', 'bisa', 'log', 'in']","['log', 'in', 'berkali', 'kali', 'tidak', 'berjam', 'jam', 'disuruh', 'verifikasi', 'suruh', 'berjam', 'coba', 'ganti', 'dihari', 'tidak', 'log', 'in']",32,17,15,log in kali kali tidak jam jam suruh verifikasi suruh jam coba ganti hari tidak log in,17,17
"Ini kenapa ya Min kok perbarui profil tidak bisa, terus lagi mau edit yg udah ke simpan terus edit lagi disimpan lagi malah hilang semua aktivitas dan deskripsi nya🥺😭 tidak bisa menggugah dokumen terus lagi logo kampus saya universitas jember ngga ada lagi 😭🥺",negatif,2022-08-18,2022,ini kenapa ya min kok perbarui profil tidak bisa terus lagi mau edit yg udah ke simpan terus edit lagi disimpan lagi malah hilang semua aktivitas dan deskripsi nya tidak bisa menggugah dokumen terus lagi logo kampus saya universitas jember ngga ada lagi,44,43,ini kenapa ya minimal kok perbarui profil tidak bisa terus lagi mau edit yang sudah ke simpan terus edit lagi disimpan lagi bahkan hilang semua aktivitas dan deskripsi nya tidak bisa menggugah dokumen terus lagi logo kampus saya universitas jember tidak ada lagi,43,43,"['ini', 'kenapa', 'ya', 'minimal', 'kok', 'perbarui', 'profil', 'tidak', 'bisa', 'terus', 'lagi', 'mau', 'edit', 'yang', 'sudah', 'ke', 'simpan', 'terus', 'edit', 'lagi', 'disimpan', 'lagi', 'bahkan', 'hilang', 'semua', 'aktivitas', 'dan', 'deskripsi', 'nya', 'tidak', 'bisa', 'menggugah', 'dokumen', 'terus', 'lagi', 'logo', 'kampus', 'saya', 'universitas', 'jember', 'tidak', 'ada', 'lagi']","['ya', 'minimal', 'perbarui', 'profil', 'tidak', 'edit', 'simpan', 'edit', 'disimpan', 'hilang', 'aktivitas', 'deskripsi', 'nya', 'tidak', 'menggugah', 'dokumen', 'logo', 'kampus', 'universitas', 'jember', 'tidak']",43,21,22,ya minimal baru profil tidak edit simpan edit simpan hilang aktivitas deskripsi nya tidak gugah dokumen logo kampus universitas jember tidak,21,21
"ini makhsudnya gimana ya? saya pengen buat akun di apk ini pas mau verifikasi captcha malah error, saya udh ikutin semua instruksi nya tp masih aja ttp error. habis waktu 30 menit cuma buat verifikasi doang",negatif,2024-01-03,2024,ini makhsudnya gimana ya saya pengen buat akun di apk ini pas mau verifikasi captcha malah error saya udh ikutin semua instruksi nya tp masih aja ttp error habis waktu menit cuma buat verifikasi doang,36,35,ini makhsudnya bagaimana ya saya pengen buat akun di aplikasi ini pas mau verifikasi captcha bahkan error saya sudah ikutin semua instruksi nya tapi masih saja tetap error habis waktu menit cuma buat verifikasi saja,35,35,"['ini', 'makhsudnya', 'bagaimana', 'ya', 'saya', 'pengen', 'buat', 'akun', 'di', 'aplikasi', 'ini', 'pas', 'mau', 'verifikasi', 'captcha', 'bahkan', 'error', 'saya', 'sudah', 'ikutin', 'semua', 'instruksi', 'nya', 'tapi', 'masih', 'saja', 'tetap', 'error', 'habis', 'waktu', 'menit', 'cuma', 'buat', 'verifikasi', 'saja']","['makhsudnya', 'ya', 'pengen', 'akun', 'aplikasi', 'pas', 'verifikasi', 'captcha', 'error', 'ikutin', 'instruksi', 'nya', 'error', 'habis', 'menit', 'verifikasi']",35,16,19,makhsudnya ya ken akun aplikasi pas verifikasi captcha error ikutin instruksi nya error habis menit verifikasi,16,16
Maaf. Akun saya telah dibatasi sementara. Saya telah mengupload KTP sesuai dengan apa yang diminta. Namun masih belum ada kepastian kapan akan diproses. Jujur saya enggan untuk berganti akun karena saya mendaftar menggunakan email utama saya. Apakah ada jalan keluar untuk hal ini. Jika memang ada hal yang kurang mengenakkan selama saya berlaku di LinkedIn bisa dibicarakan karena saya pun baru pertama kali memakai aplikasi ini. Mohon kompromi dan jalan keluar nya. Terima kasih,negatif,2023-09-01,2023,maaf akun saya telah dibatasi sementara saya telah mengupload ktp sesuai dengan apa yang diminta namun masih belum ada kepastian kapan akan diproses jujur saya enggan untuk berganti akun karena saya mendaftar menggunakan email utama saya apakah ada jalan keluar untuk hal ini jika memang ada hal yang kurang mengenakkan selama saya berlaku di linkedin bisa dibicarakan karena saya pun baru pertama kali memakai aplikasi ini mohon kompromi dan jalan keluar nya terima kasih,74,74,maaf akun saya telah dibatasi sementara saya telah mengupload ktp sesuai dengan apa yang diminta namun masih belum ada kepastian kapan akan diproses jujur saya enggan untuk berganti akun karena saya mendaftar menggunakan email utama saya apakah ada jalan keluar untuk hal ini jika memang ada hal yang kurang mengenakkan selama saya berlaku di linkedin bisa dibicarakan karena saya pun baru pertama kali memakai aplikasi ini mohon kompromi dan jalan keluar nya terima kasih,74,74,"['maaf', 'akun', 'saya', 'telah', 'dibatasi', 'sementara', 'saya', 'telah', 'mengupload', 'ktp', 'sesuai', 'dengan', 'apa', 'yang', 'diminta', 'namun', 'masih', 'belum', 'ada', 'kepastian', 'kapan', 'akan', 'diproses', 'jujur', 'saya', 'enggan', 'untuk', 'berganti', 'akun', 'karena', 'saya', 'mendaftar', 'menggunakan', 'email', 'utama', 'saya', 'apakah', 'ada', 'jalan', 'keluar', 'untuk', 'hal', 'ini', 'jika', 'memang', 'ada', 'hal', 'yang', 'kurang', 'mengenakkan', 'selama', 'saya', 'berlaku', 'di', 'linkedin', 'bisa', 'dibicarakan', 'karena', 'saya', 'pun', 'baru', 'pertama', 'kali', 'memakai', 'aplikasi', 'ini', 'mohon', 'kompromi', 'dan', 'jalan', 'keluar', 'nya', 'terima', 'kasih']","['maaf', 'akun', 'dibatasi', 'mengupload', 'ktp', 'sesuai', 'kepastian', 'diproses', 'jujur', 'enggan', 'berganti', 'akun', 'mendaftar', 'email', 'utama', 'jalan', 'mengenakkan', 'berlaku', 'linkedin', 'dibicarakan', 'kali', 'memakai', 'aplikasi', 'mohon', 'kompromi', 'jalan', 'nya', 'terima', 'kasih']",74,29,45,maaf akun batas mengupload ktp sesuai pasti proses jujur enggan ganti akun daftar email utama jalan enak laku linkedin bicara kali pakai aplikasi mohon kompromi jalan nya terima kasih,29,29
"Buat masuk dan sekedar daftar aja susah nya minta ampun, banteng dan kodok di suruh pilih yang ke arah atas padahal binatang nya di putar 2 dan aneh nya setelah 15 X percobaan ngk ada yang lolos, bintang 1 buat yang bikin ribet.",negatif,2021-03-24,2021,buat masuk dan sekedar daftar aja susah nya minta ampun banteng dan kodok di suruh pilih yang ke arah atas padahal binatang nya di putar dan aneh nya setelah x percobaan ngk ada yang lolos bintang buat yang bikin ribet,43,40,buat masuk dan sekadar daftar saja susah nya minta ampun banteng dan kodok di suruh pilih yang ke arah atas padahal binatang nya di putar dan aneh nya setelah x percobaan tidak ada yang lolos bintang buat yang bikin rumit,40,40,"['buat', 'masuk', 'dan', 'sekadar', 'daftar', 'saja', 'susah', 'nya', 'minta', 'ampun', 'banteng', 'dan', 'kodok', 'di', 'suruh', 'pilih', 'yang', 'ke', 'arah', 'atas', 'padahal', 'binatang', 'nya', 'di', 'putar', 'dan', 'aneh', 'nya', 'setelah', 'x', 'percobaan', 'tidak', 'ada', 'yang', 'lolos', 'bintang', 'buat', 'yang', 'bikin', 'rumit']","['masuk', 'daftar', 'susah', 'nya', 'ampun', 'banteng', 'kodok', 'suruh', 'pilih', 'arah', 'binatang', 'nya', 'putar', 'aneh', 'nya', 'x', 'percobaan', 'tidak', 'lolos', 'bintang', 'bikin', 'rumit']",40,22,18,masuk daftar susah nya ampun banteng kodok suruh pilih arah binatang nya putar aneh nya x coba tidak lolos bintang bikin rumit,22,22
"Woy login nya susah amat, udah bener jawab teka teki nya malah gagal trus login nya. Mending verifikasi robot nya pakai centang google biasa ajah yg mudah. Dan juga kenapa akun saya kena blokir ngga bisa login padahal saya tidak melakukan pelanggaran apapun udah verifikasi identitas tetep gagal. Dan ini tadi udah berhasil login tapi akun saya udah dipakai oleh orang lain. TOLONG DIPERBAIKI DEVELOPER",negatif,2024-02-19,2024,woy login nya susah amat udah bener jawab teka teki nya malah gagal trus login nya mending verifikasi robot nya pakai centang google biasa ajah yg mudah dan juga kenapa akun saya kena blokir ngga bisa login padahal saya tidak melakukan pelanggaran apapun udah verifikasi identitas tetep gagal dan ini tadi udah berhasil login tapi akun saya udah dipakai oleh orang lain tolong diperbaiki developer,65,65,woy login nya susah amat sudah benar jawab teka teki nya bahkan gagal terus login nya mending verifikasi robot nya pakai centang google biasa ajah yang mudah dan juga kenapa akun saya kena blokir tidak bisa login padahal saya tidak melakukan pelanggaran apapun sudah verifikasi identitas tetap gagal dan ini tadi sudah berhasil login tapi akun saya sudah dipakai oleh orang lain tolong di perbaiki developer,65,66,"['woy', 'login', 'nya', 'susah', 'amat', 'sudah', 'benar', 'jawab', 'teka', 'teki', 'nya', 'bahkan', 'gagal', 'terus', 'login', 'nya', 'mending', 'verifikasi', 'robot', 'nya', 'pakai', 'centang', 'google', 'biasa', 'ajah', 'yang', 'mudah', 'dan', 'juga', 'kenapa', 'akun', 'saya', 'kena', 'blokir', 'tidak', 'bisa', 'login', 'padahal', 'saya', 'tidak', 'melakukan', 'pelanggaran', 'apapun', 'sudah', 'verifikasi', 'identitas', 'tetap', 'gagal', 'dan', 'ini', 'tadi', 'sudah', 'berhasil', 'login', 'tapi', 'akun', 'saya', 'sudah', 'dipakai', 'oleh', 'orang', 'lain', 'tolong', 'di', 'perbaiki', 'developer']","['woy', 'login', 'nya', 'susah', 'teka', 'teki', 'nya', 'gagal', 'login', 'nya', 'mending', 'verifikasi', 'robot', 'nya', 'pakai', 'centang', 'google', 'ajah', 'mudah', 'akun', 'kena', 'blokir', 'tidak', 'login', 'tidak', 'pelanggaran', 'apapun', 'verifikasi', 'identitas', 'gagal', 'berhasil', 'login', 'akun', 'dipakai', 'orang', 'tolong', 'perbaiki', 'developer']",66,38,28,woy login nya susah teka teki nya gagal login nya mending verifikasi robot nya pakai centang google ajah mudah akun kena blokir tidak login tidak langgar apa verifikasi identitas gagal hasil login akun pakai orang tolong baik developer,38,38
"Sangat membantu dalam mencari pekerjaan dan pengetahuan serta menyalurkan ilmu, usaha, bakat yang dapat mempermudah setiap orang diseluruh dunia untuk setiap individu yang maju, tangguh yang berkepribadian kuat.",positif,2020-07-19,2020,sangat membantu dalam mencari pekerjaan dan pengetahuan serta menyalurkan ilmu usaha bakat yang dapat mempermudah setiap orang diseluruh dunia untuk setiap individu yang maju tangguh yang berkepribadian kuat,28,28,sangat membantu dalam mencari pekerjaan dan pengetahuan serta menyalurkan ilmu usaha bakat yang dapat mempermudah setiap orang diseluruh dunia untuk setiap individu yang maju tangguh yang berkepribadian kuat,28,28,"['sangat', 'membantu', 'dalam', 'mencari', 'pekerjaan', 'dan', 'pengetahuan', 'serta', 'menyalurkan', 'ilmu', 'usaha', 'bakat', 'yang', 'dapat', 'mempermudah', 'setiap', 'orang', 'diseluruh', 'dunia', 'untuk', 'setiap', 'individu', 'yang', 'maju', 'tangguh', 'yang', 'berkepribadian', 'kuat']","['membantu', 'mencari', 'pekerjaan', 'pengetahuan', 'menyalurkan', 'ilmu', 'usaha', 'bakat', 'mempermudah', 'orang', 'diseluruh', 'dunia', 'individu', 'maju', 'tangguh', 'berkepribadian', 'kuat']",28,17,11,bantu cari kerja tahu salur ilmu usaha bakat mudah orang seluruh dunia individu maju tangguh pribadi kuat,17,17
"Sekarang ini mencari kerja di linkedIn sulit sekali walau sudah akun premium tidak ada impact apa2, banyak tawaran pekerjaan & sudah apply tapi perusahan tidak pernah ada respon, harap diperbaiki. Tks",negatif,2023-08-24,2023,sekarang ini mencari kerja di linkedin sulit sekali walau sudah akun premium tidak ada impact apa banyak tawaran pekerjaan sudah apply tapi perusahan tidak pernah ada respon harap diperbaiki tks,31,30,sekarang ini mencari kerja di linkedin sulit sekali walau sudah akun premium tidak ada impact apa banyak tawaran pekerjaan sudah apply tapi perusahan tidak pernah ada respons harap di perbaiki terima kasih,30,32,"['sekarang', 'ini', 'mencari', 'kerja', 'di', 'linkedin', 'sulit', 'sekali', 'walau', 'sudah', 'akun', 'premium', 'tidak', 'ada', 'impact', 'apa', 'banyak', 'tawaran', 'pekerjaan', 'sudah', 'apply', 'tapi', 'perusahan', 'tidak', 'pernah', 'ada', 'respons', 'harap', 'di', 'perbaiki', 'terima', 'kasih']","['mencari', 'kerja', 'linkedin', 'sulit', 'akun', 'premium', 'tidak', 'impact', 'tawaran', 'pekerjaan', 'apply', 'perusahan', 'tidak', 'respons', 'harap', 'perbaiki', 'terima', 'kasih']",32,18,14,cari kerja linkedin sulit akun premium tidak impact tawar kerja apply usah tidak respons harap baik terima kasih,18,18
"Ini gimana sih, udh berkali2 upload postingan gagal mulu. Tolong dong diperbaiki. Padahal jaringan ku lancar dan udh pake wifi juga. Tetep gamau",negatif,2023-05-27,2023,ini gimana sih udh berkali upload postingan gagal mulu tolong dong diperbaiki padahal jaringan ku lancar dan udh pake wifi juga tetep gamau,23,23,ini bagaimana sih sudah berkali unggah postingan gagal mulu tolong dong di perbaiki padahal jaringan saya lancar dan sudah pakai wifi juga tetap tidak mau,23,25,"['ini', 'bagaimana', 'sih', 'sudah', 'berkali', 'unggah', 'postingan', 'gagal', 'mulu', 'tolong', 'dong', 'di', 'perbaiki', 'padahal', 'jaringan', 'saya', 'lancar', 'dan', 'sudah', 'pakai', 'wifi', 'juga', 'tetap', 'tidak', 'mau']","['sih', 'berkali', 'unggah', 'postingan', 'gagal', 'mulu', 'tolong', 'perbaiki', 'jaringan', 'lancar', 'pakai', 'wifi', 'tidak']",25,13,12,sih kali unggah postingan gagal mulu tolong baik jaring lancar pakai wifi tidak,13,13
"Tidak bisa login, setiap ingin login selalu diminta untuk mengisi verifikasi yang membuktikan anda benar-benar manusia. Tetapi, setelah itu selalu muncul Respons kode noCAPTCHA Anda tidak valid atau belum diisi. Proses tersebut terus berulang dan tidak selesai-selesai.",negatif,2023-09-17,2023,tidak bisa login setiap ingin login selalu diminta untuk mengisi verifikasi yang membuktikan anda benar benar manusia tetapi setelah itu selalu muncul respons kode nocaptcha anda tidak valid atau belum diisi proses tersebut terus berulang dan tidak selesai selesai,37,39,tidak bisa login setiap ingin login selalu diminta untuk mengisi verifikasi yang membuktikan anda benar benar manusia tetapi setelah itu selalu muncul respons kode nocaptcha anda tidak valid atau belum diisi proses tersebut terus berulang dan tidak selesai selesai,39,39,"['tidak', 'bisa', 'login', 'setiap', 'ingin', 'login', 'selalu', 'diminta', 'untuk', 'mengisi', 'verifikasi', 'yang', 'membuktikan', 'anda', 'benar', 'benar', 'manusia', 'tetapi', 'setelah', 'itu', 'selalu', 'muncul', 'respons', 'kode', 'nocaptcha', 'anda', 'tidak', 'valid', 'atau', 'belum', 'diisi', 'proses', 'tersebut', 'terus', 'berulang', 'dan', 'tidak', 'selesai', 'selesai']","['tidak', 'login', 'login', 'mengisi', 'verifikasi', 'membuktikan', 'manusia', 'muncul', 'respons', 'kode', 'nocaptcha', 'tidak', 'valid', 'diisi', 'proses', 'berulang', 'tidak', 'selesai', 'selesai']",39,19,20,tidak login login isi verifikasi bukti manusia muncul respons kode nocaptcha tidak valid isi proses ulang tidak selesai selesai,19,19
"tiba tiba akun di tangguhkan,udah nyoba log in berkali kali tetep ga bisa,udah verifikasi identitas juga tetep ga bisa.mohon di bantu dong.semuanya jadi terhambat terganggu siapa yang mau tanggung jawab.tolong di perbaiki lagi",negatif,2023-12-03,2023,tiba tiba akun di tangguhkan udah nyoba log in berkali kali tetep ga bisa udah verifikasi identitas juga tetep ga bisa mohon di bantu dong semuanya jadi terhambat terganggu siapa yang mau tanggung jawab tolong di perbaiki lagi,33,38,tiba tiba akun di tangguhkan sudah mencoba log in berkali kali tetap tidak bisa sudah verifikasi identitas juga tetap tidak bisa mohon di bantu dong semuanya jadi terhambat terganggu siapa yang mau tanggung jawab tolong di perbaikan lagi,38,38,"['tiba', 'tiba', 'akun', 'di', 'tangguhkan', 'sudah', 'mencoba', 'log', 'in', 'berkali', 'kali', 'tetap', 'tidak', 'bisa', 'sudah', 'verifikasi', 'identitas', 'juga', 'tetap', 'tidak', 'bisa', 'mohon', 'di', 'bantu', 'dong', 'semuanya', 'jadi', 'terhambat', 'terganggu', 'siapa', 'yang', 'mau', 'tanggung', 'jawab', 'tolong', 'di', 'perbaikan', 'lagi']","['akun', 'tangguhkan', 'mencoba', 'log', 'in', 'berkali', 'kali', 'tidak', 'verifikasi', 'identitas', 'tidak', 'mohon', 'bantu', 'terhambat', 'terganggu', 'tanggung', 'tolong', 'perbaikan']",38,18,20,akun tangguh coba log in kali kali tidak verifikasi identitas tidak mohon bantu hambat ganggu tanggung tolong baik,18,18
Kesulitan ketika diminta verivikasi dua langkah dan no hp yang digunakan sudah lama tidak digunakan. Menggunakan email yang terdaftar saja tidak cukup untuk bisa login dan merubah settingan,negatif,2023-12-11,2023,kesulitan ketika diminta verivikasi dua langkah dan no hp yang digunakan sudah lama tidak digunakan menggunakan email yang terdaftar saja tidak cukup untuk bisa login dan merubah settingan,28,28,kesulitan ketika diminta verivikasi dua langkah dan nomor handphone yang digunakan sudah lama tidak digunakan menggunakan email yang terdaftar saja tidak cukup untuk bisa login dan merubah settingan,28,28,"['kesulitan', 'ketika', 'diminta', 'verivikasi', 'dua', 'langkah', 'dan', 'nomor', 'handphone', 'yang', 'digunakan', 'sudah', 'lama', 'tidak', 'digunakan', 'menggunakan', 'email', 'yang', 'terdaftar', 'saja', 'tidak', 'cukup', 'untuk', 'bisa', 'login', 'dan', 'merubah', 'settingan']","['kesulitan', 'verivikasi', 'langkah', 'nomor', 'handphone', 'tidak', 'email', 'terdaftar', 'tidak', 'login', 'merubah', 'settingan']",28,12,16,sulit verivikasi langkah nomor handphone tidak email daftar tidak login rubah settingan,12,12
"D update dong lokernya , itu itu aja lokernya , ga ada perkembangan loker gtu, itu itu aja. Kita downlod , masuk aplikasi pake kuota jga , berbayar dong artinya kan , lbh d update mas , jngn monoton , kasian yg cari kerja pake aplikasi ini . Mengerikan",negatif,2023-12-27,2023,d update dong lokernya itu itu aja lokernya ga ada perkembangan loker gtu itu itu aja kita downlod masuk aplikasi pake kuota jga berbayar dong artinya kan lbh d update mas jngn monoton kasian yg cari kerja pake aplikasi ini mengerikan,49,41,di diperbarui dong lokernya itu itu saja lokernya tidak ada perkembangan loker begitu itu itu saja kita downlod masuk aplikasi pakai kuota juga berbayar dong artinya akan lebih di diperbarui mas jangan monoton kasian yang cari kerja pakai aplikasi ini mengerikan,41,41,"['di', 'diperbarui', 'dong', 'lokernya', 'itu', 'itu', 'saja', 'lokernya', 'tidak', 'ada', 'perkembangan', 'loker', 'begitu', 'itu', 'itu', 'saja', 'kita', 'downlod', 'masuk', 'aplikasi', 'pakai', 'kuota', 'juga', 'berbayar', 'dong', 'artinya', 'akan', 'lebih', 'di', 'diperbarui', 'mas', 'jangan', 'monoton', 'kasian', 'yang', 'cari', 'kerja', 'pakai', 'aplikasi', 'ini', 'mengerikan']","['diperbarui', 'lokernya', 'lokernya', 'tidak', 'perkembangan', 'loker', 'downlod', 'masuk', 'aplikasi', 'pakai', 'kuota', 'berbayar', 'diperbarui', 'mas', 'monoton', 'kasian', 'cari', 'kerja', 'pakai', 'aplikasi', 'mengerikan']",41,21,20,baru lokernya lokernya tidak kembang loker downlod masuk aplikasi pakai kuota bayar baru mas monoton kasi cari kerja pakai aplikasi keri,21,21
"Saya pengguna LinkedIn baru,tapi ada teka teki yang harus di jawab untuk masuk ke dalam nya,saya udah coba berkali2 gagal terus,habis waktu buat masuk ke dalam server nya aja,niat mau cari2 kerja malah jadi di persulit sama teka teki gak jelas kaya gitu.",negatif,2023-12-25,2023,saya pengguna linkedin baru tapi ada teka teki yang harus di jawab untuk masuk ke dalam nya saya udah coba berkali gagal terus habis waktu buat masuk ke dalam server nya aja niat mau cari kerja malah jadi di persulit sama teka teki gak jelas kaya gitu,43,47,saya pengguna linkedin baru tapi ada teka teki yang harus di jawab untuk masuk ke dalam nya saya sudah coba berkali gagal terus habis waktu buat masuk ke dalam server nya saja niat mau cari kerja bahkan jadi di persulit sama teka teki tidak jelas kayak begitu,47,47,"['saya', 'pengguna', 'linkedin', 'baru', 'tapi', 'ada', 'teka', 'teki', 'yang', 'harus', 'di', 'jawab', 'untuk', 'masuk', 'ke', 'dalam', 'nya', 'saya', 'sudah', 'coba', 'berkali', 'gagal', 'terus', 'habis', 'waktu', 'buat', 'masuk', 'ke', 'dalam', 'server', 'nya', 'saja', 'niat', 'mau', 'cari', 'kerja', 'bahkan', 'jadi', 'di', 'persulit', 'sama', 'teka', 'teki', 'tidak', 'jelas', 'kayak', 'begitu']","['pengguna', 'linkedin', 'teka', 'teki', 'masuk', 'nya', 'coba', 'berkali', 'gagal', 'habis', 'masuk', 'server', 'nya', 'niat', 'cari', 'kerja', 'persulit', 'teka', 'teki', 'tidak', 'kayak']",47,21,26,guna linkedin teka teki masuk nya coba kali gagal habis masuk server nya niat cari kerja sulit teka teki tidak kayak,21,21
"Udah ge ngerti lagi gimana caranya buat login di aplikasi ni,,akun ku udah 3 hari dibatasi ga bisa"" login padahal aku dah up identitas sesuai dengan arahan,,tolong secepatnya pulihkan akun saya,,soalnya bener-bener perlu,,sementara ku kasi bintang 1",negatif,2023-08-03,2023,udah ge ngerti lagi gimana caranya buat login di aplikasi ni akun ku udah hari dibatasi ga bisa login padahal aku dah up identitas sesuai dengan arahan tolong secepatnya pulihkan akun saya soalnya bener bener perlu sementara ku kasi bintang,37,40,sudah ge mengerti lagi bagaimana caranya buat login di aplikasi ini akun saya sudah hari dibatasi tidak bisa login padahal aku sudah up identitas sesuai dengan arahan tolong secepatnya pulihkan akun saya soalnya benar benar perlu sementara saya kasih bintang,40,40,"['sudah', 'ge', 'mengerti', 'lagi', 'bagaimana', 'caranya', 'buat', 'login', 'di', 'aplikasi', 'ini', 'akun', 'saya', 'sudah', 'hari', 'dibatasi', 'tidak', 'bisa', 'login', 'padahal', 'aku', 'sudah', 'up', 'identitas', 'sesuai', 'dengan', 'arahan', 'tolong', 'secepatnya', 'pulihkan', 'akun', 'saya', 'soalnya', 'benar', 'benar', 'perlu', 'sementara', 'saya', 'kasih', 'bintang']","['ge', 'mengerti', 'login', 'aplikasi', 'akun', 'dibatasi', 'tidak', 'login', 'up', 'identitas', 'sesuai', 'arahan', 'tolong', 'secepatnya', 'pulihkan', 'akun', 'kasih', 'bintang']",40,18,22,ge erti login aplikasi akun batas tidak login up identitas sesuai arah tolong cepat pulih akun kasih bintang,18,18
"Jujur saya adl pengguna LinkedIn dan saya suka, tapi minusnya jika saya ingin tag/kirim hal penting ke teman tidak bisa, padahal sudah terhubung dan saling mengikuti. Mohon untuk di perbaiki karena ini merupakan apk fav saya",negatif,2023-12-08,2023,jujur saya adl pengguna linkedin dan saya suka tapi minusnya jika saya ingin tag kirim hal penting ke teman tidak bisa padahal sudah terhubung dan saling mengikuti mohon untuk di perbaiki karena ini merupakan apk fav saya,36,37,jujur saya adalah pengguna linkedin dan saya suka tapi minusnya jika saya ingin tag kirim hal penting ke teman tidak bisa padahal sudah terhubung dan saling mengikuti mohon untuk di perbaikan karena ini merupakan aplikasi fav saya,37,37,"['jujur', 'saya', 'adalah', 'pengguna', 'linkedin', 'dan', 'saya', 'suka', 'tapi', 'minusnya', 'jika', 'saya', 'ingin', 'tag', 'kirim', 'hal', 'penting', 'ke', 'teman', 'tidak', 'bisa', 'padahal', 'sudah', 'terhubung', 'dan', 'saling', 'mengikuti', 'mohon', 'untuk', 'di', 'perbaikan', 'karena', 'ini', 'merupakan', 'aplikasi', 'fav', 'saya']","['jujur', 'pengguna', 'linkedin', 'suka', 'minusnya', 'tag', 'kirim', 'teman', 'tidak', 'terhubung', 'mengikuti', 'mohon', 'perbaikan', 'aplikasi', 'fav']",37,15,22,jujur guna linkedin suka minus tag kirim teman tidak hubung ikut mohon baik aplikasi fav,15,15
"Tidak bisa log in, sudah terverifikasi sebagai manusia tapi ada tulisan error no captha belum diisi mengambang di atas dan prosesnya berulang untuk verifikasi lagi dan tidak selesai selesai",negatif,2023-09-14,2023,tidak bisa log in sudah terverifikasi sebagai manusia tapi ada tulisan error no captha belum diisi mengambang di atas dan prosesnya berulang untuk verifikasi lagi dan tidak selesai selesai,29,29,tidak bisa log in sudah terverifikasi sebagai manusia tapi ada tulisan error nomor captha belum diisi mengambang di atas dan prosesnya berulang untuk verifikasi lagi dan tidak selesai selesai,29,29,"['tidak', 'bisa', 'log', 'in', 'sudah', 'terverifikasi', 'sebagai', 'manusia', 'tapi', 'ada', 'tulisan', 'error', 'nomor', 'captha', 'belum', 'diisi', 'mengambang', 'di', 'atas', 'dan', 'prosesnya', 'berulang', 'untuk', 'verifikasi', 'lagi', 'dan', 'tidak', 'selesai', 'selesai']","['tidak', 'log', 'in', 'terverifikasi', 'manusia', 'tulisan', 'error', 'nomor', 'captha', 'diisi', 'mengambang', 'prosesnya', 'berulang', 'verifikasi', 'tidak', 'selesai', 'selesai']",29,17,12,tidak log in verifikasi manusia tulis error nomor captha isi ambang proses ulang verifikasi tidak selesai selesai,17,17
"email dan password sudah betul, sudah coba login dgn berbagai cara tp disuruh verifikasi gambar teruss, padahal udh centang juga verif nya tp ttp gabisa loginn, heran bgt kenapa kaya gt truss pdhl lagi butuh banget urgent pke app ini, tolong diperbaiki🙏🙏🙏",negatif,2023-07-26,2023,email dan password sudah betul sudah coba login dgn berbagai cara tp disuruh verifikasi gambar teruss padahal udh centang juga verif nya tp ttp gabisa loginn heran bgt kenapa kaya gt truss pdhl lagi butuh banget urgent pke app ini tolong diperbaiki,42,42,email dan password sudah betul sudah coba login dengan berbagai cara tapi disuruh verifikasi gambar terus padahal sudah centang juga verif nya tapi tetap tidak bisa loginn heran banget kenapa kayak begitu truss padahal lagi butuh banget urgent pakai aplikasi ini tolong di perbaiki,42,44,"['email', 'dan', 'password', 'sudah', 'betul', 'sudah', 'coba', 'login', 'dengan', 'berbagai', 'cara', 'tapi', 'disuruh', 'verifikasi', 'gambar', 'terus', 'padahal', 'sudah', 'centang', 'juga', 'verif', 'nya', 'tapi', 'tetap', 'tidak', 'bisa', 'loginn', 'heran', 'banget', 'kenapa', 'kayak', 'begitu', 'truss', 'padahal', 'lagi', 'butuh', 'banget', 'urgent', 'pakai', 'aplikasi', 'ini', 'tolong', 'di', 'perbaiki']","['email', 'password', 'coba', 'login', 'disuruh', 'verifikasi', 'gambar', 'centang', 'verif', 'nya', 'tidak', 'loginn', 'heran', 'banget', 'kayak', 'truss', 'butuh', 'banget', 'urgent', 'pakai', 'aplikasi', 'tolong', 'perbaiki']",44,23,21,email password coba login suruh verifikasi gambar centang verif nya tidak loginn heran banget kayak truss butuh banget urgent pakai aplikasi tolong baik,23,23
"Saat login diminta menebak captcha. setelah verifikasi selesai (anda membuktikan bahwa anda manusia). Lalutiba-tida ada notifikasi "" Respon kode captcha anda belum diisi atau tidak falid"". Lalu capfcha ulang lagi, captcha dengan suara juga sama",negatif,2023-08-01,2023,saat login diminta menebak captcha setelah verifikasi selesai anda membuktikan bahwa anda manusia lalutiba tida ada notifikasi respon kode captcha anda belum diisi atau tidak falid lalu capfcha ulang lagi captcha dengan suara juga sama,35,35,saat login diminta menebak captcha setelah verifikasi selesai anda membuktikan bahwa anda manusia lalutiba tida ada notifikasi respons kode captcha anda belum diisi atau tidak falid lalu capfcha ulang lagi captcha dengan suara juga sama,35,35,"['saat', 'login', 'diminta', 'menebak', 'captcha', 'setelah', 'verifikasi', 'selesai', 'anda', 'membuktikan', 'bahwa', 'anda', 'manusia', 'lalutiba', 'tida', 'ada', 'notifikasi', 'respons', 'kode', 'captcha', 'anda', 'belum', 'diisi', 'atau', 'tidak', 'falid', 'lalu', 'capfcha', 'ulang', 'lagi', 'captcha', 'dengan', 'suara', 'juga', 'sama']","['login', 'menebak', 'captcha', 'verifikasi', 'selesai', 'membuktikan', 'manusia', 'lalutiba', 'tida', 'notifikasi', 'respons', 'kode', 'captcha', 'diisi', 'tidak', 'falid', 'capfcha', 'ulang', 'captcha', 'suara']",35,20,15,login tebak captcha verifikasi selesai bukti manusia lalutiba tida notifikasi respons kode captcha isi tidak falid capfcha ulang captcha suara,20,20
"Isi chatting atau message tidak bisa dihapus hanya diarsipkan dan itu terus aja ada walaupun sudah diarsipkan...tolong diperbaiki kembali karena banyak message yg spam juga kaya nawarin produk2, pengen di hapus selamanya aja untuk message spam.",negatif,2020-04-02,2020,isi chatting atau message tidak bisa dihapus hanya diarsipkan dan itu terus aja ada walaupun sudah diarsipkan tolong diperbaiki kembali karena banyak message yg spam juga kaya nawarin produk pengen di hapus selamanya aja untuk message spam,36,37,isi chatting atau message tidak bisa dihapus hanya diarsipkan dan itu terus saja ada walaupun sudah diarsipkan tolong di perbaiki kembali karena banyak message yang spam juga kayak nawarin produk pengen di hapus selamanya saja untuk message spam,37,38,"['isi', 'chatting', 'atau', 'message', 'tidak', 'bisa', 'dihapus', 'hanya', 'diarsipkan', 'dan', 'itu', 'terus', 'saja', 'ada', 'walaupun', 'sudah', 'diarsipkan', 'tolong', 'di', 'perbaiki', 'kembali', 'karena', 'banyak', 'message', 'yang', 'spam', 'juga', 'kayak', 'nawarin', 'produk', 'pengen', 'di', 'hapus', 'selamanya', 'saja', 'untuk', 'message', 'spam']","['isi', 'chatting', 'message', 'tidak', 'dihapus', 'diarsipkan', 'diarsipkan', 'tolong', 'perbaiki', 'message', 'spam', 'kayak', 'nawarin', 'produk', 'pengen', 'hapus', 'message', 'spam']",38,18,20,isi chatting message tidak hapus arsip arsip tolong baik message spam kayak nawarin produk ken hapus message spam,18,18
"So bad mau masuk lagi verivikasi nya pake gambar 3gp yg udah bener tp dicap salah mulu saya capek, kepala pusing liat nya tetep salah mulu , habis gitu nambah terus kalau salah. Hadeh membuang waktu",negatif,2023-11-08,2023,so bad mau masuk lagi verivikasi nya pake gambar gp yg udah bener tp dicap salah mulu saya capek kepala pusing liat nya tetep salah mulu habis gitu nambah terus kalau salah hadeh membuang waktu,36,35,so bad mau masuk lagi verivikasi nya pakai gambar gp yang sudah benar tapi dicap salah mulu saya capek kepala pusing lihat nya tetap salah mulu habis begitu nambah terus kalau salah hadeh membuang waktu,35,35,"['so', 'bad', 'mau', 'masuk', 'lagi', 'verivikasi', 'nya', 'pakai', 'gambar', 'gp', 'yang', 'sudah', 'benar', 'tapi', 'dicap', 'salah', 'mulu', 'saya', 'capek', 'kepala', 'pusing', 'lihat', 'nya', 'tetap', 'salah', 'mulu', 'habis', 'begitu', 'nambah', 'terus', 'kalau', 'salah', 'hadeh', 'membuang', 'waktu']","['so', 'bad', 'masuk', 'verivikasi', 'nya', 'pakai', 'gambar', 'gp', 'dicap', 'salah', 'mulu', 'capek', 'kepala', 'pusing', 'lihat', 'nya', 'salah', 'mulu', 'habis', 'nambah', 'salah', 'hadeh', 'membuang']",35,23,12,so bad masuk verivikasi nya pakai gambar gp cap salah mulu capek kepala pusing lihat nya salah mulu habis nambah salah hadeh buang,23,23
"Kalau merekomendasikan pekerjaan, tolong yg masih fresh gitu loh. Masa' pekerjaan yg udah berbulan-bulan yg lalu masih aja di notif via email. Maksimal yg sudah 7 hari yg lalu atau bbrpa hari iklan loker yg udah terpasang gitu loh kalau merekomendasikan..",negatif,2023-08-26,2023,kalau merekomendasikan pekerjaan tolong yg masih fresh gitu loh masa pekerjaan yg udah berbulan bulan yg lalu masih aja di notif via email maksimal yg sudah hari yg lalu atau bbrpa hari iklan loker yg udah terpasang gitu loh kalau merekomendasikan,41,41,kalau merekomendasikan pekerjaan tolong yang masih segar begitu loh masa pekerjaan yang sudah berbulan bulan yang lalu masih saja di notif melalui email maksimal yang sudah hari yang lalu atau beberapa hari iklan loker yang sudah terpasang begitu loh kalau merekomendasikan,41,41,"['kalau', 'merekomendasikan', 'pekerjaan', 'tolong', 'yang', 'masih', 'segar', 'begitu', 'loh', 'masa', 'pekerjaan', 'yang', 'sudah', 'berbulan', 'bulan', 'yang', 'lalu', 'masih', 'saja', 'di', 'notif', 'melalui', 'email', 'maksimal', 'yang', 'sudah', 'hari', 'yang', 'lalu', 'atau', 'beberapa', 'hari', 'iklan', 'loker', 'yang', 'sudah', 'terpasang', 'begitu', 'loh', 'kalau', 'merekomendasikan']","['merekomendasikan', 'pekerjaan', 'tolong', 'segar', 'loh', 'pekerjaan', 'berbulan', 'notif', 'email', 'maksimal', 'iklan', 'loker', 'terpasang', 'loh', 'merekomendasikan']",41,15,26,rekomendasi kerja tolong segar loh kerja bulan notif email maksimal iklan loker pasang loh rekomendasi,15,15
"4 bulan lalu akun saya diretas dan diganti emailnya sama orang rusia dan peringatan emailnya agak telat, padahal ga pernah buka"" website yg perlu login ke linkedin apalagi website yg rentan. Gatau dimana celahnya, walaupun berhasil hapus akun supaya ga dipake aneh-aneh, tapi pasti data saya sudah dicuri sama peretasnya bukan? Apa serawan itu keamanan di LinkedIn ini? Sekarang saya mau bikin akun baru pun kode 6 digitnya ga dikirim-kirim ke email gimana bisa lanjut verifikasi kalau gini... ayolah",negatif,2023-09-22,2023,bulan lalu akun saya diretas dan diganti emailnya sama orang rusia dan peringatan emailnya agak telat padahal ga pernah buka website yg perlu login ke linkedin apalagi website yg rentan gatau dimana celahnya walaupun berhasil hapus akun supaya ga dipake aneh aneh tapi pasti data saya sudah dicuri sama peretasnya bukan apa serawan itu keamanan di linkedin ini sekarang saya mau bikin akun baru pun kode digitnya ga dikirim kirim ke email gimana bisa lanjut verifikasi kalau gini ayolah,79,79,bulan lalu akun saya diretas dan diganti emailnya sama orang rusia dan peringatan emailnya agak terlambat padahal tidak pernah buka website yang perlu login ke linkedin apalagi website yang rentan tidak tahu dimana celahnya walaupun berhasil hapus akun supaya tidak di pakai aneh aneh tapi pasti data saya sudah dicuri sama peretasnya bukan apa serawan itu keamanan di linkedin ini sekarang saya mau bikin akun baru pun kode digitnya tidak dikirim kirim ke email bagaimana bisa lanjut verifikasi kalau begini ayolah,79,81,"['bulan', 'lalu', 'akun', 'saya', 'diretas', 'dan', 'diganti', 'emailnya', 'sama', 'orang', 'rusia', 'dan', 'peringatan', 'emailnya', 'agak', 'terlambat', 'padahal', 'tidak', 'pernah', 'buka', 'website', 'yang', 'perlu', 'login', 'ke', 'linkedin', 'apalagi', 'website', 'yang', 'rentan', 'tidak', 'tahu', 'dimana', 'celahnya', 'walaupun', 'berhasil', 'hapus', 'akun', 'supaya', 'tidak', 'di', 'pakai', 'aneh', 'aneh', 'tapi', 'pasti', 'data', 'saya', 'sudah', 'dicuri', 'sama', 'peretasnya', 'bukan', 'apa', 'serawan', 'itu', 'keamanan', 'di', 'linkedin', 'ini', 'sekarang', 'saya', 'mau', 'bikin', 'akun', 'baru', 'pun', 'kode', 'digitnya', 'tidak', 'dikirim', 'kirim', 'ke', 'email', 'bagaimana', 'bisa', 'lanjut', 'verifikasi', 'kalau', 'begini', 'ayolah']","['akun', 'diretas', 'diganti', 'emailnya', 'orang', 'rusia', 'peringatan', 'emailnya', 'terlambat', 'tidak', 'buka', 'website', 'login', 'linkedin', 'website', 'rentan', 'tidak', 'dimana', 'celahnya', 'berhasil', 'hapus', 'akun', 'tidak', 'pakai', 'aneh', 'aneh', 'data', 'dicuri', 'peretasnya', 'serawan', 'keamanan', 'linkedin', 'bikin', 'akun', 'kode', 'digitnya', 'tidak', 'dikirim', 'kirim', 'email', 'verifikasi', 'ayolah']",81,42,39,akun retas ganti email orang rusia ingat email lambat tidak buka website login linkedin website rentan tidak mana celah hasil hapus akun tidak pakai aneh aneh data curi retas rawan aman linkedin bikin akun kode digit tidak kirim kirim email verifikasi ayo,42,42
"Aplikasinya kurang,banyak bug,banyak spam,dan juga tidak menarik dan efektif",negatif,2024-06-10,2024,aplikasinya kurang banyak bug banyak spam dan juga tidak menarik dan efektif,9,12,aplikasi nya kurang banyak bug banyak spam dan juga tidak menarik dan efektif,12,13,"['aplikasi', 'nya', 'kurang', 'banyak', 'bug', 'banyak', 'spam', 'dan', 'juga', 'tidak', 'menarik', 'dan', 'efektif']","['aplikasi', 'nya', 'bug', 'spam', 'tidak', 'menarik', 'efektif']",13,7,6,aplikasi nya bug spam tidak tarik efektif,7,7
Aplikasi ini sangat membantu sekali.untuk mendapatkan referensi dalam karir,positif,2024-05-03,2024,aplikasi ini sangat membantu sekali untuk mendapatkan referensi dalam karir,9,10,aplikasi ini sangat membantu sekali untuk mendapatkan referensi dalam karir,10,10,"['aplikasi', 'ini', 'sangat', 'membantu', 'sekali', 'untuk', 'mendapatkan', 'referensi', 'dalam', 'karir']","['aplikasi', 'membantu', 'referensi', 'karir']",10,4,6,aplikasi bantu referensi karir,4,4
"Ada apa dengan LinkedIn? Udah beberapa hari ini ga bisa akses LinkedIn baik melalui web ataupun app. Berawal dari ga bisa refresh beranda, terus coba loguot malah ga bisa login lagi. Coba install ulang tetep sama aja. Tolong di perbaiki segera",negatif,2020-12-29,2020,ada apa dengan linkedin udah beberapa hari ini ga bisa akses linkedin baik melalui web ataupun app berawal dari ga bisa refresh beranda terus coba loguot malah ga bisa login lagi coba install ulang tetep sama aja tolong di perbaiki segera,41,41,ada apa dengan linkedin sudah beberapa hari ini tidak bisa akses linkedin baik melalui web ataupun aplikasi berawal dari tidak bisa refresh beranda terus coba loguot bahkan tidak bisa login lagi coba install ulang tetap sama saja tolong di perbaikan segera,41,41,"['ada', 'apa', 'dengan', 'linkedin', 'sudah', 'beberapa', 'hari', 'ini', 'tidak', 'bisa', 'akses', 'linkedin', 'baik', 'melalui', 'web', 'ataupun', 'aplikasi', 'berawal', 'dari', 'tidak', 'bisa', 'refresh', 'beranda', 'terus', 'coba', 'loguot', 'bahkan', 'tidak', 'bisa', 'login', 'lagi', 'coba', 'install', 'ulang', 'tetap', 'sama', 'saja', 'tolong', 'di', 'perbaikan', 'segera']","['linkedin', 'tidak', 'akses', 'linkedin', 'web', 'aplikasi', 'tidak', 'refresh', 'beranda', 'coba', 'loguot', 'tidak', 'login', 'coba', 'install', 'ulang', 'tolong', 'perbaikan']",41,18,23,linkedin tidak akses linkedin web aplikasi tidak refresh beranda coba loguot tidak login coba install ulang tolong baik,18,18
Entah kenapa koneksi saya tidak bertambah padah sudah diterima oleh orang lain. Koneksi tetap stuck gak bertambah tolong diberbaiki ya,negatif,2024-06-06,2024,entah kenapa koneksi saya tidak bertambah padah sudah diterima oleh orang lain koneksi tetap stuck gak bertambah tolong diberbaiki ya,20,20,entah kenapa koneksi saya tidak bertambah padah sudah diterima oleh orang lain koneksi tetap stuck tidak bertambah tolong diberbaiki ya,20,20,"['entah', 'kenapa', 'koneksi', 'saya', 'tidak', 'bertambah', 'padah', 'sudah', 'diterima', 'oleh', 'orang', 'lain', 'koneksi', 'tetap', 'stuck', 'tidak', 'bertambah', 'tolong', 'diberbaiki', 'ya']","['koneksi', 'tidak', 'bertambah', 'padah', 'diterima', 'orang', 'koneksi', 'stuck', 'tidak', 'bertambah', 'tolong', 'diberbaiki', 'ya']",20,13,7,koneksi tidak tambah padah terima orang koneksi stuck tidak tambah tolong baik ya,13,13
Haloooo para PEGAWAI Linkedin YTH... Kok.. Main blokir akun se enaknya saja?? tanpa ada info!? HAPUS DATA² saya dari LINKEDIN !!!! Saya sudah tidak butuh aplikasi anda lagi. !!!! 😠😠😠😠 tidak ada kesalahan apa-apa kok tiba-tiba akun di Non Aktifkan sepihak tanpa ada informasi di awal. Dimana letak PROFESIONALISME kalian??? Padahal saya tidak pernah memposting postingan yang berisi konten Hoaks ataupun penipuan ataupun sejenis lainnya.,negatif,2021-10-29,2021,haloooo para pegawai linkedin yth kok main blokir akun se enaknya saja tanpa ada info hapus data² saya dari linkedin saya sudah tidak butuh aplikasi anda lagi tidak ada kesalahan apa apa kok tiba tiba akun di non aktifkan sepihak tanpa ada informasi di awal dimana letak profesionalisme kalian padahal saya tidak pernah memposting postingan yang berisi konten hoaks ataupun penipuan ataupun sejenis lainnya,65,64,haloooo para pegawai linkedin yang terhormat kok main blokir akun se enaknya saja tanpa ada informasi hapus data² saya dari linkedin saya sudah tidak butuh aplikasi anda lagi tidak ada kesalahan apa apa kok tiba tiba akun di non aktifkan sepihak tanpa ada informasi di awal dimana letak profesionalisme kalian padahal saya tidak pernah memposting postingan yang berisi konten hoaks ataupun penipuan ataupun sejenis lainnya,64,65,"['haloooo', 'para', 'pegawai', 'linkedin', 'yang', 'terhormat', 'kok', 'main', 'blokir', 'akun', 'se', 'enaknya', 'saja', 'tanpa', 'ada', 'informasi', 'hapus', 'data²', 'saya', 'dari', 'linkedin', 'saya', 'sudah', 'tidak', 'butuh', 'aplikasi', 'anda', 'lagi', 'tidak', 'ada', 'kesalahan', 'apa', 'apa', 'kok', 'tiba', 'tiba', 'akun', 'di', 'non', 'aktifkan', 'sepihak', 'tanpa', 'ada', 'informasi', 'di', 'awal', 'dimana', 'letak', 'profesionalisme', 'kalian', 'padahal', 'saya', 'tidak', 'pernah', 'memposting', 'postingan', 'yang', 'berisi', 'konten', 'hoaks', 'ataupun', 'penipuan', 'ataupun', 'sejenis', 'lainnya']","['haloooo', 'pegawai', 'linkedin', 'terhormat', 'main', 'blokir', 'akun', 'enaknya', 'informasi', 'hapus', 'data²', 'linkedin', 'tidak', 'butuh', 'aplikasi', 'tidak', 'kesalahan', 'akun', 'non', 'aktifkan', 'informasi', 'dimana', 'letak', 'profesionalisme', 'tidak', 'memposting', 'postingan', 'berisi', 'konten', 'hoaks', 'penipuan', 'sejenis']",65,32,33,haloooo pegawai linkedin hormat main blokir akun enak informasi hapus data linkedin tidak butuh aplikasi tidak salah akun non aktif informasi mana letak profesionalisme tidak memposting postingan isi konten hoaks tipu jenis,32,32
"Sulit banget loginnya min , kayak Facebook saja mudah loginnya sdh aman, pakai verifikasi manusia pula dan gambar yang seharusnya menghadap keatas sudah bnr malah salah",negatif,2024-06-12,2024,sulit banget loginnya min kayak facebook saja mudah loginnya sdh aman pakai verifikasi manusia pula dan gambar yang seharusnya menghadap keatas sudah bnr malah salah,26,25,sulit banget loginnya minimal kayak facebook saja mudah loginnya sudah aman pakai verifikasi manusia pula dan gambar yang seharusnya menghadap keatas sudah benar bahkan salah,25,25,"['sulit', 'banget', 'loginnya', 'minimal', 'kayak', 'facebook', 'saja', 'mudah', 'loginnya', 'sudah', 'aman', 'pakai', 'verifikasi', 'manusia', 'pula', 'dan', 'gambar', 'yang', 'seharusnya', 'menghadap', 'keatas', 'sudah', 'benar', 'bahkan', 'salah']","['sulit', 'banget', 'loginnya', 'minimal', 'kayak', 'facebook', 'mudah', 'loginnya', 'aman', 'pakai', 'verifikasi', 'manusia', 'gambar', 'menghadap', 'keatas', 'salah']",25,16,9,sulit banget loginnya minimal kayak facebook mudah loginnya aman pakai verifikasi manusia gambar hadap atas salah,16,16
"Saya pernah lupa password sy ganti sesuai dgn password yg ideal sy pakai pada sebagian besar akun2 lain agar tidak lupa. Herannya karna pernah menggunakan password tsb, diminta bikin pass baru. Alhasil pass yg baru terpaksa perlu diingat (lupa karna banyak kerjaan), sudah sebanyak 5x aku gagal login ke LinkedIn akibat dari ulahnya minta bikin password yg blom pernah pakai. Ganggui kerjaan orang saja memang, Time Waster.",negatif,2023-01-22,2023,saya pernah lupa password sy ganti sesuai dgn password yg ideal sy pakai pada sebagian besar akun lain agar tidak lupa herannya karna pernah menggunakan password tsb diminta bikin pass baru alhasil pass yg baru terpaksa perlu diingat lupa karna banyak kerjaan sudah sebanyak x aku gagal login ke linkedin akibat dari ulahnya minta bikin password yg blom pernah pakai ganggui kerjaan orang saja memang time waster,67,67,saya pernah lupa password saya ganti sesuai dengan password yang ideal saya pakai pada sebagian besar akun lain agar tidak lupa herannya karena pernah menggunakan password tersebut diminta bikin pass baru alhasil pass yang baru terpaksa perlu diingat lupa karena banyak kerjaan sudah sebanyak x aku gagal login ke linkedin akibat dari ulahnya minta bikin password yang belum pernah pakai ganggui kerjaan orang saja memang time waster,67,67,"['saya', 'pernah', 'lupa', 'password', 'saya', 'ganti', 'sesuai', 'dengan', 'password', 'yang', 'ideal', 'saya', 'pakai', 'pada', 'sebagian', 'besar', 'akun', 'lain', 'agar', 'tidak', 'lupa', 'herannya', 'karena', 'pernah', 'menggunakan', 'password', 'tersebut', 'diminta', 'bikin', 'pass', 'baru', 'alhasil', 'pass', 'yang', 'baru', 'terpaksa', 'perlu', 'diingat', 'lupa', 'karena', 'banyak', 'kerjaan', 'sudah', 'sebanyak', 'x', 'aku', 'gagal', 'login', 'ke', 'linkedin', 'akibat', 'dari', 'ulahnya', 'minta', 'bikin', 'password', 'yang', 'belum', 'pernah', 'pakai', 'ganggui', 'kerjaan', 'orang', 'saja', 'memang', 'time', 'waster']","['lupa', 'password', 'ganti', 'sesuai', 'password', 'ideal', 'pakai', 'akun', 'tidak', 'lupa', 'herannya', 'password', 'bikin', 'pass', 'alhasil', 'pass', 'terpaksa', 'lupa', 'kerjaan', 'x', 'gagal', 'login', 'linkedin', 'akibat', 'ulahnya', 'bikin', 'password', 'pakai', 'ganggui', 'kerjaan', 'orang', 'time', 'waster']",67,33,34,lupa password ganti sesuai password ideal pakai akun tidak lupa heran password bikin pass alhasil pass paksa lupa kerja x gagal login linkedin akibat ulah bikin password pakai ganggu kerja orang time waster,33,33
"Reset kata sandi di aplikasi ini susah bet ,malah di mintain Password lama ,ya jelas jelas saya ingin ganti kata sandi yang lama jadi yang baru",negatif,2024-05-07,2024,reset kata sandi di aplikasi ini susah bet malah di mintain password lama ya jelas jelas saya ingin ganti kata sandi yang lama jadi yang baru,26,26,reset kata sandi di aplikasi ini susah banget bahkan di mintain password lama ya jelas jelas saya ingin ganti kata sandi yang lama jadi yang baru,26,26,"['reset', 'kata', 'sandi', 'di', 'aplikasi', 'ini', 'susah', 'banget', 'bahkan', 'di', 'mintain', 'password', 'lama', 'ya', 'jelas', 'jelas', 'saya', 'ingin', 'ganti', 'kata', 'sandi', 'yang', 'lama', 'jadi', 'yang', 'baru']","['reset', 'sandi', 'aplikasi', 'susah', 'banget', 'mintain', 'password', 'ya', 'ganti', 'sandi']",26,10,16,reset sandi aplikasi susah banget mintain password ya ganti sandi,10,10
Aplikasi sangat baik untuk para pencari kerja dan para pebisnis.,positif,2024-03-24,2024,aplikasi sangat baik untuk para pencari kerja dan para pebisnis,10,10,aplikasi sangat baik untuk para pencari kerja dan para pebisnis,10,10,"['aplikasi', 'sangat', 'baik', 'untuk', 'para', 'pencari', 'kerja', 'dan', 'para', 'pebisnis']","['aplikasi', 'pencari', 'kerja', 'pebisnis']",10,4,6,aplikasi cari kerja bisnis,4,4
"Aplikasi Baj*ngan😌 bikin verivikasi human aja ribet banget.. suruh milih gambar hewan ngadep keatas, udah dipilih yg ngadep keatas masih aja salah. dicoba puluhan kali masih salah juga🖕 bikin Recaptcha yg bener...",negatif,2022-01-06,2022,aplikasi baj ngan bikin verivikasi human aja ribet banget suruh milih gambar hewan ngadep keatas udah dipilih yg ngadep keatas masih aja salah dicoba puluhan kali masih salah juga bikin recaptcha yg bener,32,33,aplikasi baj ngan bikin verivikasi human saja rumit banget suruh memilih gambar hewan ngadep keatas sudah dipilih yang ngadep keatas masih saja salah dicoba puluhan kali masih salah juga bikin recaptcha yang benar,33,33,"['aplikasi', 'baj', 'ngan', 'bikin', 'verivikasi', 'human', 'saja', 'rumit', 'banget', 'suruh', 'memilih', 'gambar', 'hewan', 'ngadep', 'keatas', 'sudah', 'dipilih', 'yang', 'ngadep', 'keatas', 'masih', 'saja', 'salah', 'dicoba', 'puluhan', 'kali', 'masih', 'salah', 'juga', 'bikin', 'recaptcha', 'yang', 'benar']","['aplikasi', 'baj', 'ngan', 'bikin', 'verivikasi', 'human', 'rumit', 'banget', 'suruh', 'memilih', 'gambar', 'hewan', 'ngadep', 'keatas', 'dipilih', 'ngadep', 'keatas', 'salah', 'dicoba', 'puluhan', 'kali', 'salah', 'bikin', 'recaptcha']",33,24,9,aplikasi baj ngan bikin verivikasi human rumit banget suruh pilih gambar hewan ngadep atas pilih ngadep atas salah coba puluh kali salah bikin recaptcha,24,24
"Luar biasa! Saya mendapatkan rekan Seniman lukis dari luar negara dan kami bisa saling berbagi kultur, tradisi, dan budaya masing² selain tentu berbagi info seputar Seni Rupa.",positif,2022-11-08,2022,luar biasa saya mendapatkan rekan seniman lukis dari luar negara dan kami bisa saling berbagi kultur tradisi dan budaya masing² selain tentu berbagi info seputar seni rupa,27,27,luar biasa saya mendapatkan rekan seniman lukis dari luar negara dan kami bisa saling berbagi kultur tradisi dan budaya masing² selain tentu berbagi informasi seputar seni rupa,27,27,"['luar', 'biasa', 'saya', 'mendapatkan', 'rekan', 'seniman', 'lukis', 'dari', 'luar', 'negara', 'dan', 'kami', 'bisa', 'saling', 'berbagi', 'kultur', 'tradisi', 'dan', 'budaya', 'masing²', 'selain', 'tentu', 'berbagi', 'informasi', 'seputar', 'seni', 'rupa']","['rekan', 'seniman', 'lukis', 'negara', 'berbagi', 'kultur', 'tradisi', 'budaya', 'masing²', 'berbagi', 'informasi', 'seputar', 'seni', 'rupa']",27,14,13,rekan seniman lukis negara bagi kultur tradisi budaya masing bagi informasi putar seni rupa,14,14
Pemeriksaan keamanan ribet sampe putar² hp gblk,negatif,2024-08-21,2024,pemeriksaan keamanan ribet sampe putar² hp gblk,7,7,pemeriksaan keamanan rumit sampai putar² handphone gblk,7,7,"['pemeriksaan', 'keamanan', 'rumit', 'sampai', 'putar²', 'handphone', 'gblk']","['pemeriksaan', 'keamanan', 'rumit', 'putar²', 'handphone', 'gblk']",7,6,1,periksa aman rumit putar handphone gblk,6,6
"Lamannya lambat postingan baru malah gk keliatan, postingan lama stay di awal, jadi harus scroll bawah baru bisa liat postingan baru, itupun acak",negatif,2024-06-12,2024,lamannya lambat postingan baru malah gk keliatan postingan lama stay di awal jadi harus scroll bawah baru bisa liat postingan baru itupun acak,23,23,lamannya lambat postingan baru bahkan tidak kelihatan postingan lama stay di awal jadi harus scroll bawah baru bisa lihat postingan baru itupun acak,23,23,"['lamannya', 'lambat', 'postingan', 'baru', 'bahkan', 'tidak', 'kelihatan', 'postingan', 'lama', 'stay', 'di', 'awal', 'jadi', 'harus', 'scroll', 'bawah', 'baru', 'bisa', 'lihat', 'postingan', 'baru', 'itupun', 'acak']","['lamannya', 'lambat', 'postingan', 'tidak', 'postingan', 'stay', 'scroll', 'lihat', 'postingan', 'itupun', 'acak']",23,11,12,laman lambat postingan tidak postingan stay scroll lihat postingan itu acak,11,11
"Tolong dengan sangat kepada developer linkedin,sebelumnya linkedin saya masih bisa saya gunakan setelah beberapa bulan tidak saya buka tiba tiba minta login ulang nah karena saya input password katanya salah kemudian saya saya minta untuk repassword yg baru setelah da say buat yg baru pihak dri linkedin minta verifikasi identitas dan katanya sudah bsa tinggal nunggu balasan dan tiba saya cek email katanya sudah berhasil. Tapi saya login ulang dri linkedin gabisa juga dan selalu berulang",negatif,2020-09-01,2020,tolong dengan sangat kepada developer linkedin sebelumnya linkedin saya masih bisa saya gunakan setelah beberapa bulan tidak saya buka tiba tiba minta login ulang nah karena saya input password katanya salah kemudian saya saya minta untuk repassword yg baru setelah da say buat yg baru pihak dri linkedin minta verifikasi identitas dan katanya sudah bsa tinggal nunggu balasan dan tiba saya cek email katanya sudah berhasil tapi saya login ulang dri linkedin gabisa juga dan selalu berulang,76,77,tolong dengan sangat kepada developer linkedin sebelumnya linkedin saya masih bisa saya gunakan setelah beberapa bulan tidak saya buka tiba tiba minta login ulang nah karena saya input password katanya salah kemudian saya saya minta untuk repassword yang baru setelah ada say buat yang baru pihak dari linkedin minta verifikasi identitas dan katanya sudah bisa tinggal tunggu balasan dan tiba saya cek email katanya sudah berhasil tapi saya login ulang dari linkedin tidak bisa juga dan selalu berulang,77,78,"['tolong', 'dengan', 'sangat', 'kepada', 'developer', 'linkedin', 'sebelumnya', 'linkedin', 'saya', 'masih', 'bisa', 'saya', 'gunakan', 'setelah', 'beberapa', 'bulan', 'tidak', 'saya', 'buka', 'tiba', 'tiba', 'minta', 'login', 'ulang', 'nah', 'karena', 'saya', 'input', 'password', 'katanya', 'salah', 'kemudian', 'saya', 'saya', 'minta', 'untuk', 'repassword', 'yang', 'baru', 'setelah', 'ada', 'say', 'buat', 'yang', 'baru', 'pihak', 'dari', 'linkedin', 'minta', 'verifikasi', 'identitas', 'dan', 'katanya', 'sudah', 'bisa', 'tinggal', 'tunggu', 'balasan', 'dan', 'tiba', 'saya', 'cek', 'email', 'katanya', 'sudah', 'berhasil', 'tapi', 'saya', 'login', 'ulang', 'dari', 'linkedin', 'tidak', 'bisa', 'juga', 'dan', 'selalu', 'berulang']","['tolong', 'developer', 'linkedin', 'linkedin', 'tidak', 'buka', 'login', 'ulang', 'input', 'password', 'salah', 'repassword', 'say', 'linkedin', 'verifikasi', 'identitas', 'tinggal', 'tunggu', 'balasan', 'cek', 'email', 'berhasil', 'login', 'ulang', 'linkedin', 'tidak', 'berulang']",78,27,51,tolong developer linkedin linkedin tidak buka login ulang input password salah repassword say linkedin verifikasi identitas tinggal tunggu balas cek email hasil login ulang linkedin tidak ulang,27,27
Aplikasi kocak.. Mau daftar di suruh verifikasi objek ngadep ke atas. yang pertama sampe tiga bener pas yang ke empat tiba tiba salah. Gitu aja terus ngulang ngulang Mending lu tutup aja aplikasi sampah ga guna. orang mau nyari kerja bukannya di permudah malah di persulit tolol,negatif,2023-10-07,2023,aplikasi kocak mau daftar di suruh verifikasi objek ngadep ke atas yang pertama sampe tiga bener pas yang ke empat tiba tiba salah gitu aja terus ngulang ngulang mending lu tutup aja aplikasi sampah ga guna orang mau nyari kerja bukannya di permudah malah di persulit tolol,47,47,aplikasi kocak mau daftar di suruh verifikasi objek ngadep ke atas yang pertama sampai tiga benar pas yang ke empat tiba tiba salah begitu saja terus mengulang mengulang mending lu tutup saja aplikasi sampah tidak guna orang mau mencari kerja bukannya di permudah bahkan di persulit tolol,47,47,"['aplikasi', 'kocak', 'mau', 'daftar', 'di', 'suruh', 'verifikasi', 'objek', 'ngadep', 'ke', 'atas', 'yang', 'pertama', 'sampai', 'tiga', 'benar', 'pas', 'yang', 'ke', 'empat', 'tiba', 'tiba', 'salah', 'begitu', 'saja', 'terus', 'mengulang', 'mengulang', 'mending', 'lu', 'tutup', 'saja', 'aplikasi', 'sampah', 'tidak', 'guna', 'orang', 'mau', 'mencari', 'kerja', 'bukannya', 'di', 'permudah', 'bahkan', 'di', 'persulit', 'tolol']","['aplikasi', 'kocak', 'daftar', 'suruh', 'verifikasi', 'objek', 'ngadep', 'pas', 'salah', 'mengulang', 'mengulang', 'mending', 'lu', 'tutup', 'aplikasi', 'sampah', 'tidak', 'orang', 'mencari', 'kerja', 'permudah', 'persulit', 'tolol']",47,23,24,aplikasi kocak daftar suruh verifikasi objek ngadep pas salah ulang ulang mending lu tutup aplikasi sampah tidak orang cari kerja mudah sulit tolol,23,23
Ini aplikasi ga penting cuma malah gede gengsi doankk dan ga bantu aku atau siapapun di sekitar aku yang sulit.. Anyway budaya riset app ini ga penting buat kebutuhan cari kerja huhhhh ngapain pake tanya skill enakkan ngeblog dari pada buang buang waktu dengan pembayaran kridit yang ga fleksibel sama kebutuhan lokal,negatif,2021-02-26,2021,ini aplikasi ga penting cuma malah gede gengsi doankk dan ga bantu aku atau siapapun di sekitar aku yang sulit anyway budaya riset app ini ga penting buat kebutuhan cari kerja huhhhh ngapain pake tanya skill enakkan ngeblog dari pada buang buang waktu dengan pembayaran kridit yang ga fleksibel sama kebutuhan lokal,52,52,ini aplikasi tidak penting cuma bahkan gede gengsi doankk dan tidak bantu aku atau siapapun di sekitar aku yang sulit anyway budaya riset aplikasi ini tidak penting buat kebutuhan cari kerja huhhhh buat apa pakai tanya skill enakkan ngeblog dari pada buang buang waktu dengan pembayaran kridit yang tidak fleksibel sama kebutuhan lokal,52,53,"['ini', 'aplikasi', 'tidak', 'penting', 'cuma', 'bahkan', 'gede', 'gengsi', 'doankk', 'dan', 'tidak', 'bantu', 'aku', 'atau', 'siapapun', 'di', 'sekitar', 'aku', 'yang', 'sulit', 'anyway', 'budaya', 'riset', 'aplikasi', 'ini', 'tidak', 'penting', 'buat', 'kebutuhan', 'cari', 'kerja', 'huhhhh', 'buat', 'apa', 'pakai', 'tanya', 'skill', 'enakkan', 'ngeblog', 'dari', 'pada', 'buang', 'buang', 'waktu', 'dengan', 'pembayaran', 'kridit', 'yang', 'tidak', 'fleksibel', 'sama', 'kebutuhan', 'lokal']","['aplikasi', 'tidak', 'gede', 'gengsi', 'doankk', 'tidak', 'bantu', 'sulit', 'anyway', 'budaya', 'riset', 'aplikasi', 'tidak', 'kebutuhan', 'cari', 'kerja', 'huhhhh', 'pakai', 'skill', 'enakkan', 'ngeblog', 'buang', 'buang', 'pembayaran', 'kridit', 'tidak', 'fleksibel', 'kebutuhan', 'lokal']",53,29,24,aplikasi tidak gede gengsi doankk tidak bantu sulit anyway budaya riset aplikasi tidak butuh cari kerja huhhhh pakai skill enak ngeblog buang buang bayar kridit tidak fleksibel butuh lokal,29,29
Pengaduan kemana ya tiba tiba akun LinkedIn saya hilang... Tiba2 masukin Gmail malah kek baru gtu... Ini gmna ya? Ga hancur gini aplikasi Ini aplikasi baru update 1 April tpi kenapa akun saya hilang?,negatif,2024-04-17,2024,pengaduan kemana ya tiba tiba akun linkedin saya hilang tiba masukin gmail malah kek baru gtu ini gmna ya ga hancur gini aplikasi ini aplikasi baru update april tpi kenapa akun saya hilang,34,33,pengaduan kemana ya tiba tiba akun linkedin saya hilang tiba masukkan gmail bahkan seperti baru begitu ini bagaimana ya tidak hancur begini aplikasi ini aplikasi baru diperbarui april tetapi kenapa akun saya hilang,33,33,"['pengaduan', 'kemana', 'ya', 'tiba', 'tiba', 'akun', 'linkedin', 'saya', 'hilang', 'tiba', 'masukkan', 'gmail', 'bahkan', 'seperti', 'baru', 'begitu', 'ini', 'bagaimana', 'ya', 'tidak', 'hancur', 'begini', 'aplikasi', 'ini', 'aplikasi', 'baru', 'diperbarui', 'april', 'tetapi', 'kenapa', 'akun', 'saya', 'hilang']","['pengaduan', 'kemana', 'ya', 'akun', 'linkedin', 'hilang', 'masukkan', 'gmail', 'ya', 'tidak', 'hancur', 'aplikasi', 'aplikasi', 'diperbarui', 'april', 'akun', 'hilang']",33,17,16,adu mana ya akun linkedin hilang masuk gmail ya tidak hancur aplikasi aplikasi baru april akun hilang,17,17
"Tolong sudah 2 hari ini saya tidak bisa mengakses linkedin, baik itu lewat website laptop ataupun Aplikasi di Playstore(Handphone) saya sudah check internet saya okey, aplikasi juga sudah diberpaharui, tapi tetap saat dibuka ""silahkan dicoba lagi, terjadi kendala pada jaringan""",negatif,2022-02-15,2022,tolong sudah hari ini saya tidak bisa mengakses linkedin baik itu lewat website laptop ataupun aplikasi di playstore handphone saya sudah check internet saya okey aplikasi juga sudah diberpaharui tapi tetap saat dibuka silahkan dicoba lagi terjadi kendala pada jaringan,40,40,tolong sudah hari ini saya tidak bisa mengakses linkedin baik itu lewat website laptop ataupun aplikasi di playstore handphone saya sudah cek internet saya oke aplikasi juga sudah diberpaharui tapi tetap saat dibuka silahkan dicoba lagi terjadi kendala pada jaringan,40,40,"['tolong', 'sudah', 'hari', 'ini', 'saya', 'tidak', 'bisa', 'mengakses', 'linkedin', 'baik', 'itu', 'lewat', 'website', 'laptop', 'ataupun', 'aplikasi', 'di', 'playstore', 'handphone', 'saya', 'sudah', 'cek', 'internet', 'saya', 'oke', 'aplikasi', 'juga', 'sudah', 'diberpaharui', 'tapi', 'tetap', 'saat', 'dibuka', 'silahkan', 'dicoba', 'lagi', 'terjadi', 'kendala', 'pada', 'jaringan']","['tolong', 'tidak', 'mengakses', 'linkedin', 'website', 'laptop', 'aplikasi', 'playstore', 'handphone', 'cek', 'internet', 'oke', 'aplikasi', 'diberpaharui', 'dibuka', 'silahkan', 'dicoba', 'kendala', 'jaringan']",40,19,21,tolong tidak akses linkedin website laptop aplikasi playstore handphone cek internet oke aplikasi diberpaharui buka silah coba kendala jaring,19,19
"aku di suruh bikin akun LinkedIn tapi di paksa harus punya KTP baru bisa login. tapi aku masih SMK, masa nunggu 2 tahun lagi biar bisa buat akun. please LinkedIn buat biar gak ada verifikasi id kalo umurnya belum 17+",negatif,2024-06-05,2024,aku di suruh bikin akun linkedin tapi di paksa harus punya ktp baru bisa login tapi aku masih smk masa nunggu tahun lagi biar bisa buat akun please linkedin buat biar gak ada verifikasi id kalo umurnya belum,40,38,aku di suruh bikin akun linkedin tapi di paksa harus punya ktp baru bisa login tapi aku masih smk masa tunggu tahun lagi biar bisa buat akun please linkedin buat biar tidak ada verifikasi id kalau umurnya belum,38,38,"['aku', 'di', 'suruh', 'bikin', 'akun', 'linkedin', 'tapi', 'di', 'paksa', 'harus', 'punya', 'ktp', 'baru', 'bisa', 'login', 'tapi', 'aku', 'masih', 'smk', 'masa', 'tunggu', 'tahun', 'lagi', 'biar', 'bisa', 'buat', 'akun', 'please', 'linkedin', 'buat', 'biar', 'tidak', 'ada', 'verifikasi', 'id', 'kalau', 'umurnya', 'belum']","['suruh', 'bikin', 'akun', 'linkedin', 'paksa', 'ktp', 'login', 'smk', 'tunggu', 'biar', 'akun', 'please', 'linkedin', 'biar', 'tidak', 'verifikasi', 'id', 'umurnya']",38,18,20,suruh bikin akun linkedin paksa ktp login smk tunggu biar akun please linkedin biar tidak verifikasi id umur,18,18
"Memperluas relasi, membuka pintu rezeki, mempermudah hubungan antara pelamar dan pencari pekerja.",positif,2024-05-27,2024,memperluas relasi membuka pintu rezeki mempermudah hubungan antara pelamar dan pencari pekerja,12,12,memperluas relasi membuka pintu rezeki mempermudah hubungan antara pelamar dan pencari yang kerja,12,13,"['memperluas', 'relasi', 'membuka', 'pintu', 'rezeki', 'mempermudah', 'hubungan', 'antara', 'pelamar', 'dan', 'pencari', 'yang', 'kerja']","['memperluas', 'relasi', 'membuka', 'pintu', 'rezeki', 'mempermudah', 'hubungan', 'pelamar', 'pencari', 'kerja']",13,10,3,luas relasi buka pintu rezeki mudah hubung lamar cari kerja,10,10
Udah ceklis dah bener jawaban teka teki nya tapi malah disuruh verifikasi lg trus2an.. knapa sih mesti ribet gitu pilih2 gambar hewan ngadep ke atas??? Jelekkkk bngeeettttt apk ini.. mesti gimna coba buat bikin akun di linkedin nya???,negatif,2022-06-09,2022,udah ceklis dah bener jawaban teka teki nya tapi malah disuruh verifikasi lg trus an knapa sih mesti ribet gitu pilih gambar hewan ngadep ke atas jelekkkk bngeeettttt apk ini mesti gimna coba buat bikin akun di linkedin nya,38,39,sudah centang sudah benar jawaban teka teki nya tapi bahkan disuruh verifikasi lagi terus an kenapa sih mesti rumit begitu pilih gambar hewan ngadep ke atas jelekkkk bngeeettttt aplikasi ini mesti bagaimana coba buat bikin akun di linkedin nya,39,39,"['sudah', 'centang', 'sudah', 'benar', 'jawaban', 'teka', 'teki', 'nya', 'tapi', 'bahkan', 'disuruh', 'verifikasi', 'lagi', 'terus', 'an', 'kenapa', 'sih', 'mesti', 'rumit', 'begitu', 'pilih', 'gambar', 'hewan', 'ngadep', 'ke', 'atas', 'jelekkkk', 'bngeeettttt', 'aplikasi', 'ini', 'mesti', 'bagaimana', 'coba', 'buat', 'bikin', 'akun', 'di', 'linkedin', 'nya']","['centang', 'teka', 'teki', 'nya', 'disuruh', 'verifikasi', 'an', 'sih', 'mesti', 'rumit', 'pilih', 'gambar', 'hewan', 'ngadep', 'jelekkkk', 'bngeeettttt', 'aplikasi', 'mesti', 'coba', 'bikin', 'akun', 'linkedin', 'nya']",39,23,16,centang teka teki nya suruh verifikasi an sih mesti rumit pilih gambar hewan ngadep jelekkkk bngeeettttt aplikasi mesti coba bikin akun linkedin nya,23,23
Sangat disayangkan nda ada fitur akun linkedIn premium gratis seumur hidup. Padahal dengan fitur tersebut bisa membantu kita² untuk mendapatkan pekerjaan lebih cepat.,negatif,2023-07-13,2023,sangat disayangkan nda ada fitur akun linkedin premium gratis seumur hidup padahal dengan fitur tersebut bisa membantu kita² untuk mendapatkan pekerjaan lebih cepat,23,23,sangat disayangkan tidak ada fitur akun linkedin premium gratis seumur hidup padahal dengan fitur tersebut bisa membantu kita² untuk mendapatkan pekerjaan lebih cepat,23,23,"['sangat', 'disayangkan', 'tidak', 'ada', 'fitur', 'akun', 'linkedin', 'premium', 'gratis', 'seumur', 'hidup', 'padahal', 'dengan', 'fitur', 'tersebut', 'bisa', 'membantu', 'kita²', 'untuk', 'mendapatkan', 'pekerjaan', 'lebih', 'cepat']","['disayangkan', 'tidak', 'fitur', 'akun', 'linkedin', 'premium', 'gratis', 'seumur', 'hidup', 'fitur', 'membantu', 'kita²', 'pekerjaan', 'cepat']",23,14,9,sayang tidak fitur akun linkedin premium gratis umur hidup fitur bantu kita kerja cepat,14,14
Tidak pernah bisa mendapatkan kode verifikasi melalui SMS👎,negatif,2024-08-28,2024,tidak pernah bisa mendapatkan kode verifikasi melalui sms,8,8,tidak pernah bisa mendapatkan kode verifikasi melalui sms,8,8,"['tidak', 'pernah', 'bisa', 'mendapatkan', 'kode', 'verifikasi', 'melalui', 'sms']","['tidak', 'kode', 'verifikasi', 'sms']",8,4,4,tidak kode verifikasi sms,4,4
"Apikasi ga jelass, bikin ribet",negatif,2024-08-22,2024,apikasi ga jelass bikin ribet,5,5,apikasi tidak jelass bikin rumit,5,5,"['apikasi', 'tidak', 'jelass', 'bikin', 'rumit']","['apikasi', 'tidak', 'jelass', 'bikin', 'rumit']",5,5,0,apikasi tidak jelass bikin rumit,5,5
Gak ada guna nyari kerja lewat aplikasi. Dari sekian ratus lamaran dalam waktu berbulan bulan pun gak ada satupun keterangan lebih lanjut. Padahal dokumen yg dilampirkan sudah yang sebaik baiknya.,negatif,2022-02-20,2022,gak ada guna nyari kerja lewat aplikasi dari sekian ratus lamaran dalam waktu berbulan bulan pun gak ada satupun keterangan lebih lanjut padahal dokumen yg dilampirkan sudah yang sebaik baiknya,30,30,tidak ada guna mencari kerja lewat aplikasi dari sekian ratus lamaran dalam waktu berbulan bulan pun tidak ada satupun keterangan lebih lanjut padahal dokumen yang dilampirkan sudah yang sebaik baiknya,30,30,"['tidak', 'ada', 'guna', 'mencari', 'kerja', 'lewat', 'aplikasi', 'dari', 'sekian', 'ratus', 'lamaran', 'dalam', 'waktu', 'berbulan', 'bulan', 'pun', 'tidak', 'ada', 'satupun', 'keterangan', 'lebih', 'lanjut', 'padahal', 'dokumen', 'yang', 'dilampirkan', 'sudah', 'yang', 'sebaik', 'baiknya']","['tidak', 'mencari', 'kerja', 'aplikasi', 'sekian', 'ratus', 'lamaran', 'berbulan', 'tidak', 'satupun', 'keterangan', 'dokumen', 'dilampirkan', 'baiknya']",30,14,16,tidak cari kerja aplikasi sekian ratus lamar bulan tidak satu terang dokumen lampir baik,14,14
"App setres pw udh benar email udh benar ttep aj sruh verifikasi gj bngst mempersulit kerja orang aj ,smpe hrus msukin id pasport dkk ,app g ad bintang y gni tolong d benerin biar mempersulit penggunaan",negatif,2024-05-14,2024,app setres pw udh benar email udh benar ttep aj sruh verifikasi gj bngst mempersulit kerja orang aj smpe hrus msukin id pasport dkk app g ad bintang y gni tolong d benerin biar mempersulit penggunaan,36,36,aplikasi setres pw sudah benar email sudah benar ttep saja sruh verifikasi gj bngst mempersulit kerja orang saja sampai harus msukin id pasport dkk aplikasi tidak ada bintang ya begini tolong di benerin biar mempersulit penggunaan,36,36,"['aplikasi', 'setres', 'pw', 'sudah', 'benar', 'email', 'sudah', 'benar', 'ttep', 'saja', 'sruh', 'verifikasi', 'gj', 'bngst', 'mempersulit', 'kerja', 'orang', 'saja', 'sampai', 'harus', 'msukin', 'id', 'pasport', 'dkk', 'aplikasi', 'tidak', 'ada', 'bintang', 'ya', 'begini', 'tolong', 'di', 'benerin', 'biar', 'mempersulit', 'penggunaan']","['aplikasi', 'setres', 'pw', 'email', 'ttep', 'sruh', 'verifikasi', 'gj', 'bngst', 'mempersulit', 'kerja', 'orang', 'msukin', 'id', 'pasport', 'dkk', 'aplikasi', 'tidak', 'bintang', 'ya', 'tolong', 'benerin', 'biar', 'mempersulit', 'penggunaan']",36,25,11,aplikasi tres pw email ttep sruh verifikasi gj bngst sulit kerja orang msukin id pasport dkk aplikasi tidak bintang ya tolong benerin biar sulit guna,25,25
"Kenapa Linkedin sekarang sistemnya jadi bobrok begini. Masa 2 akun saya ga ada apa apa tiba-tiba dibatasi dan semuanya g bisa login. Tolonglah diperbaiki, platform profesional masa kaya gini sistemnya. Jadi rugi juga sebagai user.",negatif,2023-09-08,2023,kenapa linkedin sekarang sistemnya jadi bobrok begini masa akun saya ga ada apa apa tiba tiba dibatasi dan semuanya g bisa login tolonglah diperbaiki platform profesional masa kaya gini sistemnya jadi rugi juga sebagai user,35,35,kenapa linkedin sekarang sistemnya jadi bobrok begini masa akun saya tidak ada apa apa tiba tiba dibatasi dan semuanya tidak bisa login tolonglah di perbaiki platform profesional masa kayak begini sistemnya jadi rugi juga sebagai user,35,36,"['kenapa', 'linkedin', 'sekarang', 'sistemnya', 'jadi', 'bobrok', 'begini', 'masa', 'akun', 'saya', 'tidak', 'ada', 'apa', 'apa', 'tiba', 'tiba', 'dibatasi', 'dan', 'semuanya', 'tidak', 'bisa', 'login', 'tolonglah', 'di', 'perbaiki', 'platform', 'profesional', 'masa', 'kayak', 'begini', 'sistemnya', 'jadi', 'rugi', 'juga', 'sebagai', 'user']","['linkedin', 'sistemnya', 'bobrok', 'akun', 'tidak', 'dibatasi', 'tidak', 'login', 'tolonglah', 'perbaiki', 'platform', 'profesional', 'kayak', 'sistemnya', 'rugi', 'user']",36,16,20,linkedin sistem bobrok akun tidak batas tidak login tolong baik platform profesional kayak sistem rugi user,16,16
Sangat membantu dalam hal nambah relasi,positif,2024-08-05,2024,sangat membantu dalam hal nambah relasi,6,6,sangat membantu dalam hal nambah relasi,6,6,"['sangat', 'membantu', 'dalam', 'hal', 'nambah', 'relasi']","['membantu', 'nambah', 'relasi']",6,3,3,bantu nambah relasi,3,3
"Saya mauu ngasih tau buat pengguna baru seperti saya,saya ingin memberitahukan masalah² yg ad di LinkedIn yaitu Untuk Loginnya ribet,code verifikasi kgk masuk akal/lama smpe lumutan,untuk code verif kgk muncul² lain kali untuk pihak LinkedIn saya harap bisa diperbaiki masalah² yg terjadi sekarang ini sekian terimakasih...👍",negatif,2023-04-08,2023,saya mauu ngasih tau buat pengguna baru seperti saya saya ingin memberitahukan masalah² yg ad di linkedin yaitu untuk loginnya ribet code verifikasi kgk masuk akal lama smpe lumutan untuk code verif kgk muncul² lain kali untuk pihak linkedin saya harap bisa diperbaiki masalah² yg terjadi sekarang ini sekian terimakasih,46,50,saya mauu memberikan tahu buat pengguna baru seperti saya saya ingin memberitahukan masalah² yang ada di linkedin yaitu untuk loginnya rumit code verifikasi tidak masuk akal lama sampai lumutan untuk code verif tidak muncul² lain kali untuk pihak linkedin saya harap bisa di perbaiki masalah² yang terjadi sekarang ini sekian terima kasih,50,52,"['saya', 'mauu', 'memberikan', 'tahu', 'buat', 'pengguna', 'baru', 'seperti', 'saya', 'saya', 'ingin', 'memberitahukan', 'masalah²', 'yang', 'ada', 'di', 'linkedin', 'yaitu', 'untuk', 'loginnya', 'rumit', 'code', 'verifikasi', 'tidak', 'masuk', 'akal', 'lama', 'sampai', 'lumutan', 'untuk', 'code', 'verif', 'tidak', 'muncul²', 'lain', 'kali', 'untuk', 'pihak', 'linkedin', 'saya', 'harap', 'bisa', 'di', 'perbaiki', 'masalah²', 'yang', 'terjadi', 'sekarang', 'ini', 'sekian', 'terima', 'kasih']","['mauu', 'pengguna', 'memberitahukan', 'masalah²', 'linkedin', 'loginnya', 'rumit', 'code', 'verifikasi', 'tidak', 'masuk', 'akal', 'lumutan', 'code', 'verif', 'tidak', 'muncul²', 'kali', 'linkedin', 'harap', 'perbaiki', 'masalah²', 'sekian', 'terima', 'kasih']",52,25,27,mauu guna memberitahukan masalah linkedin loginnya rumit code verifikasi tidak masuk akal lumut code verif tidak muncul kali linkedin harap baik masalah sekian terima kasih,25,25
Kenapa pembayaran saldo premium otomatis? Harusnya kan konfirmasi dulu Uang segitu gitunya dipotong otomatis sama apk ginian! Mana motong saldonya gede banget sampe 700rb!! Itu potongan apa sih bangkeeeee! Dapet kerja dari akun ini aja gak pernah!,negatif,2023-06-01,2023,kenapa pembayaran saldo premium otomatis harusnya kan konfirmasi dulu uang segitu gitunya dipotong otomatis sama apk ginian mana motong saldonya gede banget sampe rb itu potongan apa sih bangkeeeee dapet kerja dari akun ini aja gak pernah,37,37,kenapa pembayaran saldo premium otomatis harusnya akan konfirmasi dahulu uang segitu gitunya dipotong otomatis sama aplikasi ginian mana motong saldonya gede banget sampai ribu itu potongan apa sih bangkeeeee dapat kerja dari akun ini saja tidak pernah,37,37,"['kenapa', 'pembayaran', 'saldo', 'premium', 'otomatis', 'harusnya', 'akan', 'konfirmasi', 'dahulu', 'uang', 'segitu', 'gitunya', 'dipotong', 'otomatis', 'sama', 'aplikasi', 'ginian', 'mana', 'motong', 'saldonya', 'gede', 'banget', 'sampai', 'ribu', 'itu', 'potongan', 'apa', 'sih', 'bangkeeeee', 'dapat', 'kerja', 'dari', 'akun', 'ini', 'saja', 'tidak', 'pernah']","['pembayaran', 'saldo', 'premium', 'otomatis', 'konfirmasi', 'uang', 'segitu', 'gitunya', 'dipotong', 'otomatis', 'aplikasi', 'ginian', 'motong', 'saldonya', 'gede', 'banget', 'ribu', 'potongan', 'sih', 'bangkeeeee', 'kerja', 'akun', 'tidak']",37,23,14,bayar saldo premium otomatis konfirmasi uang segitu gitunya potong otomatis aplikasi ginian motong saldo gede banget ribu potong sih bangkeeeee kerja akun tidak,23,23
Saya senang mau di aplikasi ini bagus dan sangat menghibur,positif,2024-06-13,2024,saya senang mau di aplikasi ini bagus dan sangat menghibur,10,10,saya senang mau di aplikasi ini bagus dan sangat menghibur,10,10,"['saya', 'senang', 'mau', 'di', 'aplikasi', 'ini', 'bagus', 'dan', 'sangat', 'menghibur']","['senang', 'aplikasi', 'bagus', 'menghibur']",10,4,6,senang aplikasi bagus hibur,4,4
Mau klik pekerjaan tiba-tiba keluar aneh bgt,negatif,2024-04-05,2024,mau klik pekerjaan tiba tiba keluar aneh bgt,7,8,mau klik pekerjaan tiba tiba keluar aneh banget,8,8,"['mau', 'klik', 'pekerjaan', 'tiba', 'tiba', 'keluar', 'aneh', 'banget']","['klik', 'pekerjaan', 'aneh', 'banget']",8,4,4,klik kerja aneh banget,4,4
"Setelah pembaharuan pencarian dibatasi, pengguna/jobseeker diarahkan untuk premium(berbayar) jangankan buat bayar, buat makan saja sulit bagi kami para jobseeker, mohon perbaharui....",negatif,2021-03-20,2021,setelah pembaharuan pencarian dibatasi pengguna jobseeker diarahkan untuk premium berbayar jangankan buat bayar buat makan saja sulit bagi kami para jobseeker mohon perbaharui,21,23,setelah pembaharuan pencarian dibatasi pengguna jobseeker diarahkan untuk premium berbayar jangankan buat bayar buat makan saja sulit bagi kami para jobseeker mohon perbaharui,23,23,"['setelah', 'pembaharuan', 'pencarian', 'dibatasi', 'pengguna', 'jobseeker', 'diarahkan', 'untuk', 'premium', 'berbayar', 'jangankan', 'buat', 'bayar', 'buat', 'makan', 'saja', 'sulit', 'bagi', 'kami', 'para', 'jobseeker', 'mohon', 'perbaharui']","['pembaharuan', 'pencarian', 'dibatasi', 'pengguna', 'jobseeker', 'diarahkan', 'premium', 'berbayar', 'bayar', 'makan', 'sulit', 'jobseeker', 'mohon', 'perbaharui']",23,14,9,baharu cari batas guna jobseeker arah premium bayar bayar makan sulit jobseeker mohon baharu,14,14
Platform untuk cari pekerjaan dan menambah skill serta relasi.,positif,2024-06-06,2024,platform untuk cari pekerjaan dan menambah skill serta relasi,9,9,platform untuk cari pekerjaan dan menambah skill serta relasi,9,9,"['platform', 'untuk', 'cari', 'pekerjaan', 'dan', 'menambah', 'skill', 'serta', 'relasi']","['platform', 'cari', 'pekerjaan', 'menambah', 'skill', 'relasi']",9,6,3,platform cari kerja tambah skill relasi,6,6
"Terimakasih LinkedIn , saya sangat berterimakasih kepada management LinkedIn dengan adanya aplikasi ini sangat sangat bermanfaat sekali buat masyarakat dunia Yang butuh pekerjaan sehingga lebih mudah lewat aplikasi ini, walaupun sebenarnya sekalipun saya belum pernah dapat pekerjaan lewat aplikasi ini tapi saya percaya dan yakin bahwa memang aplikasi ini sangat menolong banyak orang ,saya selalu berusaha ingin dapat pekerjaan lewat aplikasi tapi belum berhasil juga ,tetap saya berterimakasih",positif,2022-04-27,2022,terimakasih linkedin saya sangat berterimakasih kepada management linkedin dengan adanya aplikasi ini sangat sangat bermanfaat sekali buat masyarakat dunia yang butuh pekerjaan sehingga lebih mudah lewat aplikasi ini walaupun sebenarnya sekalipun saya belum pernah dapat pekerjaan lewat aplikasi ini tapi saya percaya dan yakin bahwa memang aplikasi ini sangat menolong banyak orang saya selalu berusaha ingin dapat pekerjaan lewat aplikasi tapi belum berhasil juga tetap saya berterimakasih,68,67,terima kasih linkedin saya sangat berterimakasih kepada management linkedin dengan adanya aplikasi ini sangat sangat bermanfaat sekali buat masyarakat dunia yang butuh pekerjaan sehingga lebih mudah lewat aplikasi ini walaupun sebenarnya sekalipun saya belum pernah dapat pekerjaan lewat aplikasi ini tapi saya percaya dan yakin bahwa memang aplikasi ini sangat menolong banyak orang saya selalu berusaha ingin dapat pekerjaan lewat aplikasi tapi belum berhasil juga tetap saya berterimakasih,67,68,"['terima', 'kasih', 'linkedin', 'saya', 'sangat', 'berterimakasih', 'kepada', 'management', 'linkedin', 'dengan', 'adanya', 'aplikasi', 'ini', 'sangat', 'sangat', 'bermanfaat', 'sekali', 'buat', 'masyarakat', 'dunia', 'yang', 'butuh', 'pekerjaan', 'sehingga', 'lebih', 'mudah', 'lewat', 'aplikasi', 'ini', 'walaupun', 'sebenarnya', 'sekalipun', 'saya', 'belum', 'pernah', 'dapat', 'pekerjaan', 'lewat', 'aplikasi', 'ini', 'tapi', 'saya', 'percaya', 'dan', 'yakin', 'bahwa', 'memang', 'aplikasi', 'ini', 'sangat', 'menolong', 'banyak', 'orang', 'saya', 'selalu', 'berusaha', 'ingin', 'dapat', 'pekerjaan', 'lewat', 'aplikasi', 'tapi', 'belum', 'berhasil', 'juga', 'tetap', 'saya', 'berterimakasih']","['terima', 'kasih', 'linkedin', 'berterimakasih', 'management', 'linkedin', 'aplikasi', 'bermanfaat', 'masyarakat', 'dunia', 'butuh', 'pekerjaan', 'mudah', 'aplikasi', 'pekerjaan', 'aplikasi', 'percaya', 'aplikasi', 'menolong', 'orang', 'berusaha', 'pekerjaan', 'aplikasi', 'berhasil', 'berterimakasih']",68,25,43,terima kasih linkedin berterimakasih management linkedin aplikasi manfaat masyarakat dunia butuh kerja mudah aplikasi kerja aplikasi percaya aplikasi tolong orang usaha kerja aplikasi hasil berterimakasih,25,25
Mau hapus akun aja ribet banget. Mengulang dialog yg sama sampe 10 kali. 😒,negatif,2024-06-05,2024,mau hapus akun aja ribet banget mengulang dialog yg sama sampe kali,14,12,mau hapus akun saja rumit banget mengulang dialog yang sama sampai kali,12,12,"['mau', 'hapus', 'akun', 'saja', 'rumit', 'banget', 'mengulang', 'dialog', 'yang', 'sama', 'sampai', 'kali']","['hapus', 'akun', 'rumit', 'banget', 'mengulang', 'dialog', 'kali']",12,7,5,hapus akun rumit banget ulang dialog kali,7,7
"Aplikasi ini sangat tidak berguna, sebagua apapun profil anda dan se provesional apapun anda, anda hanya buang buang waktu dan tenaga di dalam room ini. Tidak ada lowongan pekerjaan didalam room ini. Hanya akal akalan developer dg mitra agar apk seolah kredibel. Jika apk ini benar2 kredibel maka saya sudah mendapatkan pekerjaan karena sdh bergabung lebih dari 1 tahun.",negatif,2024-03-07,2024,aplikasi ini sangat tidak berguna sebagua apapun profil anda dan se provesional apapun anda anda hanya buang buang waktu dan tenaga di dalam room ini tidak ada lowongan pekerjaan didalam room ini hanya akal akalan developer dg mitra agar apk seolah kredibel jika apk ini benar kredibel maka saya sudah mendapatkan pekerjaan karena sdh bergabung lebih dari tahun,59,58,aplikasi ini sangat tidak berguna sebagua apapun profil anda dan se provesional apapun anda anda hanya buang buang waktu dan tenaga di dalam room ini tidak ada lowongan pekerjaan didalam room ini hanya akal akalan developer dengan mitra agar aplikasi seolah kredibel jika aplikasi ini benar kredibel maka saya sudah mendapatkan pekerjaan karena sudah bergabung lebih dari tahun,58,58,"['aplikasi', 'ini', 'sangat', 'tidak', 'berguna', 'sebagua', 'apapun', 'profil', 'anda', 'dan', 'se', 'provesional', 'apapun', 'anda', 'anda', 'hanya', 'buang', 'buang', 'waktu', 'dan', 'tenaga', 'di', 'dalam', 'room', 'ini', 'tidak', 'ada', 'lowongan', 'pekerjaan', 'didalam', 'room', 'ini', 'hanya', 'akal', 'akalan', 'developer', 'dengan', 'mitra', 'agar', 'aplikasi', 'seolah', 'kredibel', 'jika', 'aplikasi', 'ini', 'benar', 'kredibel', 'maka', 'saya', 'sudah', 'mendapatkan', 'pekerjaan', 'karena', 'sudah', 'bergabung', 'lebih', 'dari', 'tahun']","['aplikasi', 'tidak', 'berguna', 'sebagua', 'apapun', 'profil', 'provesional', 'apapun', 'buang', 'buang', 'tenaga', 'room', 'tidak', 'lowongan', 'pekerjaan', 'didalam', 'room', 'akal', 'akalan', 'developer', 'mitra', 'aplikasi', 'kredibel', 'aplikasi', 'kredibel', 'pekerjaan', 'bergabung']",58,27,31,aplikasi tidak guna sebagua apa profil provesional apa buang buang tenaga room tidak lowong kerja dalam room akal akal developer mitra aplikasi kredibel aplikasi kredibel kerja gabung,27,27
"Mohon kembalikan uang saya yang sudah di garik dari pihak anda melalui google play ke shopepay saya, saya tidak melakukan konfirmasi apapun terkait pembelian berlangganan di aplikasi ini. Tetapi apk ini telah mengambil dana dari shopepay saya tanpa konfirmasi dari pemilik akun. Saya juga sudah mengajukan klaim berkali lali tapi tidak ada jawaban dari anda. Mohon bantuanya.",negatif,2024-03-14,2024,mohon kembalikan uang saya yang sudah di garik dari pihak anda melalui google play ke shopepay saya saya tidak melakukan konfirmasi apapun terkait pembelian berlangganan di aplikasi ini tetapi apk ini telah mengambil dana dari shopepay saya tanpa konfirmasi dari pemilik akun saya juga sudah mengajukan klaim berkali lali tapi tidak ada jawaban dari anda mohon bantuanya,57,57,mohon kembalikan uang saya yang sudah di garik dari pihak anda melalui google play ke shopepay saya saya tidak melakukan konfirmasi apapun terkait pembelian berlangganan di aplikasi ini tetapi aplikasi ini telah mengambil dana dari shopepay saya tanpa konfirmasi dari pemilik akun saya juga sudah mengajukan klaim berkali lali tapi tidak ada jawaban dari anda mohon bantuanya,57,57,"['mohon', 'kembalikan', 'uang', 'saya', 'yang', 'sudah', 'di', 'garik', 'dari', 'pihak', 'anda', 'melalui', 'google', 'play', 'ke', 'shopepay', 'saya', 'saya', 'tidak', 'melakukan', 'konfirmasi', 'apapun', 'terkait', 'pembelian', 'berlangganan', 'di', 'aplikasi', 'ini', 'tetapi', 'aplikasi', 'ini', 'telah', 'mengambil', 'dana', 'dari', 'shopepay', 'saya', 'tanpa', 'konfirmasi', 'dari', 'pemilik', 'akun', 'saya', 'juga', 'sudah', 'mengajukan', 'klaim', 'berkali', 'lali', 'tapi', 'tidak', 'ada', 'jawaban', 'dari', 'anda', 'mohon', 'bantuanya']","['mohon', 'kembalikan', 'uang', 'garik', 'google', 'play', 'shopepay', 'tidak', 'konfirmasi', 'apapun', 'terkait', 'pembelian', 'berlangganan', 'aplikasi', 'aplikasi', 'mengambil', 'dana', 'shopepay', 'konfirmasi', 'pemilik', 'akun', 'mengajukan', 'klaim', 'berkali', 'lali', 'tidak', 'mohon', 'bantuanya']",57,28,29,mohon kembali uang garik google play shopepay tidak konfirmasi apa kait beli langgan aplikasi aplikasi ambil dana shopepay konfirmasi milik akun aju klaim kali lali tidak mohon bantuanya,28,28
"Tampilan terlalu rumit,kurang tertata dengan baik",negatif,2024-06-14,2024,tampilan terlalu rumit kurang tertata dengan baik,6,7,tampilan terlalu rumit kurang tertata dengan baik,7,7,"['tampilan', 'terlalu', 'rumit', 'kurang', 'tertata', 'dengan', 'baik']","['tampilan', 'rumit', 'tertata']",7,3,4,tampil rumit tata,3,3
"Akun saya tiba-tiba gak bisa dibuka malah disuruh untuk verifikasi dengan persona, kenapa akun saya malah dibatasi dan saya merasa tidak melakukan apa"" di akun itu, mohon untuk diperbaiki lagi 🤧🙏",negatif,2024-05-24,2024,akun saya tiba tiba gak bisa dibuka malah disuruh untuk verifikasi dengan persona kenapa akun saya malah dibatasi dan saya merasa tidak melakukan apa di akun itu mohon untuk diperbaiki lagi,31,31,akun saya tiba tiba tidak bisa dibuka bahkan disuruh untuk verifikasi dengan persona kenapa akun saya bahkan dibatasi dan saya merasa tidak melakukan apa di akun itu mohon untuk di perbaiki lagi,31,32,"['akun', 'saya', 'tiba', 'tiba', 'tidak', 'bisa', 'dibuka', 'bahkan', 'disuruh', 'untuk', 'verifikasi', 'dengan', 'persona', 'kenapa', 'akun', 'saya', 'bahkan', 'dibatasi', 'dan', 'saya', 'merasa', 'tidak', 'melakukan', 'apa', 'di', 'akun', 'itu', 'mohon', 'untuk', 'di', 'perbaiki', 'lagi']","['akun', 'tidak', 'dibuka', 'disuruh', 'verifikasi', 'persona', 'akun', 'dibatasi', 'tidak', 'akun', 'mohon', 'perbaiki']",32,12,20,akun tidak buka suruh verifikasi persona akun batas tidak akun mohon baik,12,12
"Linkedin klo sy liat bagus mk nya sy coba ikut akun limkedin setelah sy buat akun lg proses mengenai kata sandi , no hp stlh sy tullis di blg salah pd hal itu benar no hp sy , smp ulang berkali 2 sampr capek . Sy mohon coba yg simpel aja ng usah coba 2 nya#",negatif,2024-02-05,2024,linkedin klo sy liat bagus mk nya sy coba ikut akun limkedin setelah sy buat akun lg proses mengenai kata sandi no hp stlh sy tullis di blg salah pd hal itu benar no hp sy smp ulang berkali sampr capek sy mohon coba yg simpel aja ng usah coba nya,56,51,linkedin kalau saya lihat bagus mk nya saya coba ikut akun limkedin setelah saya buat akun lagi proses mengenai kata sandi nomor handphone setelah saya tullis di bilang salah pada hal itu benar nomor handphone saya sampai ulang berkali sampr capek saya mohon coba yang simpel saja ng usah coba nya,51,51,"['linkedin', 'kalau', 'saya', 'lihat', 'bagus', 'mk', 'nya', 'saya', 'coba', 'ikut', 'akun', 'limkedin', 'setelah', 'saya', 'buat', 'akun', 'lagi', 'proses', 'mengenai', 'kata', 'sandi', 'nomor', 'handphone', 'setelah', 'saya', 'tullis', 'di', 'bilang', 'salah', 'pada', 'hal', 'itu', 'benar', 'nomor', 'handphone', 'saya', 'sampai', 'ulang', 'berkali', 'sampr', 'capek', 'saya', 'mohon', 'coba', 'yang', 'simpel', 'saja', 'ng', 'usah', 'coba', 'nya']","['linkedin', 'lihat', 'bagus', 'mk', 'nya', 'coba', 'akun', 'limkedin', 'akun', 'proses', 'sandi', 'nomor', 'handphone', 'tullis', 'bilang', 'salah', 'nomor', 'handphone', 'ulang', 'berkali', 'sampr', 'capek', 'mohon', 'coba', 'simpel', 'ng', 'coba', 'nya']",51,28,23,linkedin lihat bagus mk nya coba akun limkedin akun proses sandi nomor handphone tullis bilang salah nomor handphone ulang kali sampr capek mohon coba simpel ng coba nya,28,28
Nyoba dulu siapa tau ada kerjaan yang pas Terimakasih Linkedln udah ngebantu nyariin pekerjaan pokonya aplikasi ini sangat bermanfaat jangan lupa lebih di tingkatkan terus aplikasi nya 😊,positif,2020-10-30,2020,nyoba dulu siapa tau ada kerjaan yang pas terimakasih linkedln udah ngebantu nyariin pekerjaan pokonya aplikasi ini sangat bermanfaat jangan lupa lebih di tingkatkan terus aplikasi nya,28,27,mencoba dahulu siapa tahu ada kerjaan yang pas terima kasih linkedln sudah membantu nyariin pekerjaan pokoknya aplikasi ini sangat bermanfaat jangan lupa lebih di tingkatkan terus aplikasi nya,27,28,"['mencoba', 'dahulu', 'siapa', 'tahu', 'ada', 'kerjaan', 'yang', 'pas', 'terima', 'kasih', 'linkedln', 'sudah', 'membantu', 'nyariin', 'pekerjaan', 'pokoknya', 'aplikasi', 'ini', 'sangat', 'bermanfaat', 'jangan', 'lupa', 'lebih', 'di', 'tingkatkan', 'terus', 'aplikasi', 'nya']","['mencoba', 'kerjaan', 'pas', 'terima', 'kasih', 'linkedln', 'membantu', 'nyariin', 'pekerjaan', 'pokoknya', 'aplikasi', 'bermanfaat', 'lupa', 'tingkatkan', 'aplikasi', 'nya']",28,16,12,coba kerja pas terima kasih linkedln bantu nyariin kerja pokok aplikasi manfaat lupa tingkat aplikasi nya,16,16
"aplikasi tergajelas, saya mau daftar ke aplikasinya tapi malah disuruh berkali kali verifikasi teka teki, berkali kali sampai satu tahun 😁. tolong kalo mau bikin aplikasi dicoba dulu biar pengguna yang mau memakai lebih dipermudah!!!",negatif,2023-12-27,2023,aplikasi tergajelas saya mau daftar ke aplikasinya tapi malah disuruh berkali kali verifikasi teka teki berkali kali sampai satu tahun tolong kalo mau bikin aplikasi dicoba dulu biar pengguna yang mau memakai lebih dipermudah,35,34,aplikasi tergajelas saya mau daftar ke aplikasi nya tapi bahkan disuruh berkali kali verifikasi teka teki berkali kali sampai satu tahun tolong kalau mau bikin aplikasi dicoba dahulu biar pengguna yang mau memakai lebih dipermudah,34,35,"['aplikasi', 'tergajelas', 'saya', 'mau', 'daftar', 'ke', 'aplikasi', 'nya', 'tapi', 'bahkan', 'disuruh', 'berkali', 'kali', 'verifikasi', 'teka', 'teki', 'berkali', 'kali', 'sampai', 'satu', 'tahun', 'tolong', 'kalau', 'mau', 'bikin', 'aplikasi', 'dicoba', 'dahulu', 'biar', 'pengguna', 'yang', 'mau', 'memakai', 'lebih', 'dipermudah']","['aplikasi', 'tergajelas', 'daftar', 'aplikasi', 'nya', 'disuruh', 'berkali', 'kali', 'verifikasi', 'teka', 'teki', 'berkali', 'kali', 'tolong', 'bikin', 'aplikasi', 'dicoba', 'biar', 'pengguna', 'memakai', 'dipermudah']",35,21,14,aplikasi tergajelas daftar aplikasi nya suruh kali kali verifikasi teka teki kali kali tolong bikin aplikasi coba biar guna pakai mudah,21,21
"good apps, mau nanya apakah bisa memasukkan sertifikasi/webinar. utk update profile. jika belum baiknya ada data sertifikasi. trims",positif,2023-11-09,2023,good apps mau nanya apakah bisa memasukkan sertifikasi webinar utk update profile jika belum baiknya ada data sertifikasi trims,18,19,bagus aplikasi mau bertanya apakah bisa memasukkan sertifikasi webinar untuk diperbarui profile jika belum baiknya ada data sertifikasi terima kasih,19,20,"['bagus', 'aplikasi', 'mau', 'bertanya', 'apakah', 'bisa', 'memasukkan', 'sertifikasi', 'webinar', 'untuk', 'diperbarui', 'profile', 'jika', 'belum', 'baiknya', 'ada', 'data', 'sertifikasi', 'terima', 'kasih']","['bagus', 'aplikasi', 'memasukkan', 'sertifikasi', 'webinar', 'diperbarui', 'profile', 'baiknya', 'data', 'sertifikasi', 'terima', 'kasih']",20,12,8,bagus aplikasi masuk sertifikasi webinar baru profile baik data sertifikasi terima kasih,12,12
"No hp tak mau masuk ,apk gimana sih , gak jelas kali, padahal no hp msih aktif nelpon wa tapi gak bisa dibuat daftar ,katanya sesi valid ntah apa yg valid ,ku uninstall aja sih kek nya ribet amat 🔥",negatif,2024-04-15,2024,no hp tak mau masuk apk gimana sih gak jelas kali padahal no hp msih aktif nelpon wa tapi gak bisa dibuat daftar katanya sesi valid ntah apa yg valid ku uninstall aja sih kek nya ribet amat,40,38,nomor handphone tidak mau masuk aplikasi bagaimana sih tidak jelas kali padahal nomor handphone masih aktif nelpon whatsapp tapi tidak bisa dibuat daftar katanya sesi valid entah apa yang valid saya uninstall saja sih seperti nya rumit amat,38,38,"['nomor', 'handphone', 'tidak', 'mau', 'masuk', 'aplikasi', 'bagaimana', 'sih', 'tidak', 'jelas', 'kali', 'padahal', 'nomor', 'handphone', 'masih', 'aktif', 'nelpon', 'whatsapp', 'tapi', 'tidak', 'bisa', 'dibuat', 'daftar', 'katanya', 'sesi', 'valid', 'entah', 'apa', 'yang', 'valid', 'saya', 'uninstall', 'saja', 'sih', 'seperti', 'nya', 'rumit', 'amat']","['nomor', 'handphone', 'tidak', 'masuk', 'aplikasi', 'sih', 'tidak', 'kali', 'nomor', 'handphone', 'aktif', 'nelpon', 'whatsapp', 'tidak', 'daftar', 'sesi', 'valid', 'valid', 'uninstall', 'sih', 'nya', 'rumit']",38,22,16,nomor handphone tidak masuk aplikasi sih tidak kali nomor handphone aktif nelpon whatsapp tidak daftar sesi valid valid uninstall sih nya rumit,22,22
Bagus dan sangat membantu sekali,positif,2024-08-03,2024,bagus dan sangat membantu sekali,5,5,bagus dan sangat membantu sekali,5,5,"['bagus', 'dan', 'sangat', 'membantu', 'sekali']","['bagus', 'membantu']",5,2,3,bagus bantu,2,2
"Saya sudah mendaftar ke apk ni tapi selalu bolak balik pendaftarannya. Awalnya masukin email dan nomor telfon nama depan belakang lalu verifikasi telfon dan stlh di lanjutkan ulangi lagi daftar dan isi nomor telfon, nmor yg sudah di verifikasi tidak dpt dipakai lagi, harus nomor baru. Ini sudah dua nmor baru yg saya coba tapi tetap saja bolak balik, saya kecewa",negatif,2022-10-01,2022,saya sudah mendaftar ke apk ni tapi selalu bolak balik pendaftarannya awalnya masukin email dan nomor telfon nama depan belakang lalu verifikasi telfon dan stlh di lanjutkan ulangi lagi daftar dan isi nomor telfon nmor yg sudah di verifikasi tidak dpt dipakai lagi harus nomor baru ini sudah dua nmor baru yg saya coba tapi tetap saja bolak balik saya kecewa,61,61,saya sudah mendaftar ke aplikasi ini tapi selalu bolak balik pendaftarannya awalnya masukkan email dan nomor telpon nama depan belakang lalu verifikasi telpon dan setelah di lanjutkan ulang lagi daftar dan isi nomor telpon nmor yang sudah di verifikasi tidak dapat dipakai lagi harus nomor baru ini sudah dua nmor baru yang saya coba tapi tetap saja bolak balik saya kecewa,61,61,"['saya', 'sudah', 'mendaftar', 'ke', 'aplikasi', 'ini', 'tapi', 'selalu', 'bolak', 'balik', 'pendaftarannya', 'awalnya', 'masukkan', 'email', 'dan', 'nomor', 'telpon', 'nama', 'depan', 'belakang', 'lalu', 'verifikasi', 'telpon', 'dan', 'setelah', 'di', 'lanjutkan', 'ulang', 'lagi', 'daftar', 'dan', 'isi', 'nomor', 'telpon', 'nmor', 'yang', 'sudah', 'di', 'verifikasi', 'tidak', 'dapat', 'dipakai', 'lagi', 'harus', 'nomor', 'baru', 'ini', 'sudah', 'dua', 'nmor', 'baru', 'yang', 'saya', 'coba', 'tapi', 'tetap', 'saja', 'bolak', 'balik', 'saya', 'kecewa']","['mendaftar', 'aplikasi', 'bolak', 'pendaftarannya', 'masukkan', 'email', 'nomor', 'telpon', 'nama', 'verifikasi', 'telpon', 'lanjutkan', 'ulang', 'daftar', 'isi', 'nomor', 'telpon', 'nmor', 'verifikasi', 'tidak', 'dipakai', 'nomor', 'nmor', 'coba', 'bolak', 'kecewa']",61,26,35,daftar aplikasi bolak daftar masuk email nomor telpon nama verifikasi telpon lanjut ulang daftar isi nomor telpon nmor verifikasi tidak pakai nomor nmor coba bolak kecewa,26,26
yg bener bikin verifikasi login min. masak udah milih gambar yg bener masih blm bisa2 login. gimana sih. di perbaiki lah untuk login pengguna baru jgn di persulit,negatif,2024-03-18,2024,yg bener bikin verifikasi login min masak udah milih gambar yg bener masih blm bisa login gimana sih di perbaiki lah untuk login pengguna baru jgn di persulit,28,28,yang benar bikin verifikasi login minimal masak sudah memilih gambar yang benar masih belum bisa login bagaimana sih di perbaikan lah untuk login pengguna baru jangan di persulit,28,28,"['yang', 'benar', 'bikin', 'verifikasi', 'login', 'minimal', 'masak', 'sudah', 'memilih', 'gambar', 'yang', 'benar', 'masih', 'belum', 'bisa', 'login', 'bagaimana', 'sih', 'di', 'perbaikan', 'lah', 'untuk', 'login', 'pengguna', 'baru', 'jangan', 'di', 'persulit']","['bikin', 'verifikasi', 'login', 'minimal', 'masak', 'memilih', 'gambar', 'login', 'sih', 'perbaikan', 'login', 'pengguna', 'persulit']",28,13,15,bikin verifikasi login minimal masak pilih gambar login sih baik login guna sulit,13,13
Proses verifikasi / security cek ny sm sekali tidak membantu mlh mempersulit,negatif,2024-04-25,2024,proses verifikasi security cek ny sm sekali tidak membantu mlh mempersulit,12,11,proses verifikasi security cek nya sama sekali tidak membantu malah mempersulit,11,11,"['proses', 'verifikasi', 'security', 'cek', 'nya', 'sama', 'sekali', 'tidak', 'membantu', 'malah', 'mempersulit']","['proses', 'verifikasi', 'security', 'cek', 'nya', 'tidak', 'membantu', 'mempersulit']",11,8,3,proses verifikasi security cek nya tidak bantu sulit,8,8
Niat mau cari job kerja pas awal masuk udah daftar masa harus deskripsikan gambar hewan gambar yang menghadap atas kurang bermanfaat banget ribet udah 7x salah mulu emang perlu banget pastiin kalo login harus manusia begitu ! Diperbaiki lagi aplikasi bikin ribet orang aja harusnya permudah penggunanya dong gimana si heran,negatif,2022-09-23,2022,niat mau cari job kerja pas awal masuk udah daftar masa harus deskripsikan gambar hewan gambar yang menghadap atas kurang bermanfaat banget ribet udah x salah mulu emang perlu banget pastiin kalo login harus manusia begitu diperbaiki lagi aplikasi bikin ribet orang aja harusnya permudah penggunanya dong gimana si heran,51,50,niat mau cari kerja kerja pas awal masuk sudah daftar masa harus deskripsikan gambar hewan gambar yang menghadap atas kurang bermanfaat banget rumit sudah x salah mulu memang perlu banget pastiin kalau login harus manusia begitu di perbaiki lagi aplikasi bikin rumit orang saja harusnya permudah penggunanya dong bagaimana sih heran,50,51,"['niat', 'mau', 'cari', 'kerja', 'kerja', 'pas', 'awal', 'masuk', 'sudah', 'daftar', 'masa', 'harus', 'deskripsikan', 'gambar', 'hewan', 'gambar', 'yang', 'menghadap', 'atas', 'kurang', 'bermanfaat', 'banget', 'rumit', 'sudah', 'x', 'salah', 'mulu', 'memang', 'perlu', 'banget', 'pastiin', 'kalau', 'login', 'harus', 'manusia', 'begitu', 'di', 'perbaiki', 'lagi', 'aplikasi', 'bikin', 'rumit', 'orang', 'saja', 'harusnya', 'permudah', 'penggunanya', 'dong', 'bagaimana', 'sih', 'heran']","['niat', 'cari', 'kerja', 'kerja', 'pas', 'masuk', 'daftar', 'deskripsikan', 'gambar', 'hewan', 'gambar', 'menghadap', 'bermanfaat', 'banget', 'rumit', 'x', 'salah', 'mulu', 'banget', 'pastiin', 'login', 'manusia', 'perbaiki', 'aplikasi', 'bikin', 'rumit', 'orang', 'permudah', 'penggunanya', 'sih', 'heran']",51,31,20,niat cari kerja kerja pas masuk daftar deskripsi gambar hewan gambar hadap manfaat banget rumit x salah mulu banget pastiin login manusia baik aplikasi bikin rumit orang mudah guna sih heran,31,31
bismilah bisa bantu cari kerja,positif,2024-08-13,2024,bismilah bisa bantu cari kerja,5,5,bismilah bisa bantu cari kerja,5,5,"['bismilah', 'bisa', 'bantu', 'cari', 'kerja']","['bismilah', 'bantu', 'cari', 'kerja']",5,4,1,bismilah bantu cari kerja,4,4
Aplikasi seenaknya saja bekukan akun tanpa ada warning dulu.. saya tidak akan perna gunakan lagi linkedin. Main bekukan akun. Makanya buat warning pemberitahuan dulu. Baru main bekukan.. saya sudah 2 akun di bekukan. Saya tdk berbuat postingan aneh2. Jangan download ini klo tdk mau kecewa.,negatif,2022-03-15,2022,aplikasi seenaknya saja bekukan akun tanpa ada warning dulu saya tidak akan perna gunakan lagi linkedin main bekukan akun makanya buat warning pemberitahuan dulu baru main bekukan saya sudah akun di bekukan saya tdk berbuat postingan aneh jangan download ini klo tdk mau kecewa,45,44,aplikasi seenaknya saja bekukan akun tanpa ada warning dahulu saya tidak akan perna gunakan lagi linkedin main bekukan akun makanya buat warning pemberitahuan dahulu baru main bekukan saya sudah akun di bekukan saya tidak berbuat postingan aneh jangan unduh ini kalau tidak mau kecewa,44,44,"['aplikasi', 'seenaknya', 'saja', 'bekukan', 'akun', 'tanpa', 'ada', 'warning', 'dahulu', 'saya', 'tidak', 'akan', 'perna', 'gunakan', 'lagi', 'linkedin', 'main', 'bekukan', 'akun', 'makanya', 'buat', 'warning', 'pemberitahuan', 'dahulu', 'baru', 'main', 'bekukan', 'saya', 'sudah', 'akun', 'di', 'bekukan', 'saya', 'tidak', 'berbuat', 'postingan', 'aneh', 'jangan', 'unduh', 'ini', 'kalau', 'tidak', 'mau', 'kecewa']","['aplikasi', 'bekukan', 'akun', 'warning', 'tidak', 'perna', 'linkedin', 'main', 'bekukan', 'akun', 'warning', 'pemberitahuan', 'main', 'bekukan', 'akun', 'bekukan', 'tidak', 'berbuat', 'postingan', 'aneh', 'unduh', 'tidak', 'kecewa']",44,23,21,aplikasi beku akun warning tidak perna linkedin main beku akun warning pemberitahuan main beku akun beku tidak buat postingan aneh unduh tidak kecewa,23,23
"Lebih parah dari FACxxxx main blokar blokir🤣 Maaf, akun LinkedIn Anda telah dinonaktifkan untuk sementara. Jika Anda yakin bahwa akun Anda dibatasi akibat kesalahan, Anda dapat mengirimkan permohonan dengan terlebih dahulu memverifikasikan identitas Anda menggunakan browser desktop.",negatif,2021-02-15,2021,lebih parah dari facxxxx main blokar blokir maaf akun linkedin anda telah dinonaktifkan untuk sementara jika anda yakin bahwa akun anda dibatasi akibat kesalahan anda dapat mengirimkan permohonan dengan terlebih dahulu memverifikasikan identitas anda menggunakan browser desktop,37,37,lebih parah dari facxxxx main blokar blokir maaf akun linkedin anda telah dinonaktifkan untuk sementara jika anda yakin bahwa akun anda dibatasi akibat kesalahan anda dapat mengirimkan permohonan dengan terlebih dahulu memverifikasikan identitas anda menggunakan browser desktop,37,37,"['lebih', 'parah', 'dari', 'facxxxx', 'main', 'blokar', 'blokir', 'maaf', 'akun', 'linkedin', 'anda', 'telah', 'dinonaktifkan', 'untuk', 'sementara', 'jika', 'anda', 'yakin', 'bahwa', 'akun', 'anda', 'dibatasi', 'akibat', 'kesalahan', 'anda', 'dapat', 'mengirimkan', 'permohonan', 'dengan', 'terlebih', 'dahulu', 'memverifikasikan', 'identitas', 'anda', 'menggunakan', 'browser', 'desktop']","['parah', 'facxxxx', 'main', 'blokar', 'blokir', 'maaf', 'akun', 'linkedin', 'dinonaktifkan', 'akun', 'dibatasi', 'akibat', 'kesalahan', 'mengirimkan', 'permohonan', 'memverifikasikan', 'identitas', 'browser', 'desktop']",37,19,18,parah facxxxx main blokar blokir maaf akun linkedin nonaktif akun batas akibat salah kirim mohon verifikasi identitas browser desktop,19,19
"Aplikasi Linkedln saya sudah saya upgrade, tetapi kenapa akun saya nonaktif dan tidak bisa membuka aplikasi Linkedln, mohon bantuannya agar bisa membuka aplikasi Linkedln lagi dan akun saya pulih lagi, Terimakasih",negatif,2020-09-22,2020,aplikasi linkedln saya sudah saya upgrade tetapi kenapa akun saya nonaktif dan tidak bisa membuka aplikasi linkedln mohon bantuannya agar bisa membuka aplikasi linkedln lagi dan akun saya pulih lagi terimakasih,31,31,aplikasi linkedln saya sudah saya upgrade tetapi kenapa akun saya nonaktif dan tidak bisa membuka aplikasi linkedln mohon bantuannya agar bisa membuka aplikasi linkedln lagi dan akun saya pulih lagi terima kasih,31,32,"['aplikasi', 'linkedln', 'saya', 'sudah', 'saya', 'upgrade', 'tetapi', 'kenapa', 'akun', 'saya', 'nonaktif', 'dan', 'tidak', 'bisa', 'membuka', 'aplikasi', 'linkedln', 'mohon', 'bantuannya', 'agar', 'bisa', 'membuka', 'aplikasi', 'linkedln', 'lagi', 'dan', 'akun', 'saya', 'pulih', 'lagi', 'terima', 'kasih']","['aplikasi', 'linkedln', 'upgrade', 'akun', 'nonaktif', 'tidak', 'membuka', 'aplikasi', 'linkedln', 'mohon', 'bantuannya', 'membuka', 'aplikasi', 'linkedln', 'akun', 'pulih', 'terima', 'kasih']",32,18,14,aplikasi linkedln upgrade akun nonaktif tidak buka aplikasi linkedln mohon bantu buka aplikasi linkedln akun pulih terima kasih,18,18
Iklannya mengganggu aja,negatif,2024-06-14,2024,iklannya mengganggu aja,3,3,iklannya mengganggu saja,3,3,"['iklannya', 'mengganggu', 'saja']","['iklannya', 'mengganggu']",3,2,1,iklan ganggu,2,2
Sangat baik. Sangat membantu untuk memperluas jaringan pekerjaan,positif,2024-05-30,2024,sangat baik sangat membantu untuk memperluas jaringan pekerjaan,8,8,sangat baik sangat membantu untuk memperluas jaringan pekerjaan,8,8,"['sangat', 'baik', 'sangat', 'membantu', 'untuk', 'memperluas', 'jaringan', 'pekerjaan']","['membantu', 'memperluas', 'jaringan', 'pekerjaan']",8,4,4,bantu luas jaring kerja,4,4
"anjirr ni aplikasi ribet bgt , tiap mo lamar mesti log'in dulu ke aplikasi , trs nulis ulang lagi pengalaman kerjanya apaan aja , buat gue yg pengalaman kerjanya banyak (bukan mo sombong) , itu ribet bgt nulisin lg satu² !! ribeeeetttt!!!!!",negatif,2020-08-01,2020,anjirr ni aplikasi ribet bgt tiap mo lamar mesti log in dulu ke aplikasi trs nulis ulang lagi pengalaman kerjanya apaan aja buat gue yg pengalaman kerjanya banyak bukan mo sombong itu ribet bgt nulisin lg satu² ribeeeetttt,42,38,anjirr ini aplikasi rumit banget tiap mau lamar mesti log in dahulu ke aplikasi terus nulis ulang lagi pengalaman kerjanya apa saja buat saya yang pengalaman kerjanya banyak bukan mau sombong itu rumit banget nulisin lagi satu² ribeeeetttt,38,38,"['anjirr', 'ini', 'aplikasi', 'rumit', 'banget', 'tiap', 'mau', 'lamar', 'mesti', 'log', 'in', 'dahulu', 'ke', 'aplikasi', 'terus', 'nulis', 'ulang', 'lagi', 'pengalaman', 'kerjanya', 'apa', 'saja', 'buat', 'saya', 'yang', 'pengalaman', 'kerjanya', 'banyak', 'bukan', 'mau', 'sombong', 'itu', 'rumit', 'banget', 'nulisin', 'lagi', 'satu²', 'ribeeeetttt']","['anjirr', 'aplikasi', 'rumit', 'banget', 'lamar', 'mesti', 'log', 'in', 'aplikasi', 'nulis', 'ulang', 'pengalaman', 'kerjanya', 'pengalaman', 'kerjanya', 'sombong', 'rumit', 'banget', 'nulisin', 'satu²', 'ribeeeetttt']",38,21,17,anjirr aplikasi rumit banget lamar mesti log in aplikasi nulis ulang alam kerja alam kerja sombong rumit banget nulisin satu ribeeeetttt,21,21
"Bubar aja aplikasinya. Semua aplikasi, ga aplikasi dating ga aplikasi kerja. Semua pada diminta verifikasi pembuktian manusia atau bukan. Ujungnya suruh nebak gambar hewan menghadap ke atas dll, Biar apa sih?! Kok makin maju teknologi makin menyulitkan ya! Udah tau gak semuanya bisa. Malah dikasih verifikasi model sampah begitu.",negatif,2023-08-20,2023,bubar aja aplikasinya semua aplikasi ga aplikasi dating ga aplikasi kerja semua pada diminta verifikasi pembuktian manusia atau bukan ujungnya suruh nebak gambar hewan menghadap ke atas dll biar apa sih kok makin maju teknologi makin menyulitkan ya udah tau gak semuanya bisa malah dikasih verifikasi model sampah begitu,49,49,bubar saja aplikasi nya semua aplikasi tidak aplikasi dating tidak aplikasi kerja semua pada diminta verifikasi pembuktian manusia atau bukan ujungnya suruh nebak gambar hewan menghadap ke atas dan lain lain biar apa sih kok makin maju teknologi makin menyulitkan ya sudah tahu tidak semuanya bisa bahkan dikasih verifikasi model sampah begitu,49,52,"['bubar', 'saja', 'aplikasi', 'nya', 'semua', 'aplikasi', 'tidak', 'aplikasi', 'dating', 'tidak', 'aplikasi', 'kerja', 'semua', 'pada', 'diminta', 'verifikasi', 'pembuktian', 'manusia', 'atau', 'bukan', 'ujungnya', 'suruh', 'nebak', 'gambar', 'hewan', 'menghadap', 'ke', 'atas', 'dan', 'lain', 'lain', 'biar', 'apa', 'sih', 'kok', 'makin', 'maju', 'teknologi', 'makin', 'menyulitkan', 'ya', 'sudah', 'tahu', 'tidak', 'semuanya', 'bisa', 'bahkan', 'dikasih', 'verifikasi', 'model', 'sampah', 'begitu']","['bubar', 'aplikasi', 'nya', 'aplikasi', 'tidak', 'aplikasi', 'dating', 'tidak', 'aplikasi', 'kerja', 'verifikasi', 'pembuktian', 'manusia', 'ujungnya', 'suruh', 'nebak', 'gambar', 'hewan', 'menghadap', 'biar', 'sih', 'maju', 'teknologi', 'menyulitkan', 'ya', 'tidak', 'dikasih', 'verifikasi', 'model', 'sampah']",52,30,22,bubar aplikasi nya aplikasi tidak aplikasi dating tidak aplikasi kerja verifikasi bukti manusia ujung suruh nebak gambar hewan hadap biar sih maju teknologi sulit ya tidak kasih verifikasi model sampah,30,30
Masa login aja gak bisa kek mana ini secara lagi butuh secepatnya,negatif,2024-05-17,2024,masa login aja gak bisa kek mana ini secara lagi butuh secepatnya,12,12,masa login saja tidak bisa seperti mana ini secara lagi butuh secepatnya,12,12,"['masa', 'login', 'saja', 'tidak', 'bisa', 'seperti', 'mana', 'ini', 'secara', 'lagi', 'butuh', 'secepatnya']","['login', 'tidak', 'butuh', 'secepatnya']",12,4,8,login tidak butuh cepat,4,4
Terlalu berat kagak ada loker,negatif,2024-06-14,2024,terlalu berat kagak ada loker,5,5,terlalu berat tidak ada loker,5,5,"['terlalu', 'berat', 'tidak', 'ada', 'loker']","['berat', 'tidak', 'loker']",5,3,2,berat tidak loker,3,3
Aplikasi sering lag,negatif,2024-07-12,2024,aplikasi sering lag,3,3,aplikasi sering lagi,3,3,"['aplikasi', 'sering', 'lagi']",['aplikasi'],3,1,2,aplikasi,1,1
"Aplikasi Bagus dan Bermanfaat Untuk Mencari Lowongan Kerja Yang Sesuai Minat,Keahlian dan Bakat Kita Masing Masing Aplikasi Ini Mudah dan Gampang Digunakkan Kalo Mengerti Cara Menggunakkan Tools Tools Yang Ada Di Aplikasi Ini Secara Baik",positif,2022-04-05,2022,aplikasi bagus dan bermanfaat untuk mencari lowongan kerja yang sesuai minat keahlian dan bakat kita masing masing aplikasi ini mudah dan gampang digunakkan kalo mengerti cara menggunakkan tools tools yang ada di aplikasi ini secara baik,35,36,aplikasi bagus dan bermanfaat untuk mencari lowongan kerja yang sesuai minat keahlian dan bakat kita masing masing aplikasi ini mudah dan gampang digunakkan kalau mengerti cara menggunakkan tools tools yang ada di aplikasi ini secara baik,36,36,"['aplikasi', 'bagus', 'dan', 'bermanfaat', 'untuk', 'mencari', 'lowongan', 'kerja', 'yang', 'sesuai', 'minat', 'keahlian', 'dan', 'bakat', 'kita', 'masing', 'masing', 'aplikasi', 'ini', 'mudah', 'dan', 'gampang', 'digunakkan', 'kalau', 'mengerti', 'cara', 'menggunakkan', 'tools', 'tools', 'yang', 'ada', 'di', 'aplikasi', 'ini', 'secara', 'baik']","['aplikasi', 'bagus', 'bermanfaat', 'mencari', 'lowongan', 'kerja', 'sesuai', 'minat', 'keahlian', 'bakat', 'aplikasi', 'mudah', 'gampang', 'digunakkan', 'mengerti', 'menggunakkan', 'tools', 'tools', 'aplikasi']",36,19,17,aplikasi bagus manfaat cari lowong kerja sesuai minat ahli bakat aplikasi mudah gampang digunakkan erti menggunakkan tools tools aplikasi,19,19
sangat membantu bagi yg membutuhkan,positif,2024-07-08,2024,sangat membantu bagi yg membutuhkan,5,5,sangat membantu bagi yang membutuhkan,5,5,"['sangat', 'membantu', 'bagi', 'yang', 'membutuhkan']","['membantu', 'membutuhkan']",5,2,3,bantu butuh,2,2
sangat senang dan berbahagialah,positif,2024-06-22,2024,sangat senang dan berbahagialah,4,4,sangat senang dan berbahagialah,4,4,"['sangat', 'senang', 'dan', 'berbahagialah']","['senang', 'berbahagialah']",4,2,2,senang bahagia,2,2
Bersyukur karena akan ada banyak kesempatan mendapatkan pengalaman baru,positif,2024-06-13,2024,bersyukur karena akan ada banyak kesempatan mendapatkan pengalaman baru,9,9,bersyukur karena akan ada banyak kesempatan mendapatkan pengalaman baru,9,9,"['bersyukur', 'karena', 'akan', 'ada', 'banyak', 'kesempatan', 'mendapatkan', 'pengalaman', 'baru']","['bersyukur', 'kesempatan', 'pengalaman']",9,3,6,syukur sempat alam,3,3
Lumayan baik aplikasinya dan fitur2 yg ditampilkan menawan,positif,2024-05-14,2024,lumayan baik aplikasinya dan fitur yg ditampilkan menawan,8,8,lumayan baik aplikasi nya dan fitur yang ditampilkan menawan,8,9,"['lumayan', 'baik', 'aplikasi', 'nya', 'dan', 'fitur', 'yang', 'ditampilkan', 'menawan']","['lumayan', 'aplikasi', 'nya', 'fitur', 'ditampilkan', 'menawan']",9,6,3,lumayan aplikasi nya fitur tampil tawan,6,6
Menarik dan membantu,positif,2024-07-14,2024,menarik dan membantu,3,3,menarik dan membantu,3,3,"['menarik', 'dan', 'membantu']","['menarik', 'membantu']",3,2,1,tarik bantu,2,2
Membuat kami mudah melar kerja,positif,2024-06-28,2024,membuat kami mudah melar kerja,5,5,membuat kami mudah melar kerja,5,5,"['membuat', 'kami', 'mudah', 'melar', 'kerja']","['mudah', 'melar', 'kerja']",5,3,2,mudah melar kerja,3,3
Assalamualaikum terima kasih atas kunjungan untuk loker,positif,2024-06-22,2024,assalamualaikum terima kasih atas kunjungan untuk loker,7,7,assalamualaikum terima kasih atas kunjungan untuk loker,7,7,"['assalamualaikum', 'terima', 'kasih', 'atas', 'kunjungan', 'untuk', 'loker']","['assalamualaikum', 'terima', 'kasih', 'kunjungan', 'loker']",7,5,2,assalamualaikum terima kasih kunjung loker,5,5
Kok ga bisa di donwload sih,negatif,2024-06-14,2024,kok ga bisa di donwload sih,6,6,kok tidak bisa di donwload sih,6,6,"['kok', 'tidak', 'bisa', 'di', 'donwload', 'sih']","['tidak', 'donwload', 'sih']",6,3,3,tidak donwload sih,3,3
"Ga jelas tb² logout sendiri,,",negatif,2024-07-06,2024,ga jelas tb² logout sendiri,5,5,tidak jelas tb² logout sendiri,5,5,"['tidak', 'jelas', 'tb²', 'logout', 'sendiri']","['tidak', 'tb²', 'logout']",5,3,2,tidak tb logout,3,3
Keren dan sangat membantu,positif,2024-08-02,2024,keren dan sangat membantu,4,4,keren dan sangat membantu,4,4,"['keren', 'dan', 'sangat', 'membantu']","['keren', 'membantu']",4,2,2,keren bantu,2,2
Verifikasi login rumit,negatif,2024-07-18,2024,verifikasi login rumit,3,3,verifikasi login rumit,3,3,"['verifikasi', 'login', 'rumit']","['verifikasi', 'login', 'rumit']",3,3,0,verifikasi login rumit,3,3
Cepat dapat informasi,positif,2024-06-20,2024,cepat dapat informasi,3,3,cepat dapat informasi,3,3,"['cepat', 'dapat', 'informasi']","['cepat', 'informasi']",3,2,1,cepat informasi,2,2
sangat baik. Mudah digunakan,negatif,2024-07-25,2024,sangat baik mudah digunakan,4,4,sangat baik mudah digunakan,4,4,"['sangat', 'baik', 'mudah', 'digunakan']",['mudah'],4,1,3,mudah,1,1
Aplikasi yang luar biasa,negatif,2024-06-27,2024,aplikasi yang luar biasa,4,4,aplikasi yang luar biasa,4,4,"['aplikasi', 'yang', 'luar', 'biasa']",['aplikasi'],4,1,3,aplikasi,1,1
Pelayanan aplikasi terburuk,negatif,2024-07-26,2024,pelayanan aplikasi terburuk,3,3,pelayanan aplikasi terburuk,3,3,"['pelayanan', 'aplikasi', 'terburuk']","['pelayanan', 'aplikasi', 'terburuk']",3,3,0,layan aplikasi buruk,3,3
Apaan coba maksa kasih identitas,negatif,2024-06-28,2024,apaan coba maksa kasih identitas,5,5,apa coba maksa kasih identitas,5,5,"['apa', 'coba', 'maksa', 'kasih', 'identitas']","['coba', 'maksa', 'kasih', 'identitas']",5,4,1,coba maksa kasih identitas,4,4
"stress berat gabisa daftar, udah coba berbagai cara",negatif,2024-03-29,2024,stress berat gabisa daftar udah coba berbagai cara,8,8,stress berat tidak bisa daftar sudah coba berbagai cara,8,9,"['stress', 'berat', 'tidak', 'bisa', 'daftar', 'sudah', 'coba', 'berbagai', 'cara']","['stress', 'berat', 'tidak', 'daftar', 'coba']",9,5,4,stress berat tidak daftar coba,5,5
"Sangat buruk, postingan saya selalu dibatasi dengan alasan komunitas profesional. Aplikasi ini sangat membela zionis.",negatif,2024-08-28,2024,sangat buruk postingan saya selalu dibatasi dengan alasan komunitas profesional aplikasi ini sangat membela zionis,15,15,sangat buruk postingan saya selalu dibatasi dengan alasan komunitas profesional aplikasi ini sangat membela zionis,15,15,"['sangat', 'buruk', 'postingan', 'saya', 'selalu', 'dibatasi', 'dengan', 'alasan', 'komunitas', 'profesional', 'aplikasi', 'ini', 'sangat', 'membela', 'zionis']","['buruk', 'postingan', 'dibatasi', 'alasan', 'komunitas', 'profesional', 'aplikasi', 'membela', 'zionis']",15,9,6,buruk postingan batas alas komunitas profesional aplikasi bela zionis,9,9
Untuk pengaturan penggunaan kamera pada saat verivikasi log in sangat harus diperbaiki lagi,negatif,2024-08-11,2024,untuk pengaturan penggunaan kamera pada saat verivikasi log in sangat harus diperbaiki lagi,13,13,untuk pengaturan penggunaan kamera pada saat verivikasi log in sangat harus di perbaiki lagi,13,14,"['untuk', 'pengaturan', 'penggunaan', 'kamera', 'pada', 'saat', 'verivikasi', 'log', 'in', 'sangat', 'harus', 'di', 'perbaiki', 'lagi']","['pengaturan', 'penggunaan', 'kamera', 'verivikasi', 'log', 'in', 'perbaiki']",14,7,7,atur guna kamera verivikasi log in baik,7,7
"Saya membayar tagihan premium yang tidak saya setujui dan tidak ada notifikasi sebelumnya, uang di Dana langsung terpotong tanpaa meminta persetujuan. Dan tidak bisa untuk meminta refund.",negatif,2024-08-10,2024,saya membayar tagihan premium yang tidak saya setujui dan tidak ada notifikasi sebelumnya uang di dana langsung terpotong tanpaa meminta persetujuan dan tidak bisa untuk meminta refund,27,27,saya membayar tagihan premium yang tidak saya setujui dan tidak ada notifikasi sebelumnya uang di dana langsung terpotong tanpaa meminta persetujuan dan tidak bisa untuk meminta refund,27,27,"['saya', 'membayar', 'tagihan', 'premium', 'yang', 'tidak', 'saya', 'setujui', 'dan', 'tidak', 'ada', 'notifikasi', 'sebelumnya', 'uang', 'di', 'dana', 'langsung', 'terpotong', 'tanpaa', 'meminta', 'persetujuan', 'dan', 'tidak', 'bisa', 'untuk', 'meminta', 'refund']","['membayar', 'tagihan', 'premium', 'tidak', 'setujui', 'tidak', 'notifikasi', 'uang', 'dana', 'langsung', 'terpotong', 'tanpaa', 'persetujuan', 'tidak', 'refund']",27,15,12,bayar tagih premium tidak tuju tidak notifikasi uang dana langsung potong tanpaa tuju tidak refund,15,15
"Banyak bug nya mau posting aja keluar aplikasi terus, GK guna saya posting 2 kali gara gara ngebug",negatif,2024-08-08,2024,banyak bug nya mau posting aja keluar aplikasi terus gk guna saya posting kali gara gara ngebug,18,17,banyak bug nya mau posting saja keluar aplikasi terus tidak guna saya posting kali gara gara nge bug,17,18,"['banyak', 'bug', 'nya', 'mau', 'posting', 'saja', 'keluar', 'aplikasi', 'terus', 'tidak', 'guna', 'saya', 'posting', 'kali', 'gara', 'gara', 'nge', 'bug']","['bug', 'nya', 'posting', 'aplikasi', 'tidak', 'posting', 'kali', 'gara', 'gara', 'nge', 'bug']",18,11,7,bug nya posting aplikasi tidak posting kali gara gara nge bug,11,11
"Salah satu aplikasi yang sangat bermanfaat untuk mendapat pekerjaan, mengupgrade portfolio dan lainnya",positif,2024-08-07,2024,salah satu aplikasi yang sangat bermanfaat untuk mendapat pekerjaan mengupgrade portfolio dan lainnya,13,13,salah satu aplikasi yang sangat bermanfaat untuk mendapat pekerjaan mengupgrade portfolio dan lainnya,13,13,"['salah', 'satu', 'aplikasi', 'yang', 'sangat', 'bermanfaat', 'untuk', 'mendapat', 'pekerjaan', 'mengupgrade', 'portfolio', 'dan', 'lainnya']","['salah', 'aplikasi', 'bermanfaat', 'pekerjaan', 'mengupgrade', 'portfolio']",13,6,7,salah aplikasi manfaat kerja mengupgrade portfolio,6,6
"Lama lama ngaco nih aplikasi, masa loker yg diminta driver direksi kok malah di pisah2, driver DT, Truk, Trailer lah terus direksi/manager nya beda lagi",negatif,2024-08-09,2024,lama lama ngaco nih aplikasi masa loker yg diminta driver direksi kok malah di pisah driver dt truk trailer lah terus direksi manager nya beda lagi,25,26,lama lama ngaco nih aplikasi masa loker yang diminta pengemudi direksi kok bahkan di pisah pengemudi dt truk trailer lah terus direksi manager nya beda lagi,26,26,"['lama', 'lama', 'ngaco', 'nih', 'aplikasi', 'masa', 'loker', 'yang', 'diminta', 'pengemudi', 'direksi', 'kok', 'bahkan', 'di', 'pisah', 'pengemudi', 'dt', 'truk', 'trailer', 'lah', 'terus', 'direksi', 'manager', 'nya', 'beda', 'lagi']","['ngaco', 'nih', 'aplikasi', 'loker', 'pengemudi', 'direksi', 'pisah', 'pengemudi', 'dt', 'truk', 'trailer', 'direksi', 'manager', 'nya', 'beda']",26,15,11,ngaco nih aplikasi loker kemudi direksi pisah kemudi dt truk trailer direksi manager nya beda,15,15
Aplikasi yang bagus untuk para pencari kerja bahkan yang sudah memiliki pekerjaan pun dapat menaruh rekam jejak mereka di aplikasi ini sehingga mempermudah penyedia pekerjaan untuk merekrut calon karyawan yang sesuai kriteria perusahaan mereka.,positif,2023-10-28,2023,aplikasi yang bagus untuk para pencari kerja bahkan yang sudah memiliki pekerjaan pun dapat menaruh rekam jejak mereka di aplikasi ini sehingga mempermudah penyedia pekerjaan untuk merekrut calon karyawan yang sesuai kriteria perusahaan mereka,34,34,aplikasi yang bagus untuk para pencari kerja bahkan yang sudah memiliki pekerjaan pun dapat menaruh rekam jejak mereka di aplikasi ini sehingga mempermudah penyedia pekerjaan untuk merekrut calon karyawan yang sesuai kriteria perusahaan mereka,34,34,"['aplikasi', 'yang', 'bagus', 'untuk', 'para', 'pencari', 'kerja', 'bahkan', 'yang', 'sudah', 'memiliki', 'pekerjaan', 'pun', 'dapat', 'menaruh', 'rekam', 'jejak', 'mereka', 'di', 'aplikasi', 'ini', 'sehingga', 'mempermudah', 'penyedia', 'pekerjaan', 'untuk', 'merekrut', 'calon', 'karyawan', 'yang', 'sesuai', 'kriteria', 'perusahaan', 'mereka']","['aplikasi', 'bagus', 'pencari', 'kerja', 'memiliki', 'pekerjaan', 'menaruh', 'rekam', 'jejak', 'aplikasi', 'mempermudah', 'penyedia', 'pekerjaan', 'merekrut', 'calon', 'karyawan', 'sesuai', 'kriteria', 'perusahaan']",34,19,15,aplikasi bagus cari kerja milik kerja taruh rekam jejak aplikasi mudah sedia kerja rekrut calon karyawan sesuai kriteria usaha,19,19
"Sudah berkali"" akun saya ke banned, tdk tau kenapa, tidak bisa login, harus membuat akun baru dan tidak menyenangkan untuk twrus berganti akun dan membuat akun gmail. Tolong perbaiki tingkat keamanan dan prikritaskan kenyamanan pengguna",negatif,2023-08-26,2023,sudah berkali akun saya ke banned tdk tau kenapa tidak bisa login harus membuat akun baru dan tidak menyenangkan untuk twrus berganti akun dan membuat akun gmail tolong perbaiki tingkat keamanan dan prikritaskan kenyamanan pengguna,35,35,sudah berkali akun saya ke banned tidak tahu kenapa tidak bisa login harus membuat akun baru dan tidak menyenangkan untuk twrus berganti akun dan membuat akun gmail tolong perbaikan tingkat keamanan dan prikritaskan kenyamanan pengguna,35,35,"['sudah', 'berkali', 'akun', 'saya', 'ke', 'banned', 'tidak', 'tahu', 'kenapa', 'tidak', 'bisa', 'login', 'harus', 'membuat', 'akun', 'baru', 'dan', 'tidak', 'menyenangkan', 'untuk', 'twrus', 'berganti', 'akun', 'dan', 'membuat', 'akun', 'gmail', 'tolong', 'perbaikan', 'tingkat', 'keamanan', 'dan', 'prikritaskan', 'kenyamanan', 'pengguna']","['berkali', 'akun', 'banned', 'tidak', 'tidak', 'login', 'akun', 'tidak', 'menyenangkan', 'twrus', 'berganti', 'akun', 'akun', 'gmail', 'tolong', 'perbaikan', 'tingkat', 'keamanan', 'prikritaskan', 'kenyamanan', 'pengguna']",35,21,14,kali akun banned tidak tidak login akun tidak senang twrus ganti akun akun gmail tolong baik tingkat aman prikritaskan nyaman guna,21,21
Blokkk loginnn susah vertifikasi mulu gk jelas nyusahin,negatif,2024-07-18,2024,blokkk loginnn susah vertifikasi mulu gk jelas nyusahin,8,8,blokkk loginnn susah vertifikasi mulu tidak jelas nyusahin,8,8,"['blokkk', 'loginnn', 'susah', 'vertifikasi', 'mulu', 'tidak', 'jelas', 'nyusahin']","['blokkk', 'loginnn', 'susah', 'vertifikasi', 'mulu', 'tidak', 'nyusahin']",8,7,1,blokkk loginnn susah vertifikasi mulu tidak nyusahin,7,7
"Susah banget teka teki nya untuk memeriksa keamanan yg sentuh gambar yg menghadap ke atas, tadi aku coba betul pas selesai malah pasword saya yg salah nggak jelas 😅😅, terus ngulang lagi",negatif,2022-06-05,2022,susah banget teka teki nya untuk memeriksa keamanan yg sentuh gambar yg menghadap ke atas tadi aku coba betul pas selesai malah pasword saya yg salah nggak jelas terus ngulang lagi,32,31,susah banget teka teki nya untuk memeriksa keamanan yang sentuh gambar yang menghadap ke atas tadi aku coba betul pas selesai bahkan pasword saya yang salah tidak jelas terus mengulang lagi,31,31,"['susah', 'banget', 'teka', 'teki', 'nya', 'untuk', 'memeriksa', 'keamanan', 'yang', 'sentuh', 'gambar', 'yang', 'menghadap', 'ke', 'atas', 'tadi', 'aku', 'coba', 'betul', 'pas', 'selesai', 'bahkan', 'pasword', 'saya', 'yang', 'salah', 'tidak', 'jelas', 'terus', 'mengulang', 'lagi']","['susah', 'banget', 'teka', 'teki', 'nya', 'memeriksa', 'keamanan', 'sentuh', 'gambar', 'menghadap', 'coba', 'pas', 'selesai', 'pasword', 'salah', 'tidak', 'mengulang']",31,17,14,susah banget teka teki nya periksa aman sentuh gambar hadap coba pas selesai pasword salah tidak ulang,17,17
"Tidal bisa login karena terus minta verifikasi, sudah di beri foto id card masih tida bisa di akses hingga berulang kali",negatif,2024-06-02,2024,tidal bisa login karena terus minta verifikasi sudah di beri foto id card masih tida bisa di akses hingga berulang kali,21,21,tidal bisa login karena terus minta verifikasi sudah di beri foto id card masih tida bisa di akses hingga berulang kali,21,21,"['tidal', 'bisa', 'login', 'karena', 'terus', 'minta', 'verifikasi', 'sudah', 'di', 'beri', 'foto', 'id', 'card', 'masih', 'tida', 'bisa', 'di', 'akses', 'hingga', 'berulang', 'kali']","['tidal', 'login', 'verifikasi', 'foto', 'id', 'card', 'tida', 'akses', 'berulang', 'kali']",21,10,11,tidal login verifikasi foto id card tida akses ulang kali,10,10
"apk loker gajelas, akun gw tbtb di batasi aneh padahal gw ga ngelanggar peraturan apapun, gaada yang aneh aneh, tp tiba tiba di batasi, padahal lagi nyari loker, apk yg sangat tidak jelas",negatif,2024-08-02,2024,apk loker gajelas akun gw tbtb di batasi aneh padahal gw ga ngelanggar peraturan apapun gaada yang aneh aneh tp tiba tiba di batasi padahal lagi nyari loker apk yg sangat tidak jelas,33,33,aplikasi loker tidak jelas akun saya tbtb di batasi aneh padahal saya tidak ngelanggar peraturan apapun tidak ada yang aneh aneh tapi tiba tiba di batasi padahal lagi mencari loker aplikasi yang sangat tidak jelas,33,35,"['aplikasi', 'loker', 'tidak', 'jelas', 'akun', 'saya', 'tbtb', 'di', 'batasi', 'aneh', 'padahal', 'saya', 'tidak', 'ngelanggar', 'peraturan', 'apapun', 'tidak', 'ada', 'yang', 'aneh', 'aneh', 'tapi', 'tiba', 'tiba', 'di', 'batasi', 'padahal', 'lagi', 'mencari', 'loker', 'aplikasi', 'yang', 'sangat', 'tidak', 'jelas']","['aplikasi', 'loker', 'tidak', 'akun', 'tbtb', 'batasi', 'aneh', 'tidak', 'ngelanggar', 'peraturan', 'apapun', 'tidak', 'aneh', 'aneh', 'batasi', 'mencari', 'loker', 'aplikasi', 'tidak']",35,19,16,aplikasi loker tidak akun tbtb batas aneh tidak ngelanggar atur apa tidak aneh aneh batas cari loker aplikasi tidak,19,19
"Kita dipaksa utk update, tp ga jelas kapan update selesainya. Mutar aja di Google Play",negatif,2024-08-10,2024,kita dipaksa utk update tp ga jelas kapan update selesainya mutar aja di google play,15,15,kita dipaksa untuk diperbarui tapi tidak jelas kapan diperbarui selesainya mutar saja di google play,15,15,"['kita', 'dipaksa', 'untuk', 'diperbarui', 'tapi', 'tidak', 'jelas', 'kapan', 'diperbarui', 'selesainya', 'mutar', 'saja', 'di', 'google', 'play']","['dipaksa', 'diperbarui', 'tidak', 'diperbarui', 'selesainya', 'mutar', 'google', 'play']",15,8,7,paksa baru tidak baru selesai mutar google play,8,8
Memudahakan saya mendapatkan seputaran informasi lowongan kerja. Kalo bsa lbh di tingkatkan kmbli ya min sllu terupdate.,positif,2024-07-15,2024,memudahakan saya mendapatkan seputaran informasi lowongan kerja kalo bsa lbh di tingkatkan kmbli ya min sllu terupdate,17,17,memudahkan saya mendapatkan seputaran informasi lowongan kerja kalau bisa lebih di tingkatkan kmbli ya minimal selalu terupdate,17,17,"['memudahkan', 'saya', 'mendapatkan', 'seputaran', 'informasi', 'lowongan', 'kerja', 'kalau', 'bisa', 'lebih', 'di', 'tingkatkan', 'kmbli', 'ya', 'minimal', 'selalu', 'terupdate']","['memudahkan', 'seputaran', 'informasi', 'lowongan', 'kerja', 'tingkatkan', 'kmbli', 'ya', 'minimal', 'terupdate']",17,10,7,mudah putar informasi lowong kerja tingkat kmbli ya minimal terupdate,10,10
Platform profesional dan belajar terbaik,positif,2024-04-17,2024,platform profesional dan belajar terbaik,5,5,platform profesional dan belajar terbaik,5,5,"['platform', 'profesional', 'dan', 'belajar', 'terbaik']","['platform', 'profesional', 'belajar', 'terbaik']",5,4,1,platform profesional ajar baik,4,4
Verivikasi nya susah amat masak iya 100 kali nyari gambar kodok menghadap ke atas salah semua Security check jangan ambigu dunk Kek dikerjain,negatif,2024-04-08,2024,verivikasi nya susah amat masak iya kali nyari gambar kodok menghadap ke atas salah semua security check jangan ambigu dunk kek dikerjain,23,22,verivikasi nya susah amat masak iya kali mencari gambar kodok menghadap ke atas salah semua security cek jangan ambigu dong seperti dikerjain,22,22,"['verivikasi', 'nya', 'susah', 'amat', 'masak', 'iya', 'kali', 'mencari', 'gambar', 'kodok', 'menghadap', 'ke', 'atas', 'salah', 'semua', 'security', 'cek', 'jangan', 'ambigu', 'dong', 'seperti', 'dikerjain']","['verivikasi', 'nya', 'susah', 'masak', 'iya', 'kali', 'mencari', 'gambar', 'kodok', 'menghadap', 'salah', 'security', 'cek', 'ambigu', 'dikerjain']",22,15,7,verivikasi nya susah masak iya kali cari gambar kodok hadap salah security cek ambigu dikerjain,15,15
Mode kreator hilang sangat mengecewakan,negatif,2024-05-12,2024,mode kreator hilang sangat mengecewakan,5,5,mode kreator hilang sangat mengecewakan,5,5,"['mode', 'kreator', 'hilang', 'sangat', 'mengecewakan']","['mode', 'kreator', 'hilang', 'mengecewakan']",5,4,1,mode kreator hilang kecewa,4,4
"Aplikasi sangat bagus,memudahkan kita untuk menghubungkan ke banyak relasi",positif,2024-04-24,2024,aplikasi sangat bagus memudahkan kita untuk menghubungkan ke banyak relasi,9,10,aplikasi sangat bagus memudahkan kita untuk menghubungkan ke banyak relasi,10,10,"['aplikasi', 'sangat', 'bagus', 'memudahkan', 'kita', 'untuk', 'menghubungkan', 'ke', 'banyak', 'relasi']","['aplikasi', 'bagus', 'memudahkan', 'menghubungkan', 'relasi']",10,5,5,aplikasi bagus mudah hubung relasi,5,5
"sebelumnya udah pernah buat account dan sudah mensetup semuanya, beberapa minggu ga dibuka tiba"" akun saya hilang",negatif,2024-06-01,2024,sebelumnya udah pernah buat account dan sudah mensetup semuanya beberapa minggu ga dibuka tiba akun saya hilang,17,17,sebelumnya sudah pernah buat akun dan sudah mensetup semuanya beberapa minggu tidak dibuka tiba akun saya hilang,17,17,"['sebelumnya', 'sudah', 'pernah', 'buat', 'akun', 'dan', 'sudah', 'mensetup', 'semuanya', 'beberapa', 'minggu', 'tidak', 'dibuka', 'tiba', 'akun', 'saya', 'hilang']","['akun', 'mensetup', 'minggu', 'tidak', 'dibuka', 'akun', 'hilang']",17,7,10,akun setup minggu tidak buka akun hilang,7,7
Kenapa ya kok saya mau melamar tapi ngak bisa2 aneh banget udah seminggu gini terus,negatif,2024-03-31,2024,kenapa ya kok saya mau melamar tapi ngak bisa aneh banget udah seminggu gini terus,15,15,kenapa ya kok saya mau melamar tapi tidak bisa aneh banget sudah seminggu begini terus,15,15,"['kenapa', 'ya', 'kok', 'saya', 'mau', 'melamar', 'tapi', 'tidak', 'bisa', 'aneh', 'banget', 'sudah', 'seminggu', 'begini', 'terus']","['ya', 'melamar', 'tidak', 'aneh', 'banget', 'seminggu']",15,6,9,ya lamar tidak aneh banget minggu,6,6
Aplikasi yang sangat membantu mencari info lowongan pekerjaan,positif,2024-05-15,2024,aplikasi yang sangat membantu mencari info lowongan pekerjaan,8,8,aplikasi yang sangat membantu mencari informasi lowongan pekerjaan,8,8,"['aplikasi', 'yang', 'sangat', 'membantu', 'mencari', 'informasi', 'lowongan', 'pekerjaan']","['aplikasi', 'membantu', 'mencari', 'informasi', 'lowongan', 'pekerjaan']",8,6,2,aplikasi bantu cari informasi lowong kerja,6,6
Untuk versi yg sekarang masih ada bug untuk verifikasi,negatif,2024-04-24,2024,untuk versi yg sekarang masih ada bug untuk verifikasi,9,9,untuk versi yang sekarang masih ada bug untuk verifikasi,9,9,"['untuk', 'versi', 'yang', 'sekarang', 'masih', 'ada', 'bug', 'untuk', 'verifikasi']","['versi', 'bug', 'verifikasi']",9,3,6,versi bug verifikasi,3,3
"Akses diblokir, tidak ada solusi sama sekali",negatif,2024-04-03,2024,akses diblokir tidak ada solusi sama sekali,7,7,akses diblokir tidak ada solusi sama sekali,7,7,"['akses', 'diblokir', 'tidak', 'ada', 'solusi', 'sama', 'sekali']","['akses', 'diblokir', 'tidak', 'solusi']",7,4,3,akses blokir tidak solusi,4,4
"Meskipun saya masih bingung sedikit, tapi saya akan belajar, karna linkdIn sangat membantu",positif,2024-05-21,2024,meskipun saya masih bingung sedikit tapi saya akan belajar karna linkdin sangat membantu,13,13,meskipun saya masih bingung sedikit tapi saya akan belajar karena linkdin sangat membantu,13,13,"['meskipun', 'saya', 'masih', 'bingung', 'sedikit', 'tapi', 'saya', 'akan', 'belajar', 'karena', 'linkdin', 'sangat', 'membantu']","['bingung', 'belajar', 'linkdin', 'membantu']",13,4,9,bingung ajar linkdin bantu,4,4
"Gabisa login kocak, verif sana sini gagal terus halaman tidak ditemukan",negatif,2024-05-23,2024,gabisa login kocak verif sana sini gagal terus halaman tidak ditemukan,11,11,tidak bisa login kocak verif sana sini gagal terus halaman tidak ditemukan,11,12,"['tidak', 'bisa', 'login', 'kocak', 'verif', 'sana', 'sini', 'gagal', 'terus', 'halaman', 'tidak', 'ditemukan']","['tidak', 'login', 'kocak', 'verif', 'gagal', 'halaman', 'tidak', 'ditemukan']",12,8,4,tidak login kocak verif gagal halaman tidak temu,8,8
"Saya sudah lebih dari 14 tahun pengguna LinkedIn, sayang dalam 1 bulan terakhir akun saya hilang dan mengalami kesulitan untuk pemulihan padahal sudah lakukan verivikasi persona dg id nasional/KTP.",negatif,2024-05-10,2024,saya sudah lebih dari tahun pengguna linkedin sayang dalam bulan terakhir akun saya hilang dan mengalami kesulitan untuk pemulihan padahal sudah lakukan verivikasi persona dg id nasional ktp,29,28,saya sudah lebih dari tahun pengguna linkedin sayang dalam bulan terakhir akun saya hilang dan mengalami kesulitan untuk pemulihan padahal sudah lakukan verivikasi persona dengan id nasional ktp,28,28,"['saya', 'sudah', 'lebih', 'dari', 'tahun', 'pengguna', 'linkedin', 'sayang', 'dalam', 'bulan', 'terakhir', 'akun', 'saya', 'hilang', 'dan', 'mengalami', 'kesulitan', 'untuk', 'pemulihan', 'padahal', 'sudah', 'lakukan', 'verivikasi', 'persona', 'dengan', 'id', 'nasional', 'ktp']","['pengguna', 'linkedin', 'sayang', 'akun', 'hilang', 'mengalami', 'kesulitan', 'pemulihan', 'lakukan', 'verivikasi', 'persona', 'id', 'nasional', 'ktp']",28,14,14,guna linkedin sayang akun hilang alami sulit pulih laku verivikasi persona id nasional ktp,14,14
Sangat mudah untuk cari kerja,positif,2024-05-06,2024,sangat mudah untuk cari kerja,5,5,sangat mudah untuk cari kerja,5,5,"['sangat', 'mudah', 'untuk', 'cari', 'kerja']","['mudah', 'cari', 'kerja']",5,3,2,mudah cari kerja,3,3
"Tidak bisa login, mantul terus",negatif,2024-05-08,2024,tidak bisa login mantul terus,5,5,tidak bisa login mantap betul terus,5,6,"['tidak', 'bisa', 'login', 'mantap', 'betul', 'terus']","['tidak', 'login', 'mantap']",6,3,3,tidak login mantap,3,3
Mencari pekerjaan menjadi lebih terarah thats awesome,positif,2024-04-21,2024,mencari pekerjaan menjadi lebih terarah thats awesome,7,7,mencari pekerjaan menjadi lebih terarah thats luar biasa,7,8,"['mencari', 'pekerjaan', 'menjadi', 'lebih', 'terarah', 'thats', 'luar', 'biasa']","['mencari', 'pekerjaan', 'terarah', 'thats']",8,4,4,cari kerja arah thats,4,4
Halo ini kenapa saya tidak bisa masuk kembali ke akun saya? Sdh berkali kali verivikasi tapi tetap tidak bisa masuk,negatif,2024-05-16,2024,halo ini kenapa saya tidak bisa masuk kembali ke akun saya sdh berkali kali verivikasi tapi tetap tidak bisa masuk,20,20,halo ini kenapa saya tidak bisa masuk kembali ke akun saya sudah berkali kali verivikasi tapi tetap tidak bisa masuk,20,20,"['halo', 'ini', 'kenapa', 'saya', 'tidak', 'bisa', 'masuk', 'kembali', 'ke', 'akun', 'saya', 'sudah', 'berkali', 'kali', 'verivikasi', 'tapi', 'tetap', 'tidak', 'bisa', 'masuk']","['halo', 'tidak', 'masuk', 'akun', 'berkali', 'kali', 'verivikasi', 'tidak', 'masuk']",20,9,11,halo tidak masuk akun kali kali verivikasi tidak masuk,9,9
Sangat baik dan saya kirim tugas juga gak lama - lama.,negatif,2024-04-22,2024,sangat baik dan saya kirim tugas juga gak lama lama,11,10,sangat baik dan saya kirim tugas juga tidak lama lama,10,10,"['sangat', 'baik', 'dan', 'saya', 'kirim', 'tugas', 'juga', 'tidak', 'lama', 'lama']","['kirim', 'tugas', 'tidak']",10,3,7,kirim tugas tidak,3,3
"Min tolong dong, akun saya infonya melanggar, saya mau login harus cek ini cek itu dan gagal terus, ini kenapa dengan akun saya? Tolong bantuannya min",negatif,2024-05-16,2024,min tolong dong akun saya infonya melanggar saya mau login harus cek ini cek itu dan gagal terus ini kenapa dengan akun saya tolong bantuannya min,26,26,minimal tolong dong akun saya informasinya melanggar saya mau login harus cek ini cek itu dan gagal terus ini kenapa dengan akun saya tolong bantuannya minimal,26,26,"['minimal', 'tolong', 'dong', 'akun', 'saya', 'informasinya', 'melanggar', 'saya', 'mau', 'login', 'harus', 'cek', 'ini', 'cek', 'itu', 'dan', 'gagal', 'terus', 'ini', 'kenapa', 'dengan', 'akun', 'saya', 'tolong', 'bantuannya', 'minimal']","['minimal', 'tolong', 'akun', 'informasinya', 'melanggar', 'login', 'cek', 'cek', 'gagal', 'akun', 'tolong', 'bantuannya', 'minimal']",26,13,13,minimal tolong akun informasi langgar login cek cek gagal akun tolong bantu minimal,13,13
Strategis di gunakan berfungsi maximal Terimakasih,positif,2024-04-20,2024,strategis di gunakan berfungsi maximal terimakasih,6,6,strategis di gunakan berfungsi maximal terima kasih,6,7,"['strategis', 'di', 'gunakan', 'berfungsi', 'maximal', 'terima', 'kasih']","['strategis', 'berfungsi', 'maximal', 'terima', 'kasih']",7,5,2,strategis fungsi maximal terima kasih,5,5
ini kenapa si jadi gada gambar nya sama sekali,negatif,2024-03-29,2024,ini kenapa si jadi gada gambar nya sama sekali,9,9,ini kenapa sih jadi tidak ada gambar nya sama sekali,9,10,"['ini', 'kenapa', 'sih', 'jadi', 'tidak', 'ada', 'gambar', 'nya', 'sama', 'sekali']","['sih', 'tidak', 'gambar', 'nya']",10,4,6,sih tidak gambar nya,4,4
Kenapa saya diminta verifikasi berulang-ulang? Saya tidak bisa masuk akun sama sekali gara² verifikasi ini,negatif,2024-05-19,2024,kenapa saya diminta verifikasi berulang ulang saya tidak bisa masuk akun sama sekali gara² verifikasi ini,15,16,kenapa saya diminta verifikasi berulang ulang saya tidak bisa masuk akun sama sekali gara² verifikasi ini,16,16,"['kenapa', 'saya', 'diminta', 'verifikasi', 'berulang', 'ulang', 'saya', 'tidak', 'bisa', 'masuk', 'akun', 'sama', 'sekali', 'gara²', 'verifikasi', 'ini']","['verifikasi', 'berulang', 'ulang', 'tidak', 'masuk', 'akun', 'gara²', 'verifikasi']",16,8,8,verifikasi ulang ulang tidak masuk akun gara verifikasi,8,8
Platform yang cocok untuk meningkatkan branding diri kita sbg profesional dalam dunia kerja,positif,2024-04-12,2024,platform yang cocok untuk meningkatkan branding diri kita sbg profesional dalam dunia kerja,13,13,platform yang cocok untuk meningkatkan branding diri kita sebagai profesional dalam dunia kerja,13,13,"['platform', 'yang', 'cocok', 'untuk', 'meningkatkan', 'branding', 'diri', 'kita', 'sebagai', 'profesional', 'dalam', 'dunia', 'kerja']","['platform', 'cocok', 'meningkatkan', 'branding', 'profesional', 'dunia', 'kerja']",13,7,6,platform cocok tingkat branding profesional dunia kerja,7,7
Mau login aja ribet cahpta tidak valid padahal udah bener,negatif,2024-03-23,2024,mau login aja ribet cahpta tidak valid padahal udah bener,10,10,mau login saja rumit cahpta tidak valid padahal sudah benar,10,10,"['mau', 'login', 'saja', 'rumit', 'cahpta', 'tidak', 'valid', 'padahal', 'sudah', 'benar']","['login', 'rumit', 'cahpta', 'tidak', 'valid']",10,5,5,login rumit cahpta tidak valid,5,5
Kecewa udah 2 kali buat akun 2 kali jg harus verifikasi dan slalu gagal padahal sandi yg d isi udah benar tpi masih aja d bilang salah mana harus ambil foto muka dan foto KTP,negatif,2024-05-25,2024,kecewa udah kali buat akun kali jg harus verifikasi dan slalu gagal padahal sandi yg d isi udah benar tpi masih aja d bilang salah mana harus ambil foto muka dan foto ktp,35,33,kecewa sudah kali buat akun kali juga harus verifikasi dan selalu gagal padahal sandi yang di isi sudah benar tetapi masih saja di bilang salah mana harus ambil foto muka dan foto ktp,33,33,"['kecewa', 'sudah', 'kali', 'buat', 'akun', 'kali', 'juga', 'harus', 'verifikasi', 'dan', 'selalu', 'gagal', 'padahal', 'sandi', 'yang', 'di', 'isi', 'sudah', 'benar', 'tetapi', 'masih', 'saja', 'di', 'bilang', 'salah', 'mana', 'harus', 'ambil', 'foto', 'muka', 'dan', 'foto', 'ktp']","['kecewa', 'kali', 'akun', 'kali', 'verifikasi', 'gagal', 'sandi', 'isi', 'bilang', 'salah', 'ambil', 'foto', 'muka', 'foto', 'ktp']",33,15,18,kecewa kali akun kali verifikasi gagal sandi isi bilang salah ambil foto muka foto ktp,15,15
Saya belum pernah menggunakan applikasi ini hingga saat ini tapi tidak apa-apa saya tetap mensupport applikasi anda lebih maju dan modern...,negatif,2024-05-05,2024,saya belum pernah menggunakan applikasi ini hingga saat ini tapi tidak apa apa saya tetap mensupport applikasi anda lebih maju dan modern,21,22,saya belum pernah menggunakan aplikasi ini hingga saat ini tapi tidak apa apa saya tetap mensupport aplikasi anda lebih maju dan modern,22,22,"['saya', 'belum', 'pernah', 'menggunakan', 'aplikasi', 'ini', 'hingga', 'saat', 'ini', 'tapi', 'tidak', 'apa', 'apa', 'saya', 'tetap', 'mensupport', 'aplikasi', 'anda', 'lebih', 'maju', 'dan', 'modern']","['aplikasi', 'tidak', 'mensupport', 'aplikasi', 'maju', 'modern']",22,6,16,aplikasi tidak mensupport aplikasi maju modern,6,6
mau log in terlalu sulit verifikasi,negatif,2024-05-25,2024,mau log in terlalu sulit verifikasi,6,6,mau log in terlalu sulit verifikasi,6,6,"['mau', 'log', 'in', 'terlalu', 'sulit', 'verifikasi']","['log', 'in', 'sulit', 'verifikasi']",6,4,2,log in sulit verifikasi,4,4
Ini kenapa saya mau ganti email suka error.,negatif,2024-05-24,2024,ini kenapa saya mau ganti email suka error,8,8,ini kenapa saya mau ganti email suka error,8,8,"['ini', 'kenapa', 'saya', 'mau', 'ganti', 'email', 'suka', 'error']","['ganti', 'email', 'suka', 'error']",8,4,4,ganti email suka error,4,4
Aplikasi kurang memuaskan dalam mencari kerjaan,negatif,2024-05-27,2024,aplikasi kurang memuaskan dalam mencari kerjaan,6,6,aplikasi kurang memuaskan dalam mencari kerjaan,6,6,"['aplikasi', 'kurang', 'memuaskan', 'dalam', 'mencari', 'kerjaan']","['aplikasi', 'memuaskan', 'mencari', 'kerjaan']",6,4,2,aplikasi muas cari kerja,4,4
"Aplikasi sampahhhhh, akun tiba"" hilang. Tolollll",negatif,2024-05-27,2024,aplikasi sampahhhhh akun tiba hilang tolollll,6,6,aplikasi sampahhhhh akun tiba hilang tolollll,6,6,"['aplikasi', 'sampahhhhh', 'akun', 'tiba', 'hilang', 'tolollll']","['aplikasi', 'sampahhhhh', 'akun', 'hilang', 'tolollll']",6,5,1,aplikasi sampahhhhh akun hilang tolollll,5,5
end frontier.. sdh 8 hari aplikasi linkedin tdk bisa akses.. bbrp kali coba update..gagal juga.. uninstall dan re install juga sdh dicoba.. mungkin mobilephone saya sdh tdk support lagi..,negatif,2020-12-25,2020,end frontier sdh hari aplikasi linkedin tdk bisa akses bbrp kali coba update gagal juga uninstall dan re install juga sdh dicoba mungkin mobilephone saya sdh tdk support lagi,29,29,end frontier sudah hari aplikasi linkedin tidak bisa akses beberapa kali coba diperbarui gagal juga uninstall dan re install juga sudah dicoba mungkin mobilephone saya sudah tidak support lagi,29,29,"['end', 'frontier', 'sudah', 'hari', 'aplikasi', 'linkedin', 'tidak', 'bisa', 'akses', 'beberapa', 'kali', 'coba', 'diperbarui', 'gagal', 'juga', 'uninstall', 'dan', 're', 'install', 'juga', 'sudah', 'dicoba', 'mungkin', 'mobilephone', 'saya', 'sudah', 'tidak', 'support', 'lagi']","['end', 'frontier', 'aplikasi', 'linkedin', 'tidak', 'akses', 'kali', 'coba', 'diperbarui', 'gagal', 'uninstall', 're', 'install', 'dicoba', 'mobilephone', 'tidak', 'support']",29,17,12,end frontier aplikasi linkedin tidak akses kali coba baru gagal uninstall re install coba mobilephone tidak support,17,17
"Kalo memang membantu beri yang termudah .jgn dibuat ribet segala lewatin tebak gambar ..berapa kali sudah coba gagal terus ... Manusia punya otak juga , tapi soal kerja bukan dengan itu untuk menekan kita manusia yg berproduktif ... Kecewaaa Linkedln",negatif,2022-05-27,2022,kalo memang membantu beri yang termudah jgn dibuat ribet segala lewatin tebak gambar berapa kali sudah coba gagal terus manusia punya otak juga tapi soal kerja bukan dengan itu untuk menekan kita manusia yg berproduktif kecewaaa linkedln,40,37,kalau memang membantu beri yang termudah jangan dibuat rumit segala lewatin tebak gambar berapa kali sudah coba gagal terus manusia punya otak juga tapi soal kerja bukan dengan itu untuk menekan kita manusia yang berproduktif kecewaaa linkedln,37,37,"['kalau', 'memang', 'membantu', 'beri', 'yang', 'termudah', 'jangan', 'dibuat', 'rumit', 'segala', 'lewatin', 'tebak', 'gambar', 'berapa', 'kali', 'sudah', 'coba', 'gagal', 'terus', 'manusia', 'punya', 'otak', 'juga', 'tapi', 'soal', 'kerja', 'bukan', 'dengan', 'itu', 'untuk', 'menekan', 'kita', 'manusia', 'yang', 'berproduktif', 'kecewaaa', 'linkedln']","['membantu', 'termudah', 'rumit', 'lewatin', 'tebak', 'gambar', 'kali', 'coba', 'gagal', 'manusia', 'otak', 'kerja', 'menekan', 'manusia', 'berproduktif', 'kecewaaa', 'linkedln']",37,17,20,bantu mudah rumit lewatin tebak gambar kali coba gagal manusia otak kerja tekan manusia produktif kecewaaa linkedln,17,17
"Aplikaso yng sangat berguna, dari sini ketemu temen baru dan pekerjaan baru",positif,2024-05-09,2024,aplikaso yng sangat berguna dari sini ketemu temen baru dan pekerjaan baru,12,12,aplikaso yng sangat berguna dari sini ketemu teman baru dan pekerjaan baru,12,12,"['aplikaso', 'yng', 'sangat', 'berguna', 'dari', 'sini', 'ketemu', 'teman', 'baru', 'dan', 'pekerjaan', 'baru']","['aplikaso', 'yng', 'berguna', 'ketemu', 'teman', 'pekerjaan']",12,6,6,aplikaso yng guna ketemu teman kerja,6,6
"Di update juga percuma, app nya masih sangat berat untuk di buka selalu bug...entah lah, Kuota masih penuh internet di daerah saya lumayan bagus, tolong pengembang app nya di perbaiki",negatif,2021-10-05,2021,di update juga percuma app nya masih sangat berat untuk di buka selalu bug entah lah kuota masih penuh internet di daerah saya lumayan bagus tolong pengembang app nya di perbaiki,30,31,di diperbarui juga percuma aplikasi nya masih sangat berat untuk di buka selalu bug entah lah kuota masih penuh internet di daerah saya lumayan bagus tolong pengembang aplikasi nya di perbaikan,31,31,"['di', 'diperbarui', 'juga', 'percuma', 'aplikasi', 'nya', 'masih', 'sangat', 'berat', 'untuk', 'di', 'buka', 'selalu', 'bug', 'entah', 'lah', 'kuota', 'masih', 'penuh', 'internet', 'di', 'daerah', 'saya', 'lumayan', 'bagus', 'tolong', 'pengembang', 'aplikasi', 'nya', 'di', 'perbaikan']","['diperbarui', 'aplikasi', 'nya', 'berat', 'buka', 'bug', 'kuota', 'penuh', 'internet', 'daerah', 'lumayan', 'bagus', 'tolong', 'pengembang', 'aplikasi', 'nya', 'perbaikan']",31,17,14,baru aplikasi nya berat buka bug kuota penuh internet daerah lumayan bagus tolong kembang aplikasi nya baik,17,17
Sosial media yang bersifat professional,positif,2024-08-28,2024,sosial media yang bersifat professional,5,5,sosial media yang bersifat professional,5,5,"['sosial', 'media', 'yang', 'bersifat', 'professional']","['sosial', 'media', 'bersifat', 'professional']",5,4,1,sosial media sifat professional,4,4
Tolol verifikasi Mulu Ampe habis baterai,negatif,2024-06-12,2024,tolol verifikasi mulu ampe habis baterai,6,6,tolol verifikasi mulu sampai habis baterai,6,6,"['tolol', 'verifikasi', 'mulu', 'sampai', 'habis', 'baterai']","['tolol', 'verifikasi', 'mulu', 'habis', 'baterai']",6,5,1,tolol verifikasi mulu habis baterai,5,5
"Verifikasi nebak gambar pas sampai step terakhirnya selalu salah terus, udh dicoba berkali2 selalu di step terakhir yg gagal. Gak rekomendasi aplikasinya. KECEWA",negatif,2022-01-26,2022,verifikasi nebak gambar pas sampai step terakhirnya selalu salah terus udh dicoba berkali selalu di step terakhir yg gagal gak rekomendasi aplikasinya kecewa,23,23,verifikasi nebak gambar pas sampai step terakhirnya selalu salah terus sudah dicoba berkali selalu di step terakhir yang gagal tidak rekomendasi aplikasi nya kecewa,23,24,"['verifikasi', 'nebak', 'gambar', 'pas', 'sampai', 'step', 'terakhirnya', 'selalu', 'salah', 'terus', 'sudah', 'dicoba', 'berkali', 'selalu', 'di', 'step', 'terakhir', 'yang', 'gagal', 'tidak', 'rekomendasi', 'aplikasi', 'nya', 'kecewa']","['verifikasi', 'nebak', 'gambar', 'pas', 'step', 'terakhirnya', 'salah', 'dicoba', 'berkali', 'step', 'gagal', 'tidak', 'rekomendasi', 'aplikasi', 'nya', 'kecewa']",24,16,8,verifikasi nebak gambar pas step akhir salah coba kali step gagal tidak rekomendasi aplikasi nya kecewa,16,16
"tiba-tiba akun ke log out sendiri, login lagi suruh verifikasi bolak-balik diputer-puterin. kesel!!!!",negatif,2024-07-14,2024,tiba tiba akun ke log out sendiri login lagi suruh verifikasi bolak balik diputer puterin kesel,13,16,tiba tiba akun ke log out sendiri login lagi suruh verifikasi bolak balik diputer puterin kesel,16,16,"['tiba', 'tiba', 'akun', 'ke', 'log', 'out', 'sendiri', 'login', 'lagi', 'suruh', 'verifikasi', 'bolak', 'balik', 'diputer', 'puterin', 'kesel']","['akun', 'log', 'out', 'login', 'suruh', 'verifikasi', 'bolak', 'diputer', 'puterin', 'kesel']",16,10,6,akun log out login suruh verifikasi bolak puter puterin kesel,10,10
Login harus pake teka teki..udah dijawab bener selalu disalahin,negatif,2024-03-27,2024,login harus pake teka teki udah dijawab bener selalu disalahin,9,10,login harus pakai teka teki sudah dijawab benar selalu disalahin,10,10,"['login', 'harus', 'pakai', 'teka', 'teki', 'sudah', 'dijawab', 'benar', 'selalu', 'disalahin']","['login', 'pakai', 'teka', 'teki', 'disalahin']",10,5,5,login pakai teka teki disalahin,5,5
"Aplikasi yang luar biasa. Aplikasi yang dapat membawa Anda go internasional, go world wide hanya dalam beberapa saat. Luar biasa!",positif,2021-10-22,2021,aplikasi yang luar biasa aplikasi yang dapat membawa anda go internasional go world wide hanya dalam beberapa saat luar biasa,20,20,aplikasi yang luar biasa aplikasi yang dapat membawa anda go internasional go world wide hanya dalam beberapa saat luar biasa,20,20,"['aplikasi', 'yang', 'luar', 'biasa', 'aplikasi', 'yang', 'dapat', 'membawa', 'anda', 'go', 'internasional', 'go', 'world', 'wide', 'hanya', 'dalam', 'beberapa', 'saat', 'luar', 'biasa']","['aplikasi', 'aplikasi', 'membawa', 'go', 'internasional', 'go', 'world', 'wide']",20,8,12,aplikasi aplikasi bawa go internasional go world wide,8,8
"Udah kode captchanya gagal terus, masuk juga tida bisa. Parah tolong diperbaiki masalah loginnya. Belum aja lamar kerja yang sulit, masuk aplikasi ini udah sulit duluan.",negatif,2022-05-23,2022,udah kode captchanya gagal terus masuk juga tida bisa parah tolong diperbaiki masalah loginnya belum aja lamar kerja yang sulit masuk aplikasi ini udah sulit duluan,26,26,sudah kode captchanya gagal terus masuk juga tida bisa parah tolong di perbaiki masalah loginnya belum saja lamar kerja yang sulit masuk aplikasi ini sudah sulit duluan,26,27,"['sudah', 'kode', 'captchanya', 'gagal', 'terus', 'masuk', 'juga', 'tida', 'bisa', 'parah', 'tolong', 'di', 'perbaiki', 'masalah', 'loginnya', 'belum', 'saja', 'lamar', 'kerja', 'yang', 'sulit', 'masuk', 'aplikasi', 'ini', 'sudah', 'sulit', 'duluan']","['kode', 'captchanya', 'gagal', 'masuk', 'tida', 'parah', 'tolong', 'perbaiki', 'loginnya', 'lamar', 'kerja', 'sulit', 'masuk', 'aplikasi', 'sulit', 'duluan']",27,16,11,kode captchanya gagal masuk tida parah tolong baik loginnya lamar kerja sulit masuk aplikasi sulit duluan,16,16
"Tolong lebih selektif lagi dalam merekomendasikan pekerjaan terutama iklan dari j*oble, memang selektif dalam memilih pekerjaan adalah tanggung jawab pribadi. Tapi, ada jobseeker/pemula yang percaya dengan keaslian loker di linkedin sehingga tidak melakukan pengechekan dulu terhadap latar belakang perusahaan dan akhirnya tertipu. Tolong jaga kepercayaan kami saat melamar melalui Linkedin.",negatif,2021-12-15,2021,tolong lebih selektif lagi dalam merekomendasikan pekerjaan terutama iklan dari j oble memang selektif dalam memilih pekerjaan adalah tanggung jawab pribadi tapi ada jobseeker pemula yang percaya dengan keaslian loker di linkedin sehingga tidak melakukan pengechekan dulu terhadap latar belakang perusahaan dan akhirnya tertipu tolong jaga kepercayaan kami saat melamar melalui linkedin,50,52,tolong lebih selektif lagi dalam merekomendasikan pekerjaan terutama iklan dari j oble memang selektif dalam memilih pekerjaan adalah tanggung jawab pribadi tapi ada jobseeker pemula yang percaya dengan keaslian loker di linkedin sehingga tidak melakukan pengechekan dahulu terhadap latar belakang perusahaan dan akhirnya tertipu tolong jaga kepercayaan kami saat melamar melalui linkedin,52,52,"['tolong', 'lebih', 'selektif', 'lagi', 'dalam', 'merekomendasikan', 'pekerjaan', 'terutama', 'iklan', 'dari', 'j', 'oble', 'memang', 'selektif', 'dalam', 'memilih', 'pekerjaan', 'adalah', 'tanggung', 'jawab', 'pribadi', 'tapi', 'ada', 'jobseeker', 'pemula', 'yang', 'percaya', 'dengan', 'keaslian', 'loker', 'di', 'linkedin', 'sehingga', 'tidak', 'melakukan', 'pengechekan', 'dahulu', 'terhadap', 'latar', 'belakang', 'perusahaan', 'dan', 'akhirnya', 'tertipu', 'tolong', 'jaga', 'kepercayaan', 'kami', 'saat', 'melamar', 'melalui', 'linkedin']","['tolong', 'selektif', 'merekomendasikan', 'pekerjaan', 'iklan', 'j', 'oble', 'selektif', 'memilih', 'pekerjaan', 'tanggung', 'pribadi', 'jobseeker', 'pemula', 'percaya', 'keaslian', 'loker', 'linkedin', 'tidak', 'pengechekan', 'latar', 'perusahaan', 'tertipu', 'tolong', 'jaga', 'kepercayaan', 'melamar', 'linkedin']",52,28,24,tolong selektif rekomendasi kerja iklan j oble selektif pilih kerja tanggung pribadi jobseeker mula percaya asli loker linkedin tidak pengechekan latar usaha tipu tolong jaga percaya lamar linkedin,28,28
"Aplikasi ini kebanyakan diisi oleh org2 yg bergaya, berlagak seperti sultan, spt ahli dlm suatu bidang usaha dll, hanyalah postingan2 ucapan selamat, motifasi yg pada knyataannya pemberi motifasinya juga perlu motifasi, hanya omongan2 tinggi, yg memperlihatkan kelebihan2 mereka, yg kenyataannya trbalik, info2 HOAX,",negatif,2021-06-03,2021,aplikasi ini kebanyakan diisi oleh org yg bergaya berlagak seperti sultan spt ahli dlm suatu bidang usaha dll hanyalah postingan ucapan selamat motifasi yg pada knyataannya pemberi motifasinya juga perlu motifasi hanya omongan tinggi yg memperlihatkan kelebihan mereka yg kenyataannya trbalik info hoax,43,43,aplikasi ini kebanyakan diisi oleh orang yang bergaya berlagak seperti sultan seperti ahli dalam suatu bidang usaha dan lain lain hanyalah postingan ucapan selamat motifasi yang pada knyataannya pemberi motifasinya juga perlu motifasi hanya omongan tinggi yang memperlihatkan kelebihan mereka yang kenyataannya trbalik informasi isu bohong,43,46,"['aplikasi', 'ini', 'kebanyakan', 'diisi', 'oleh', 'orang', 'yang', 'bergaya', 'berlagak', 'seperti', 'sultan', 'seperti', 'ahli', 'dalam', 'suatu', 'bidang', 'usaha', 'dan', 'lain', 'lain', 'hanyalah', 'postingan', 'ucapan', 'selamat', 'motifasi', 'yang', 'pada', 'knyataannya', 'pemberi', 'motifasinya', 'juga', 'perlu', 'motifasi', 'hanya', 'omongan', 'tinggi', 'yang', 'memperlihatkan', 'kelebihan', 'mereka', 'yang', 'kenyataannya', 'trbalik', 'informasi', 'isu', 'bohong']","['aplikasi', 'kebanyakan', 'diisi', 'orang', 'bergaya', 'berlagak', 'sultan', 'ahli', 'bidang', 'usaha', 'postingan', 'ucapan', 'selamat', 'motifasi', 'knyataannya', 'pemberi', 'motifasinya', 'motifasi', 'omongan', 'kelebihan', 'kenyataannya', 'trbalik', 'informasi', 'isu', 'bohong']",46,25,21,aplikasi banyak isi orang gaya lagak sultan ahli bidang usaha postingan ucap selamat motifasi knyataannya beri motifasinya motifasi omong lebih nyata trbalik informasi isu bohong,25,25
Aplikasi kocak login aja payah nebak gambar udah bener malah disalahin,negatif,2024-06-09,2024,aplikasi kocak login aja payah nebak gambar udah bener malah disalahin,11,11,aplikasi kocak login saja payah nebak gambar sudah benar bahkan disalahin,11,11,"['aplikasi', 'kocak', 'login', 'saja', 'payah', 'nebak', 'gambar', 'sudah', 'benar', 'bahkan', 'disalahin']","['aplikasi', 'kocak', 'login', 'payah', 'nebak', 'gambar', 'disalahin']",11,7,4,aplikasi kocak login payah nebak gambar disalahin,7,7
"Setelah pengikut banyak. Tidak beli paket, jadi tidak bisa masuk. Hanya previkasi terus dan terus . Tak adahasil",negatif,2024-07-22,2024,setelah pengikut banyak tidak beli paket jadi tidak bisa masuk hanya previkasi terus dan terus tak adahasil,18,17,setelah pengikut banyak tidak beli paket jadi tidak bisa masuk hanya previkasi terus dan terus tidak adahasil,17,17,"['setelah', 'pengikut', 'banyak', 'tidak', 'beli', 'paket', 'jadi', 'tidak', 'bisa', 'masuk', 'hanya', 'previkasi', 'terus', 'dan', 'terus', 'tidak', 'adahasil']","['pengikut', 'tidak', 'beli', 'paket', 'tidak', 'masuk', 'previkasi', 'tidak', 'adahasil']",17,9,8,ikut tidak beli paket tidak masuk previkasi tidak adahasil,9,9
"kenapa setiap kali saya masuk tidak bisa...padahal email dan password sudah benar??? kenapa harus minta verifikasi bahwa saya manusia???padahal email dan password sudah benar,huffffftttt",negatif,2022-08-02,2022,kenapa setiap kali saya masuk tidak bisa padahal email dan password sudah benar kenapa harus minta verifikasi bahwa saya manusia padahal email dan password sudah benar huffffftttt,24,27,kenapa setiap kali saya masuk tidak bisa padahal email dan password sudah benar kenapa harus minta verifikasi bahwa saya manusia padahal email dan password sudah benar huffffftttt,27,27,"['kenapa', 'setiap', 'kali', 'saya', 'masuk', 'tidak', 'bisa', 'padahal', 'email', 'dan', 'password', 'sudah', 'benar', 'kenapa', 'harus', 'minta', 'verifikasi', 'bahwa', 'saya', 'manusia', 'padahal', 'email', 'dan', 'password', 'sudah', 'benar', 'huffffftttt']","['kali', 'masuk', 'tidak', 'email', 'password', 'verifikasi', 'manusia', 'email', 'password', 'huffffftttt']",27,10,17,kali masuk tidak email password verifikasi manusia email password huffffftttt,10,10
"ganti hp, pas login ulang linkedin emailnya ga ada yg terhubung aneh bgt jadi gabisa login/ganti password",negatif,2024-07-17,2024,ganti hp pas login ulang linkedin emailnya ga ada yg terhubung aneh bgt jadi gabisa login ganti password,17,18,ganti handphone pas login ulang linkedin emailnya tidak ada yang terhubung aneh banget jadi tidak bisa login ganti password,18,19,"['ganti', 'handphone', 'pas', 'login', 'ulang', 'linkedin', 'emailnya', 'tidak', 'ada', 'yang', 'terhubung', 'aneh', 'banget', 'jadi', 'tidak', 'bisa', 'login', 'ganti', 'password']","['ganti', 'handphone', 'pas', 'login', 'ulang', 'linkedin', 'emailnya', 'tidak', 'terhubung', 'aneh', 'banget', 'tidak', 'login', 'ganti', 'password']",19,15,4,ganti handphone pas login ulang linkedin email tidak hubung aneh banget tidak login ganti password,15,15
"Sangat Bagus ,utk memcari lapangan kerja dan sangat memuaskan",positif,2024-07-07,2024,sangat bagus utk memcari lapangan kerja dan sangat memuaskan,9,9,sangat bagus untuk memcari lapangan kerja dan sangat memuaskan,9,9,"['sangat', 'bagus', 'untuk', 'memcari', 'lapangan', 'kerja', 'dan', 'sangat', 'memuaskan']","['bagus', 'memcari', 'lapangan', 'kerja', 'memuaskan']",9,5,4,bagus memcari lapang kerja muas,5,5
"Akun saya tiba2 disuruh login ulang dan itu ribet banget, tolong deh jgn dipersulit.",negatif,2024-06-07,2024,akun saya tiba disuruh login ulang dan itu ribet banget tolong deh jgn dipersulit,14,14,akun saya tiba disuruh login ulang dan itu rumit banget tolong deh jangan dipersulit,14,14,"['akun', 'saya', 'tiba', 'disuruh', 'login', 'ulang', 'dan', 'itu', 'rumit', 'banget', 'tolong', 'deh', 'jangan', 'dipersulit']","['akun', 'disuruh', 'login', 'ulang', 'rumit', 'banget', 'tolong', 'deh', 'dipersulit']",14,9,5,akun suruh login ulang rumit banget tolong deh sulit,9,9
Salam sehat semuanya... Sangat membantu pemula yang ingin memulai belajar Terimakasih,positif,2024-06-28,2024,salam sehat semuanya sangat membantu pemula yang ingin memulai belajar terimakasih,11,11,salam sehat semuanya sangat membantu pemula yang ingin memulai belajar terima kasih,11,12,"['salam', 'sehat', 'semuanya', 'sangat', 'membantu', 'pemula', 'yang', 'ingin', 'memulai', 'belajar', 'terima', 'kasih']","['salam', 'sehat', 'membantu', 'pemula', 'belajar', 'terima', 'kasih']",12,7,5,salam sehat bantu mula ajar terima kasih,7,7
Sudah cukup bagus dan sangat membantu saya dalam memperoleh informasi sesuai dgn kebutuhan dan keahlian kami,positif,2024-06-07,2024,sudah cukup bagus dan sangat membantu saya dalam memperoleh informasi sesuai dgn kebutuhan dan keahlian kami,16,16,sudah cukup bagus dan sangat membantu saya dalam memperoleh informasi sesuai dengan kebutuhan dan keahlian kami,16,16,"['sudah', 'cukup', 'bagus', 'dan', 'sangat', 'membantu', 'saya', 'dalam', 'memperoleh', 'informasi', 'sesuai', 'dengan', 'kebutuhan', 'dan', 'keahlian', 'kami']","['bagus', 'membantu', 'memperoleh', 'informasi', 'sesuai', 'kebutuhan', 'keahlian']",16,7,9,bagus bantu oleh informasi sesuai butuh ahli,7,7
Apk buruk ini cuma mau ambil data kita aja verifikasi muter sana muter sini data dah masuk verifikasi selalu gagal dan saya ulang lagi 3x ada peringatan anda tidak dapat menggunakan nomer ini karena sudah di pakai pengguna lain Lah???? Kan yang gunain gue blok,negatif,2024-07-15,2024,apk buruk ini cuma mau ambil data kita aja verifikasi muter sana muter sini data dah masuk verifikasi selalu gagal dan saya ulang lagi x ada peringatan anda tidak dapat menggunakan nomer ini karena sudah di pakai pengguna lain lah kan yang gunain gue blok,45,45,aplikasi buruk ini cuma mau ambil data kita saja verifikasi memutar sana memutar sini data sudah masuk verifikasi selalu gagal dan saya ulang lagi x ada peringatan anda tidak dapat menggunakan nomor ini karena sudah di pakai pengguna lain lah akan yang guna in saya blok,45,46,"['aplikasi', 'buruk', 'ini', 'cuma', 'mau', 'ambil', 'data', 'kita', 'saja', 'verifikasi', 'memutar', 'sana', 'memutar', 'sini', 'data', 'sudah', 'masuk', 'verifikasi', 'selalu', 'gagal', 'dan', 'saya', 'ulang', 'lagi', 'x', 'ada', 'peringatan', 'anda', 'tidak', 'dapat', 'menggunakan', 'nomor', 'ini', 'karena', 'sudah', 'di', 'pakai', 'pengguna', 'lain', 'lah', 'akan', 'yang', 'guna', 'in', 'saya', 'blok']","['aplikasi', 'buruk', 'ambil', 'data', 'verifikasi', 'memutar', 'memutar', 'data', 'masuk', 'verifikasi', 'gagal', 'ulang', 'x', 'peringatan', 'tidak', 'nomor', 'pakai', 'pengguna', 'in', 'blok']",46,20,26,aplikasi buruk ambil data verifikasi putar putar data masuk verifikasi gagal ulang x ingat tidak nomor pakai guna in blok,20,20
Login ini apps seperti pinjol aja ... Foto selfie dg KTP ... Gak lama di salah gunakan buat pinjol nih,negatif,2024-07-30,2024,login ini apps seperti pinjol aja foto selfie dg ktp gak lama di salah gunakan buat pinjol nih,20,18,login ini aplikasi seperti pinjol saja foto selfie dengan ktp tidak lama di salah gunakan buat pinjol nih,18,18,"['login', 'ini', 'aplikasi', 'seperti', 'pinjol', 'saja', 'foto', 'selfie', 'dengan', 'ktp', 'tidak', 'lama', 'di', 'salah', 'gunakan', 'buat', 'pinjol', 'nih']","['login', 'aplikasi', 'pinjol', 'foto', 'selfie', 'ktp', 'tidak', 'salah', 'pinjol', 'nih']",18,10,8,login aplikasi pinjol foto selfie ktp tidak salah pinjol nih,10,10
"login aja ribet verifikasi dimna mna, udah jelas"" sesuai data",negatif,2024-03-28,2024,login aja ribet verifikasi dimna mna udah jelas sesuai data,10,10,login saja rumit verifikasi dimana mana sudah jelas sesuai data,10,10,"['login', 'saja', 'rumit', 'verifikasi', 'dimana', 'mana', 'sudah', 'jelas', 'sesuai', 'data']","['login', 'rumit', 'verifikasi', 'dimana', 'sesuai', 'data']",10,6,4,login rumit verifikasi mana sesuai data,6,6
"Pakai linkedln premium gratis sebulan ....ga ada pemberitahuan, ee tiba2 ada dana terpotong dari account saya, bukan nya ada pemberitahuan lewat email sebelum kita harus membeli linkedln premium..?? Parah.. Hati2",negatif,2022-11-12,2022,pakai linkedln premium gratis sebulan ga ada pemberitahuan ee tiba ada dana terpotong dari account saya bukan nya ada pemberitahuan lewat email sebelum kita harus membeli linkedln premium parah hati,30,30,pakai linkedln premium gratis sebulan tidak ada pemberitahuan eh tiba ada dana terpotong dari akun saya bukan nya ada pemberitahuan lewat email sebelum kita harus membeli linkedln premium parah hati,30,30,"['pakai', 'linkedln', 'premium', 'gratis', 'sebulan', 'tidak', 'ada', 'pemberitahuan', 'eh', 'tiba', 'ada', 'dana', 'terpotong', 'dari', 'akun', 'saya', 'bukan', 'nya', 'ada', 'pemberitahuan', 'lewat', 'email', 'sebelum', 'kita', 'harus', 'membeli', 'linkedln', 'premium', 'parah', 'hati']","['pakai', 'linkedln', 'premium', 'gratis', 'sebulan', 'tidak', 'pemberitahuan', 'eh', 'dana', 'terpotong', 'akun', 'nya', 'pemberitahuan', 'email', 'membeli', 'linkedln', 'premium', 'parah', 'hati']",30,19,11,pakai linkedln premium gratis bulan tidak pemberitahuan eh dana potong akun nya pemberitahuan email beli linkedln premium parah hati,19,19
apsih ini nongoll mulu iklan nya mending yg iklanin enak di pandang minimal rambutnya di benerin keramas biar ga lepek bikin sakit mata aja tiap detik nongol bikin sakit mata ck,negatif,2024-06-27,2024,apsih ini nongoll mulu iklan nya mending yg iklanin enak di pandang minimal rambutnya di benerin keramas biar ga lepek bikin sakit mata aja tiap detik nongol bikin sakit mata ck,31,31,apsih ini nongoll mulu iklan nya mending yang iklanin enak di pandang minimal rambutnya di benerin keramas biar tidak lepek bikin sakit mata saja tiap detik nongol bikin sakit mata ck,31,31,"['apsih', 'ini', 'nongoll', 'mulu', 'iklan', 'nya', 'mending', 'yang', 'iklanin', 'enak', 'di', 'pandang', 'minimal', 'rambutnya', 'di', 'benerin', 'keramas', 'biar', 'tidak', 'lepek', 'bikin', 'sakit', 'mata', 'saja', 'tiap', 'detik', 'nongol', 'bikin', 'sakit', 'mata', 'ck']","['apsih', 'nongoll', 'mulu', 'iklan', 'nya', 'mending', 'iklanin', 'enak', 'pandang', 'minimal', 'rambutnya', 'benerin', 'keramas', 'biar', 'tidak', 'lepek', 'bikin', 'sakit', 'mata', 'detik', 'nongol', 'bikin', 'sakit', 'mata', 'ck']",31,25,6,apsih nongoll mulu iklan nya mending iklanin enak pandang minimal rambut benerin keramas biar tidak lepek bikin sakit mata detik nongol bikin sakit mata ck,25,25
"Masuk nya susah, verifikasi terus. Udah berhasil balik lagi verifikasi.. 4 jam cuman verifikasi",negatif,2024-06-06,2024,masuk nya susah verifikasi terus udah berhasil balik lagi verifikasi jam cuman verifikasi,14,13,masuk nya susah verifikasi terus sudah berhasil balik lagi verifikasi jam cuman verifikasi,13,13,"['masuk', 'nya', 'susah', 'verifikasi', 'terus', 'sudah', 'berhasil', 'balik', 'lagi', 'verifikasi', 'jam', 'cuman', 'verifikasi']","['masuk', 'nya', 'susah', 'verifikasi', 'berhasil', 'verifikasi', 'jam', 'cuman', 'verifikasi']",13,9,4,masuk nya susah verifikasi hasil verifikasi jam cuman verifikasi,9,9
Min. Mohon balikin dana saya. Saya tidak mau jadi member premium. Tiba-tiba ketarik aja saldo dana saya buat member premium. Saya hanya nyobain yang gratis nya. Saya mohon balikin dana saya.,negatif,2024-04-28,2024,min mohon balikin dana saya saya tidak mau jadi member premium tiba tiba ketarik aja saldo dana saya buat member premium saya hanya nyobain yang gratis nya saya mohon balikin dana saya,31,32,minimal mohon balikin dana saya saya tidak mau jadi member premium tiba tiba ketarik saja saldo dana saya buat member premium saya hanya mencoba yang gratis nya saya mohon balikin dana saya,32,32,"['minimal', 'mohon', 'balikin', 'dana', 'saya', 'saya', 'tidak', 'mau', 'jadi', 'member', 'premium', 'tiba', 'tiba', 'ketarik', 'saja', 'saldo', 'dana', 'saya', 'buat', 'member', 'premium', 'saya', 'hanya', 'mencoba', 'yang', 'gratis', 'nya', 'saya', 'mohon', 'balikin', 'dana', 'saya']","['minimal', 'mohon', 'balikin', 'dana', 'tidak', 'member', 'premium', 'ketarik', 'saldo', 'dana', 'member', 'premium', 'mencoba', 'gratis', 'nya', 'mohon', 'balikin', 'dana']",32,18,14,minimal mohon balikin dana tidak member premium tarik saldo dana member premium coba gratis nya mohon balikin dana,18,18
"Baru download dan mau daftar, pas masukin nomor telpon di suruh verifikasi pakai kode tp kodenya di tunggu2 gk dikirim2 akhirnya ulang lagi dan lagi sampai dikirimi kode pas udah saya masukin kodenya malah keluar sendiri app nya, pas saya mau daftar lagi malah nomor saya gk bisa dipake.. hadeh ribet uninstall",negatif,2023-01-10,2023,baru download dan mau daftar pas masukin nomor telpon di suruh verifikasi pakai kode tp kodenya di tunggu gk dikirim akhirnya ulang lagi dan lagi sampai dikirimi kode pas udah saya masukin kodenya malah keluar sendiri app nya pas saya mau daftar lagi malah nomor saya gk bisa dipake hadeh ribet uninstall,52,52,baru unduh dan mau daftar pas masukkan nomor telpon di suruh verifikasi pakai kode tapi kodenya di tunggu tidak dikirim akhirnya ulang lagi dan lagi sampai dikirimi kode pas sudah saya masukkan kodenya bahkan keluar sendiri aplikasi nya pas saya mau daftar lagi bahkan nomor saya tidak bisa di pakai hadeh rumit uninstall,52,53,"['baru', 'unduh', 'dan', 'mau', 'daftar', 'pas', 'masukkan', 'nomor', 'telpon', 'di', 'suruh', 'verifikasi', 'pakai', 'kode', 'tapi', 'kodenya', 'di', 'tunggu', 'tidak', 'dikirim', 'akhirnya', 'ulang', 'lagi', 'dan', 'lagi', 'sampai', 'dikirimi', 'kode', 'pas', 'sudah', 'saya', 'masukkan', 'kodenya', 'bahkan', 'keluar', 'sendiri', 'aplikasi', 'nya', 'pas', 'saya', 'mau', 'daftar', 'lagi', 'bahkan', 'nomor', 'saya', 'tidak', 'bisa', 'di', 'pakai', 'hadeh', 'rumit', 'uninstall']","['unduh', 'daftar', 'pas', 'masukkan', 'nomor', 'telpon', 'suruh', 'verifikasi', 'pakai', 'kode', 'kodenya', 'tunggu', 'tidak', 'dikirim', 'ulang', 'dikirimi', 'kode', 'pas', 'masukkan', 'kodenya', 'aplikasi', 'nya', 'pas', 'daftar', 'nomor', 'tidak', 'pakai', 'hadeh', 'rumit', 'uninstall']",53,30,23,unduh daftar pas masuk nomor telpon suruh verifikasi pakai kode kode tunggu tidak kirim ulang kirim kode pas masuk kode aplikasi nya pas daftar nomor tidak pakai hadeh rumit uninstall,30,30
"Keamanan aplikasi ini sangatlah buruk, 2 kali akun saya dihack tanpa ada pemberitahuan, dan sangat ribet berkali kali disuruh main teka teki, padahal disini banyak lowongan dari rekruter2 untuk membuka peluang kerja, tapi aplikasi nya ga bermutu gini",negatif,2023-08-25,2023,keamanan aplikasi ini sangatlah buruk kali akun saya dihack tanpa ada pemberitahuan dan sangat ribet berkali kali disuruh main teka teki padahal disini banyak lowongan dari rekruter untuk membuka peluang kerja tapi aplikasi nya ga bermutu gini,38,37,keamanan aplikasi ini sangatlah buruk kali akun saya dihack tanpa ada pemberitahuan dan sangat rumit berkali kali disuruh main teka teki padahal disini banyak lowongan dari rekruter untuk membuka peluang kerja tapi aplikasi nya tidak bermutu begini,37,37,"['keamanan', 'aplikasi', 'ini', 'sangatlah', 'buruk', 'kali', 'akun', 'saya', 'dihack', 'tanpa', 'ada', 'pemberitahuan', 'dan', 'sangat', 'rumit', 'berkali', 'kali', 'disuruh', 'main', 'teka', 'teki', 'padahal', 'disini', 'banyak', 'lowongan', 'dari', 'rekruter', 'untuk', 'membuka', 'peluang', 'kerja', 'tapi', 'aplikasi', 'nya', 'tidak', 'bermutu', 'begini']","['keamanan', 'aplikasi', 'buruk', 'kali', 'akun', 'dihack', 'pemberitahuan', 'rumit', 'berkali', 'kali', 'disuruh', 'main', 'teka', 'teki', 'lowongan', 'rekruter', 'membuka', 'peluang', 'kerja', 'aplikasi', 'nya', 'tidak', 'bermutu']",37,23,14,aman aplikasi buruk kali akun dihack pemberitahuan rumit kali kali suruh main teka teki lowong rekruter buka peluang kerja aplikasi nya tidak mutu,23,23
Tidak bisa menambah media dan mengpload foto sampul. Sudah di update dan re-instal lagi tapi tetap tidak bisa berjalan dengan baik aplikasinya.,negatif,2023-12-12,2023,tidak bisa menambah media dan mengpload foto sampul sudah di update dan re instal lagi tapi tetap tidak bisa berjalan dengan baik aplikasinya,22,23,tidak bisa menambah media dan mengpload foto sampul sudah di diperbarui dan re memasang lagi tapi tetap tidak bisa berjalan dengan baik aplikasi nya,23,24,"['tidak', 'bisa', 'menambah', 'media', 'dan', 'mengpload', 'foto', 'sampul', 'sudah', 'di', 'diperbarui', 'dan', 're', 'memasang', 'lagi', 'tapi', 'tetap', 'tidak', 'bisa', 'berjalan', 'dengan', 'baik', 'aplikasi', 'nya']","['tidak', 'menambah', 'media', 'mengpload', 'foto', 'sampul', 'diperbarui', 're', 'memasang', 'tidak', 'berjalan', 'aplikasi', 'nya']",24,13,11,tidak tambah media mengpload foto sampul baru re pasang tidak jalan aplikasi nya,13,13
"CAPTCHA NYA ASU EMANG. NGASIH KEAMANAN YANG BECUS DIKIT NAPA. NYURUH NYARI GAMBAR TERTENTU, GAMBARNYA DOBEL, APA APAAN!!!",negatif,2024-06-05,2024,captcha nya asu emang ngasih keamanan yang becus dikit napa nyuruh nyari gambar tertentu gambarnya dobel apa apaan,18,18,captcha nya asu memang memberikan keamanan yang becus dikit napa nyuruh mencari gambar tertentu gambarnya dobel apa apa,18,18,"['captcha', 'nya', 'asu', 'memang', 'memberikan', 'keamanan', 'yang', 'becus', 'dikit', 'napa', 'nyuruh', 'mencari', 'gambar', 'tertentu', 'gambarnya', 'dobel', 'apa', 'apa']","['captcha', 'nya', 'asu', 'keamanan', 'becus', 'dikit', 'napa', 'nyuruh', 'mencari', 'gambar', 'gambarnya', 'dobel']",18,12,6,captcha nya asu aman becus dikit napa nyuruh cari gambar gambar dobel,12,12
"Ini aplikasi sangat lah buruk, setiap kali login harus verifikasi trus dan terus. Login pun kg pernah berhasil, pdahal sudah mengikuti arahan. Aplikasi ini sangat lah membuat aku jadi pusing, hadeww😒",negatif,2023-07-18,2023,ini aplikasi sangat lah buruk setiap kali login harus verifikasi trus dan terus login pun kg pernah berhasil pdahal sudah mengikuti arahan aplikasi ini sangat lah membuat aku jadi pusing hadeww,31,31,ini aplikasi sangat lah buruk setiap kali login harus verifikasi terus dan terus login pun kg pernah berhasil pdahal sudah mengikuti arahan aplikasi ini sangat lah membuat aku jadi pusing hadeww,31,31,"['ini', 'aplikasi', 'sangat', 'lah', 'buruk', 'setiap', 'kali', 'login', 'harus', 'verifikasi', 'terus', 'dan', 'terus', 'login', 'pun', 'kg', 'pernah', 'berhasil', 'pdahal', 'sudah', 'mengikuti', 'arahan', 'aplikasi', 'ini', 'sangat', 'lah', 'membuat', 'aku', 'jadi', 'pusing', 'hadeww']","['aplikasi', 'buruk', 'kali', 'login', 'verifikasi', 'login', 'kg', 'berhasil', 'pdahal', 'mengikuti', 'arahan', 'aplikasi', 'pusing', 'hadeww']",31,14,17,aplikasi buruk kali login verifikasi login kg hasil pdahal ikut arah aplikasi pusing hadeww,14,14
"LinkedIn sudah tidak berfungsi, login akun lama gak bisa, ubah pasword gak bisa, bikin baru juga gak bisa, bilangnya kode kirim SMS dan email tapi gak ada yang masuk, apa udh bangkrut",negatif,2023-11-12,2023,linkedin sudah tidak berfungsi login akun lama gak bisa ubah pasword gak bisa bikin baru juga gak bisa bilangnya kode kirim sms dan email tapi gak ada yang masuk apa udh bangkrut,32,32,linkedin sudah tidak berfungsi login akun lama tidak bisa ubah pasword tidak bisa bikin baru juga tidak bisa bilangnya kode kirim sms dan email tapi tidak ada yang masuk apa sudah bangkrut,32,32,"['linkedin', 'sudah', 'tidak', 'berfungsi', 'login', 'akun', 'lama', 'tidak', 'bisa', 'ubah', 'pasword', 'tidak', 'bisa', 'bikin', 'baru', 'juga', 'tidak', 'bisa', 'bilangnya', 'kode', 'kirim', 'sms', 'dan', 'email', 'tapi', 'tidak', 'ada', 'yang', 'masuk', 'apa', 'sudah', 'bangkrut']","['linkedin', 'tidak', 'berfungsi', 'login', 'akun', 'tidak', 'ubah', 'pasword', 'tidak', 'bikin', 'tidak', 'bilangnya', 'kode', 'kirim', 'sms', 'email', 'tidak', 'masuk', 'bangkrut']",32,19,13,linkedin tidak fungsi login akun tidak ubah pasword tidak bikin tidak bilang kode kirim sms email tidak masuk bangkrut,19,19
"Tiba tiba tidak bisa login, dan pada saat Verifikasi ID untuk login tidak. Terjadi kesalahan pada saat upload. Masih juga tidak bisa, udah buat laporan ke team terkait, gak ada hasilnya LOL",negatif,2023-06-24,2023,tiba tiba tidak bisa login dan pada saat verifikasi id untuk login tidak terjadi kesalahan pada saat upload masih juga tidak bisa udah buat laporan ke team terkait gak ada hasilnya lol,32,32,tiba tiba tidak bisa login dan pada saat verifikasi id untuk login tidak terjadi kesalahan pada saat unggah masih juga tidak bisa sudah buat laporan ke team terkait tidak ada hasilnya lol,32,32,"['tiba', 'tiba', 'tidak', 'bisa', 'login', 'dan', 'pada', 'saat', 'verifikasi', 'id', 'untuk', 'login', 'tidak', 'terjadi', 'kesalahan', 'pada', 'saat', 'unggah', 'masih', 'juga', 'tidak', 'bisa', 'sudah', 'buat', 'laporan', 'ke', 'team', 'terkait', 'tidak', 'ada', 'hasilnya', 'lol']","['tidak', 'login', 'verifikasi', 'id', 'login', 'tidak', 'kesalahan', 'unggah', 'tidak', 'laporan', 'team', 'terkait', 'tidak', 'hasilnya', 'lol']",32,15,17,tidak login verifikasi id login tidak salah unggah tidak lapor team kait tidak hasil lol,15,15
"Untuk updatetan selanjutnya tolong donk kalian udah terintegrasi dengan semua perusahaan, jadi gampang buat daftarnya. Saya nggak suka kalau tiap kali ngelamar harus masuk ke web lain dan harus registrasi lagi dari awal, bagus kalau keterima. Kalau kagak, habis saya diteror sama web lain dengan notif lamaran yang numpuk di Gmail. Oh ya tolong juga donk nggak usah notif lagi di Gmail, saya merasa terganggu.",negatif,2022-12-03,2022,untuk updatetan selanjutnya tolong donk kalian udah terintegrasi dengan semua perusahaan jadi gampang buat daftarnya saya nggak suka kalau tiap kali ngelamar harus masuk ke web lain dan harus registrasi lagi dari awal bagus kalau keterima kalau kagak habis saya diteror sama web lain dengan notif lamaran yang numpuk di gmail oh ya tolong juga donk nggak usah notif lagi di gmail saya merasa terganggu,65,65,untuk updatetan selanjutnya tolong dong kalian sudah terintegrasi dengan semua perusahaan jadi gampang buat daftarnya saya tidak suka kalau tiap kali ngelamar harus masuk ke web lain dan harus registrasi lagi dari awal bagus kalau keterima kalau tidak habis saya diteror sama web lain dengan notif lamaran yang numpuk di gmail oh ya tolong juga dong tidak usah notif lagi di gmail saya merasa terganggu,65,65,"['untuk', 'updatetan', 'selanjutnya', 'tolong', 'dong', 'kalian', 'sudah', 'terintegrasi', 'dengan', 'semua', 'perusahaan', 'jadi', 'gampang', 'buat', 'daftarnya', 'saya', 'tidak', 'suka', 'kalau', 'tiap', 'kali', 'ngelamar', 'harus', 'masuk', 'ke', 'web', 'lain', 'dan', 'harus', 'registrasi', 'lagi', 'dari', 'awal', 'bagus', 'kalau', 'keterima', 'kalau', 'tidak', 'habis', 'saya', 'diteror', 'sama', 'web', 'lain', 'dengan', 'notif', 'lamaran', 'yang', 'numpuk', 'di', 'gmail', 'oh', 'ya', 'tolong', 'juga', 'dong', 'tidak', 'usah', 'notif', 'lagi', 'di', 'gmail', 'saya', 'merasa', 'terganggu']","['updatetan', 'tolong', 'terintegrasi', 'perusahaan', 'gampang', 'daftarnya', 'tidak', 'suka', 'kali', 'ngelamar', 'masuk', 'web', 'registrasi', 'bagus', 'keterima', 'tidak', 'habis', 'diteror', 'web', 'notif', 'lamaran', 'numpuk', 'gmail', 'oh', 'ya', 'tolong', 'tidak', 'notif', 'gmail', 'terganggu']",65,30,35,updatetan tolong integrasi usaha gampang daftar tidak suka kali ngelamar masuk web registrasi bagus terima tidak habis teror web notif lamar numpuk gmail oh ya tolong tidak notif gmail ganggu,30,30
Kenapa akun saya dibatasi tanpa pemberitahuan terlebih dahulu dan saya terus mencoba login kembali tapi tidak bisa. Tolong segera diatasi saya sangat membutuhkan akun nya dan saya pun tidak melakukan hal yang aneh dengan aplikasi ini,negatif,2023-07-31,2023,kenapa akun saya dibatasi tanpa pemberitahuan terlebih dahulu dan saya terus mencoba login kembali tapi tidak bisa tolong segera diatasi saya sangat membutuhkan akun nya dan saya pun tidak melakukan hal yang aneh dengan aplikasi ini,36,36,kenapa akun saya dibatasi tanpa pemberitahuan terlebih dahulu dan saya terus mencoba login kembali tapi tidak bisa tolong segera diatasi saya sangat membutuhkan akun nya dan saya pun tidak melakukan hal yang aneh dengan aplikasi ini,36,36,"['kenapa', 'akun', 'saya', 'dibatasi', 'tanpa', 'pemberitahuan', 'terlebih', 'dahulu', 'dan', 'saya', 'terus', 'mencoba', 'login', 'kembali', 'tapi', 'tidak', 'bisa', 'tolong', 'segera', 'diatasi', 'saya', 'sangat', 'membutuhkan', 'akun', 'nya', 'dan', 'saya', 'pun', 'tidak', 'melakukan', 'hal', 'yang', 'aneh', 'dengan', 'aplikasi', 'ini']","['akun', 'dibatasi', 'pemberitahuan', 'mencoba', 'login', 'tidak', 'tolong', 'diatasi', 'membutuhkan', 'akun', 'nya', 'tidak', 'aneh', 'aplikasi']",36,14,22,akun batas pemberitahuan coba login tidak tolong atas butuh akun nya tidak aneh aplikasi,14,14
"Verifikasi captcha uda bener, tapi ngulang terus""an verifikasi lagi, jadi gak kelar"", uninstall aja lah. The captcha verification was success but it keep going asking the captcha again and again. Uninstall it.",negatif,2023-04-04,2023,verifikasi captcha uda bener tapi ngulang terus an verifikasi lagi jadi gak kelar uninstall aja lah the captcha verification was success but it keep going asking the captcha again and again uninstall it,32,33,verifikasi captcha sudah benar tapi mengulang terus an verifikasi lagi jadi tidak kelar uninstall saja lah the captcha verification ragu ragu success but it keep going asking the captcha again and again uninstall it,33,34,"['verifikasi', 'captcha', 'sudah', 'benar', 'tapi', 'mengulang', 'terus', 'an', 'verifikasi', 'lagi', 'jadi', 'tidak', 'kelar', 'uninstall', 'saja', 'lah', 'the', 'captcha', 'verification', 'ragu', 'ragu', 'success', 'but', 'it', 'keep', 'going', 'asking', 'the', 'captcha', 'again', 'and', 'again', 'uninstall', 'it']","['verifikasi', 'captcha', 'mengulang', 'an', 'verifikasi', 'tidak', 'kelar', 'uninstall', 'the', 'captcha', 'verification', 'ragu', 'ragu', 'success', 'but', 'it', 'keep', 'going', 'asking', 'the', 'captcha', 'again', 'and', 'again', 'uninstall', 'it']",34,26,8,verifikasi captcha ulang an verifikasi tidak kelar uninstall the captcha verification ragu ragu success but it keep going asking the captcha again and again uninstall it,26,26
"Maaf saya kasih bintang 1aja karena kecewa bangat dgn apknya. Disuruh pilih gambar yg menghadap ke atas saat mau verifikasi susah bangat, kita udh pilih yg benar puluhan kali tapi gagal trs, kecewa bangat dowloadnya.",negatif,2021-09-21,2021,maaf saya kasih bintang aja karena kecewa bangat dgn apknya disuruh pilih gambar yg menghadap ke atas saat mau verifikasi susah bangat kita udh pilih yg benar puluhan kali tapi gagal trs kecewa bangat dowloadnya,35,35,maaf saya kasih bintang saja karena kecewa banget dengan aplikasinya disuruh pilih gambar yang menghadap ke atas saat mau verifikasi susah banget kita sudah pilih yang benar puluhan kali tapi gagal terus kecewa banget dowloadnya,35,35,"['maaf', 'saya', 'kasih', 'bintang', 'saja', 'karena', 'kecewa', 'banget', 'dengan', 'aplikasinya', 'disuruh', 'pilih', 'gambar', 'yang', 'menghadap', 'ke', 'atas', 'saat', 'mau', 'verifikasi', 'susah', 'banget', 'kita', 'sudah', 'pilih', 'yang', 'benar', 'puluhan', 'kali', 'tapi', 'gagal', 'terus', 'kecewa', 'banget', 'dowloadnya']","['maaf', 'kasih', 'bintang', 'kecewa', 'banget', 'aplikasinya', 'disuruh', 'pilih', 'gambar', 'menghadap', 'verifikasi', 'susah', 'banget', 'pilih', 'puluhan', 'kali', 'gagal', 'kecewa', 'banget', 'dowloadnya']",35,20,15,maaf kasih bintang kecewa banget aplikasi suruh pilih gambar hadap verifikasi susah banget pilih puluh kali gagal kecewa banget dowloadnya,20,20
"Jangan pernah instal aplikasi ini. Ntar nyeselll Dari awal udah jelek dipersulit untuk verifikasi Disuruh pilih gambar Badak yang menghadap keatas,.. salah mulu padahal udah bener. Nyesel habisin kuota doang !!!",negatif,2021-10-15,2021,jangan pernah instal aplikasi ini ntar nyeselll dari awal udah jelek dipersulit untuk verifikasi disuruh pilih gambar badak yang menghadap keatas salah mulu padahal udah bener nyesel habisin kuota doang,31,30,jangan pernah memasang aplikasi ini entar nyeselll dari awal sudah jelek dipersulit untuk verifikasi disuruh pilih gambar badak yang menghadap keatas salah mulu padahal sudah benar menyesal habisin kuota saja,30,30,"['jangan', 'pernah', 'memasang', 'aplikasi', 'ini', 'entar', 'nyeselll', 'dari', 'awal', 'sudah', 'jelek', 'dipersulit', 'untuk', 'verifikasi', 'disuruh', 'pilih', 'gambar', 'badak', 'yang', 'menghadap', 'keatas', 'salah', 'mulu', 'padahal', 'sudah', 'benar', 'menyesal', 'habisin', 'kuota', 'saja']","['memasang', 'aplikasi', 'entar', 'nyeselll', 'jelek', 'dipersulit', 'verifikasi', 'disuruh', 'pilih', 'gambar', 'badak', 'menghadap', 'keatas', 'salah', 'mulu', 'menyesal', 'habisin', 'kuota']",30,18,12,pasang aplikasi entar nyeselll jelek sulit verifikasi suruh pilih gambar badak hadap atas salah mulu sesal habisin kuota,18,18
Aplikasi taiiii mau masuk aja ga masuk2 log in nya susah...di suruh pecahkan teka teki suruh liat gambar yang ngadep ke atas tapi jawaban akhir nya salah mulu...taiiiii doang....,negatif,2023-11-30,2023,aplikasi taiiii mau masuk aja ga masuk log in nya susah di suruh pecahkan teka teki suruh liat gambar yang ngadep ke atas tapi jawaban akhir nya salah mulu taiiiii doang,29,31,aplikasi taiiii mau masuk saja tidak masuk log in nya susah di suruh pecahkan teka teki suruh lihat gambar yang ngadep ke atas tapi jawaban akhir nya salah mulu taiiiii saja,31,31,"['aplikasi', 'taiiii', 'mau', 'masuk', 'saja', 'tidak', 'masuk', 'log', 'in', 'nya', 'susah', 'di', 'suruh', 'pecahkan', 'teka', 'teki', 'suruh', 'lihat', 'gambar', 'yang', 'ngadep', 'ke', 'atas', 'tapi', 'jawaban', 'akhir', 'nya', 'salah', 'mulu', 'taiiiii', 'saja']","['aplikasi', 'taiiii', 'masuk', 'tidak', 'masuk', 'log', 'in', 'nya', 'susah', 'suruh', 'pecahkan', 'teka', 'teki', 'suruh', 'lihat', 'gambar', 'ngadep', 'nya', 'salah', 'mulu', 'taiiiii']",31,21,10,aplikasi taiiii masuk tidak masuk log in nya susah suruh pecah teka teki suruh lihat gambar ngadep nya salah mulu taiiiii,21,21
"Kenapa kok susah bener untuk Login. Saya sudah Berkali-kali Login karena Hp saya di hilang.malah nyuruh Verifikasi lewat LinkedIn. Tapi bagaimana mau di Verifikasi, kalau Hp udah Hilang 🤣😅",negatif,2023-11-15,2023,kenapa kok susah bener untuk login saya sudah berkali kali login karena hp saya di hilang malah nyuruh verifikasi lewat linkedin tapi bagaimana mau di verifikasi kalau hp udah hilang,29,30,kenapa kok susah benar untuk login saya sudah berkali kali login karena handphone saya di hilang bahkan nyuruh verifikasi lewat linkedin tapi bagaimana mau di verifikasi kalau handphone sudah hilang,30,30,"['kenapa', 'kok', 'susah', 'benar', 'untuk', 'login', 'saya', 'sudah', 'berkali', 'kali', 'login', 'karena', 'handphone', 'saya', 'di', 'hilang', 'bahkan', 'nyuruh', 'verifikasi', 'lewat', 'linkedin', 'tapi', 'bagaimana', 'mau', 'di', 'verifikasi', 'kalau', 'handphone', 'sudah', 'hilang']","['susah', 'login', 'berkali', 'kali', 'login', 'handphone', 'hilang', 'nyuruh', 'verifikasi', 'linkedin', 'verifikasi', 'handphone', 'hilang']",30,13,17,susah login kali kali login handphone hilang nyuruh verifikasi linkedin verifikasi handphone hilang,13,13
Halo saya kecewa dengan linkedin kenapa akun saya di nonaktifkan tiba² padahal saya tidak melalukan apa apa yang di larang. Saya sudah mencoba untuk memverifikasi akun saya tapi selalu ditolak padahal saya sudah mengikuti rules dengan benar. Jadi tolong kembalikan akun saya!,negatif,2021-09-15,2021,halo saya kecewa dengan linkedin kenapa akun saya di nonaktifkan tiba² padahal saya tidak melalukan apa apa yang di larang saya sudah mencoba untuk memverifikasi akun saya tapi selalu ditolak padahal saya sudah mengikuti rules dengan benar jadi tolong kembalikan akun saya,42,42,halo saya kecewa dengan linkedin kenapa akun saya di nonaktifkan tiba² padahal saya tidak melalukan apa apa yang di larang saya sudah mencoba untuk memverifikasi akun saya tapi selalu ditolak padahal saya sudah mengikuti rules dengan benar jadi tolong kembalikan akun saya,42,42,"['halo', 'saya', 'kecewa', 'dengan', 'linkedin', 'kenapa', 'akun', 'saya', 'di', 'nonaktifkan', 'tiba²', 'padahal', 'saya', 'tidak', 'melalukan', 'apa', 'apa', 'yang', 'di', 'larang', 'saya', 'sudah', 'mencoba', 'untuk', 'memverifikasi', 'akun', 'saya', 'tapi', 'selalu', 'ditolak', 'padahal', 'saya', 'sudah', 'mengikuti', 'rules', 'dengan', 'benar', 'jadi', 'tolong', 'kembalikan', 'akun', 'saya']","['halo', 'kecewa', 'linkedin', 'akun', 'nonaktifkan', 'tiba²', 'tidak', 'melalukan', 'larang', 'mencoba', 'memverifikasi', 'akun', 'ditolak', 'mengikuti', 'rules', 'tolong', 'kembalikan', 'akun']",42,18,24,halo kecewa linkedin akun nonaktif tiba tidak lalu larang coba verifikasi akun tolak ikut rules tolong kembali akun,18,18
"Pada Apikasi LinkedIn tiba tiba akun saya logout sendiri. Pada saat log in lagi pas verifikasi manusia ketemu gambar katak putih susah sekali memverifikasi nya. Saran saja kenapa ga di ganti aja format verifikasi manusianya jangan pake gambar katak:'( tolong pulihkan akun LinkedIn saya, saya tidak bisa login",negatif,2021-05-22,2021,pada apikasi linkedin tiba tiba akun saya logout sendiri pada saat log in lagi pas verifikasi manusia ketemu gambar katak putih susah sekali memverifikasi nya saran saja kenapa ga di ganti aja format verifikasi manusianya jangan pake gambar katak tolong pulihkan akun linkedin saya saya tidak bisa login,48,48,pada apikasi linkedin tiba tiba akun saya logout sendiri pada saat log in lagi pas verifikasi manusia ketemu gambar katak putih susah sekali memverifikasi nya saran saja kenapa tidak di ganti saja format verifikasi manusianya jangan pakai gambar katak tolong pulihkan akun linkedin saya saya tidak bisa login,48,48,"['pada', 'apikasi', 'linkedin', 'tiba', 'tiba', 'akun', 'saya', 'logout', 'sendiri', 'pada', 'saat', 'log', 'in', 'lagi', 'pas', 'verifikasi', 'manusia', 'ketemu', 'gambar', 'katak', 'putih', 'susah', 'sekali', 'memverifikasi', 'nya', 'saran', 'saja', 'kenapa', 'tidak', 'di', 'ganti', 'saja', 'format', 'verifikasi', 'manusianya', 'jangan', 'pakai', 'gambar', 'katak', 'tolong', 'pulihkan', 'akun', 'linkedin', 'saya', 'saya', 'tidak', 'bisa', 'login']","['apikasi', 'linkedin', 'akun', 'logout', 'log', 'in', 'pas', 'verifikasi', 'manusia', 'ketemu', 'gambar', 'katak', 'putih', 'susah', 'memverifikasi', 'nya', 'saran', 'tidak', 'ganti', 'format', 'verifikasi', 'manusianya', 'pakai', 'gambar', 'katak', 'tolong', 'pulihkan', 'akun', 'linkedin', 'tidak', 'login']",48,31,17,apikasi linkedin akun logout log in pas verifikasi manusia ketemu gambar katak putih susah verifikasi nya saran tidak ganti format verifikasi manusia pakai gambar katak tolong pulih akun linkedin tidak login,31,31
"Verifikasi sangat tidak jelas. Padahal sudah muncul keterangan ""verifikasi selesai,anda telah membuktikan bahwa anda manusia"", tapi malah muncul ""eror noCAPTCHA anda tidak valid atau belum di isi"". GAK JELAS, BROKEN APP",negatif,2023-05-06,2023,verifikasi sangat tidak jelas padahal sudah muncul keterangan verifikasi selesai anda telah membuktikan bahwa anda manusia tapi malah muncul eror nocaptcha anda tidak valid atau belum di isi gak jelas broken app,31,32,verifikasi sangat tidak jelas padahal sudah muncul keterangan verifikasi selesai anda telah membuktikan bahwa anda manusia tapi bahkan muncul error nocaptcha anda tidak valid atau belum di isi tidak jelas broken aplikasi,32,32,"['verifikasi', 'sangat', 'tidak', 'jelas', 'padahal', 'sudah', 'muncul', 'keterangan', 'verifikasi', 'selesai', 'anda', 'telah', 'membuktikan', 'bahwa', 'anda', 'manusia', 'tapi', 'bahkan', 'muncul', 'error', 'nocaptcha', 'anda', 'tidak', 'valid', 'atau', 'belum', 'di', 'isi', 'tidak', 'jelas', 'broken', 'aplikasi']","['verifikasi', 'tidak', 'muncul', 'keterangan', 'verifikasi', 'selesai', 'membuktikan', 'manusia', 'muncul', 'error', 'nocaptcha', 'tidak', 'valid', 'isi', 'tidak', 'broken', 'aplikasi']",32,17,15,verifikasi tidak muncul terang verifikasi selesai bukti manusia muncul error nocaptcha tidak valid isi tidak broken aplikasi,17,17
"Kode captcha untuk verifikasi akunnya selalu diulang2, kalaupun sudah benar pasti sbntr diulang terus. Bgituu terus nggak bisa login",negatif,2024-02-07,2024,kode captcha untuk verifikasi akunnya selalu diulang kalaupun sudah benar pasti sbntr diulang terus bgituu terus nggak bisa login,19,19,kode captcha untuk verifikasi akunnya selalu diulang kalaupun sudah benar pasti sebentar diulang terus bgituu terus tidak bisa login,19,19,"['kode', 'captcha', 'untuk', 'verifikasi', 'akunnya', 'selalu', 'diulang', 'kalaupun', 'sudah', 'benar', 'pasti', 'sebentar', 'diulang', 'terus', 'bgituu', 'terus', 'tidak', 'bisa', 'login']","['kode', 'captcha', 'verifikasi', 'akunnya', 'diulang', 'sebentar', 'diulang', 'bgituu', 'tidak', 'login']",19,10,9,kode captcha verifikasi akun ulang sebentar ulang bgituu tidak login,10,10
Nggak bs login dah dari kapaaaaan itu. Pngn ngecek2 nyari lowongan. Sama memperbarui profil. Soalnya takutnya dikira msh kerja di tmpt yg dulu pdhl udh resign.,negatif,2024-01-31,2024,nggak bs login dah dari kapaaaaan itu pngn ngecek nyari lowongan sama memperbarui profil soalnya takutnya dikira msh kerja di tmpt yg dulu pdhl udh resign,26,26,tidak bisa login sudah dari kapaaaaan itu pngn cek mencari lowongan sama memperbarui profil soalnya takutnya dikira masih kerja di tmpt yang dahulu padahal sudah resign,26,26,"['tidak', 'bisa', 'login', 'sudah', 'dari', 'kapaaaaan', 'itu', 'pngn', 'cek', 'mencari', 'lowongan', 'sama', 'memperbarui', 'profil', 'soalnya', 'takutnya', 'dikira', 'masih', 'kerja', 'di', 'tmpt', 'yang', 'dahulu', 'padahal', 'sudah', 'resign']","['tidak', 'login', 'kapaaaaan', 'pngn', 'cek', 'mencari', 'lowongan', 'memperbarui', 'profil', 'takutnya', 'kerja', 'tmpt', 'resign']",26,13,13,tidak login kapaaaaan pngn cek cari lowong baru profil takut kerja tmpt resign,13,13
Tolong Linkedln kenapasih tiap buka aplikasi suruh login terus. Udh gitu harus ngulang beberapa kali lg. Suruh verifikasi terus. Nih aplikasi bukannya mempermudah malah bikin ribet. Gk bisa dibuka,negatif,2024-02-19,2024,tolong linkedln kenapasih tiap buka aplikasi suruh login terus udh gitu harus ngulang beberapa kali lg suruh verifikasi terus nih aplikasi bukannya mempermudah malah bikin ribet gk bisa dibuka,29,29,tolong linkedln kenapasih tiap buka aplikasi suruh login terus sudah begitu harus mengulang beberapa kali lagi suruh verifikasi terus nih aplikasi bukannya mempermudah bahkan bikin rumit tidak bisa dibuka,29,29,"['tolong', 'linkedln', 'kenapasih', 'tiap', 'buka', 'aplikasi', 'suruh', 'login', 'terus', 'sudah', 'begitu', 'harus', 'mengulang', 'beberapa', 'kali', 'lagi', 'suruh', 'verifikasi', 'terus', 'nih', 'aplikasi', 'bukannya', 'mempermudah', 'bahkan', 'bikin', 'rumit', 'tidak', 'bisa', 'dibuka']","['tolong', 'linkedln', 'kenapasih', 'buka', 'aplikasi', 'suruh', 'login', 'mengulang', 'kali', 'suruh', 'verifikasi', 'nih', 'aplikasi', 'mempermudah', 'bikin', 'rumit', 'tidak', 'dibuka']",29,18,11,tolong linkedln kenapasih buka aplikasi suruh login ulang kali suruh verifikasi nih aplikasi mudah bikin rumit tidak buka,18,18
Verifikasi Indetitas dibagian KTP padahal sudah sesuai ketentuan tapi kenapa tulisannya. Terjadi masalah coba lagi udah diulangin beberapa kali masih tetap sama,negatif,2023-05-11,2023,verifikasi indetitas dibagian ktp padahal sudah sesuai ketentuan tapi kenapa tulisannya terjadi masalah coba lagi udah diulangin beberapa kali masih tetap sama,22,22,verifikasi indetitas dibagian ktp padahal sudah sesuai ketentuan tapi kenapa tulisannya terjadi masalah coba lagi sudah diulangin beberapa kali masih tetap sama,22,22,"['verifikasi', 'indetitas', 'dibagian', 'ktp', 'padahal', 'sudah', 'sesuai', 'ketentuan', 'tapi', 'kenapa', 'tulisannya', 'terjadi', 'masalah', 'coba', 'lagi', 'sudah', 'diulangin', 'beberapa', 'kali', 'masih', 'tetap', 'sama']","['verifikasi', 'indetitas', 'dibagian', 'ktp', 'sesuai', 'ketentuan', 'tulisannya', 'coba', 'diulangin', 'kali']",22,10,12,verifikasi indetitas bagi ktp sesuai tentu tulis coba diulangin kali,10,10
Sulit banget loginnya kenapa ya..? udah ganti gmailpun juga masih nggak bisa login. Harus verifikasi data padahal sudah kirim ktp masih tetap muncul verifikasi data terus,negatif,2023-04-30,2023,sulit banget loginnya kenapa ya udah ganti gmailpun juga masih nggak bisa login harus verifikasi data padahal sudah kirim ktp masih tetap muncul verifikasi data terus,26,26,sulit banget loginnya kenapa ya sudah ganti gmailpun juga masih tidak bisa login harus verifikasi data padahal sudah kirim ktp masih tetap muncul verifikasi data terus,26,26,"['sulit', 'banget', 'loginnya', 'kenapa', 'ya', 'sudah', 'ganti', 'gmailpun', 'juga', 'masih', 'tidak', 'bisa', 'login', 'harus', 'verifikasi', 'data', 'padahal', 'sudah', 'kirim', 'ktp', 'masih', 'tetap', 'muncul', 'verifikasi', 'data', 'terus']","['sulit', 'banget', 'loginnya', 'ya', 'ganti', 'gmailpun', 'tidak', 'login', 'verifikasi', 'data', 'kirim', 'ktp', 'muncul', 'verifikasi', 'data']",26,15,11,sulit banget loginnya ya ganti gmailpun tidak login verifikasi data kirim ktp muncul verifikasi data,15,15
"Aplikasinya aneh wkwk login make google, dsuruh verifikasi keamanan hewan madep keatas masa salah terus, dan selalu gagal di percobaan yg terakhir, padahal sudah bener semua, alhasil mohon maap saya uninstall wkwk aneh jg",negatif,2023-05-27,2023,aplikasinya aneh wkwk login make google dsuruh verifikasi keamanan hewan madep keatas masa salah terus dan selalu gagal di percobaan yg terakhir padahal sudah bener semua alhasil mohon maap saya uninstall wkwk aneh jg,34,34,aplikasi nya aneh wkwk login make google dsuruh verifikasi keamanan hewan madep keatas masa salah terus dan selalu gagal di percobaan yang terakhir padahal sudah benar semua alhasil mohon maap saya uninstall wkwk aneh juga,34,35,"['aplikasi', 'nya', 'aneh', 'wkwk', 'login', 'make', 'google', 'dsuruh', 'verifikasi', 'keamanan', 'hewan', 'madep', 'keatas', 'masa', 'salah', 'terus', 'dan', 'selalu', 'gagal', 'di', 'percobaan', 'yang', 'terakhir', 'padahal', 'sudah', 'benar', 'semua', 'alhasil', 'mohon', 'maap', 'saya', 'uninstall', 'wkwk', 'aneh', 'juga']","['aplikasi', 'nya', 'aneh', 'wkwk', 'login', 'make', 'google', 'dsuruh', 'verifikasi', 'keamanan', 'hewan', 'madep', 'keatas', 'salah', 'gagal', 'percobaan', 'alhasil', 'mohon', 'maap', 'uninstall', 'wkwk', 'aneh']",35,22,13,aplikasi nya aneh wkwk login make google dsuruh verifikasi aman hewan madep atas salah gagal coba alhasil mohon maap uninstall wkwk aneh,22,22
Bagus👍 sangat penting,positif,2024-08-28,2024,bagus sangat penting,3,3,bagus sangat penting,3,3,"['bagus', 'sangat', 'penting']",['bagus'],3,1,2,bagus,1,1
"Ini LinkedIn lgi bermasalah atau gimana si? Dari tadi udh isi security check, ga di respon sama kode no captcha. Padahal udh di isi dengan benar, anehh ini lama² herannn tolong di PERBAIKI DONG",negatif,2023-12-01,2023,ini linkedin lgi bermasalah atau gimana si dari tadi udh isi security check ga di respon sama kode no captcha padahal udh di isi dengan benar anehh ini lama² herannn tolong di perbaiki dong,34,34,ini linkedin lagi bermasalah atau bagaimana sih dari tadi sudah isi security cek tidak di respons sama kode nomor captcha padahal sudah di isi dengan benar anehh ini lama² herannn tolong di perbaikan dong,34,34,"['ini', 'linkedin', 'lagi', 'bermasalah', 'atau', 'bagaimana', 'sih', 'dari', 'tadi', 'sudah', 'isi', 'security', 'cek', 'tidak', 'di', 'respons', 'sama', 'kode', 'nomor', 'captcha', 'padahal', 'sudah', 'di', 'isi', 'dengan', 'benar', 'anehh', 'ini', 'lama²', 'herannn', 'tolong', 'di', 'perbaikan', 'dong']","['linkedin', 'bermasalah', 'sih', 'isi', 'security', 'cek', 'tidak', 'respons', 'kode', 'nomor', 'captcha', 'isi', 'anehh', 'lama²', 'herannn', 'tolong', 'perbaikan']",34,17,17,linkedin masalah sih isi security cek tidak respons kode nomor captcha isi anehh lama herannn tolong baik,17,17
verifikasinya susah sekali padahal sudah dipilih dengan benar sampai saya coba pakek hp maupun laptop tolong diperbaiki kalo kyk gni ngk biaa buat akunnya. salah terus dri tekateki gambar maupun suara,negatif,2021-09-28,2021,verifikasinya susah sekali padahal sudah dipilih dengan benar sampai saya coba pakek hp maupun laptop tolong diperbaiki kalo kyk gni ngk biaa buat akunnya salah terus dri tekateki gambar maupun suara,31,31,verifikasinya susah sekali padahal sudah dipilih dengan benar sampai saya coba pakai handphone maupun laptop tolong di perbaiki kalau seperti begini tidak biaa buat akunnya salah terus dari tekateki gambar maupun suara,31,32,"['verifikasinya', 'susah', 'sekali', 'padahal', 'sudah', 'dipilih', 'dengan', 'benar', 'sampai', 'saya', 'coba', 'pakai', 'handphone', 'maupun', 'laptop', 'tolong', 'di', 'perbaiki', 'kalau', 'seperti', 'begini', 'tidak', 'biaa', 'buat', 'akunnya', 'salah', 'terus', 'dari', 'tekateki', 'gambar', 'maupun', 'suara']","['verifikasinya', 'susah', 'dipilih', 'coba', 'pakai', 'handphone', 'laptop', 'tolong', 'perbaiki', 'tidak', 'biaa', 'akunnya', 'salah', 'tekateki', 'gambar', 'suara']",32,16,16,verifikasi susah pilih coba pakai handphone laptop tolong baik tidak biaa akun salah tekateki gambar suara,16,16
"pas dibuka Minta perbaharui,,,pas mau diperbaharui keluar tulisan china gitu.. gak bisa login.. ada yg bisa bantu,, gimana cara memperbaharui dan untuk login",negatif,2020-12-02,2020,pas dibuka minta perbaharui pas mau diperbaharui keluar tulisan china gitu gak bisa login ada yg bisa bantu gimana cara memperbaharui dan untuk login,23,24,pas dibuka minta perbaharui pas mau pembaruan keluar tulisan china begitu tidak bisa login ada yang bisa bantu bagaimana cara memperbaharui dan untuk login,24,24,"['pas', 'dibuka', 'minta', 'perbaharui', 'pas', 'mau', 'pembaruan', 'keluar', 'tulisan', 'china', 'begitu', 'tidak', 'bisa', 'login', 'ada', 'yang', 'bisa', 'bantu', 'bagaimana', 'cara', 'memperbaharui', 'dan', 'untuk', 'login']","['pas', 'dibuka', 'perbaharui', 'pas', 'pembaruan', 'tulisan', 'china', 'tidak', 'login', 'bantu', 'memperbaharui', 'login']",24,12,12,pas buka baharu pas baru tulis china tidak login bantu baharu login,12,12
Kenapa yah setiap mau bikin postingan itu cuman bisa ngirim 1 gambar ga bisa lebih.dan ini cuman berlaku di versi mobile nya saja. Selalu gagal saat mengirim postingan yg ada lebih dari 1 gambar,negatif,2023-11-09,2023,kenapa yah setiap mau bikin postingan itu cuman bisa ngirim gambar ga bisa lebih dan ini cuman berlaku di versi mobile nya saja selalu gagal saat mengirim postingan yg ada lebih dari gambar,34,33,kenapa ya setiap mau bikin postingan itu cuman bisa mengirim gambar tidak bisa lebih dan ini cuman berlaku di versi mobile nya saja selalu gagal saat mengirim postingan yang ada lebih dari gambar,33,33,"['kenapa', 'ya', 'setiap', 'mau', 'bikin', 'postingan', 'itu', 'cuman', 'bisa', 'mengirim', 'gambar', 'tidak', 'bisa', 'lebih', 'dan', 'ini', 'cuman', 'berlaku', 'di', 'versi', 'mobile', 'nya', 'saja', 'selalu', 'gagal', 'saat', 'mengirim', 'postingan', 'yang', 'ada', 'lebih', 'dari', 'gambar']","['ya', 'bikin', 'postingan', 'cuman', 'mengirim', 'gambar', 'tidak', 'cuman', 'berlaku', 'versi', 'mobile', 'nya', 'gagal', 'mengirim', 'postingan', 'gambar']",33,16,17,ya bikin postingan cuman kirim gambar tidak cuman laku versi mobile nya gagal kirim postingan gambar,16,16
"Setiap masuk ke aplikasi log in selalu ada tulisan akun di nonaktifkan, udah bikin akun 3x dengan gmail yang berbeda selalu begitu, jelek banget",negatif,2020-05-27,2020,setiap masuk ke aplikasi log in selalu ada tulisan akun di nonaktifkan udah bikin akun x dengan gmail yang berbeda selalu begitu jelek banget,24,24,setiap masuk ke aplikasi log in selalu ada tulisan akun di nonaktifkan sudah bikin akun x dengan gmail yang berbeda selalu begitu jelek banget,24,24,"['setiap', 'masuk', 'ke', 'aplikasi', 'log', 'in', 'selalu', 'ada', 'tulisan', 'akun', 'di', 'nonaktifkan', 'sudah', 'bikin', 'akun', 'x', 'dengan', 'gmail', 'yang', 'berbeda', 'selalu', 'begitu', 'jelek', 'banget']","['masuk', 'aplikasi', 'log', 'in', 'tulisan', 'akun', 'nonaktifkan', 'bikin', 'akun', 'x', 'gmail', 'berbeda', 'jelek', 'banget']",24,14,10,masuk aplikasi log in tulis akun nonaktif bikin akun x gmail beda jelek banget,14,14
"Mohon di benahi lagi untuk sistem verifikasi masuk akun, gambar yang tidak jelas itu membuat saya tertahan di verifikasi sangat lama, dan sampai saat ini saya masih belum bisa masuk ke akun saya. Mohon di perbaiki kedepannya dengan opsi yang lebih baik lagi",negatif,2021-01-13,2021,mohon di benahi lagi untuk sistem verifikasi masuk akun gambar yang tidak jelas itu membuat saya tertahan di verifikasi sangat lama dan sampai saat ini saya masih belum bisa masuk ke akun saya mohon di perbaiki kedepannya dengan opsi yang lebih baik lagi,43,43,mohon di benahi lagi untuk sistem verifikasi masuk akun gambar yang tidak jelas itu membuat saya tertahan di verifikasi sangat lama dan sampai saat ini saya masih belum bisa masuk ke akun saya mohon di perbaikan kedepannya dengan opsi yang lebih baik lagi,43,43,"['mohon', 'di', 'benahi', 'lagi', 'untuk', 'sistem', 'verifikasi', 'masuk', 'akun', 'gambar', 'yang', 'tidak', 'jelas', 'itu', 'membuat', 'saya', 'tertahan', 'di', 'verifikasi', 'sangat', 'lama', 'dan', 'sampai', 'saat', 'ini', 'saya', 'masih', 'belum', 'bisa', 'masuk', 'ke', 'akun', 'saya', 'mohon', 'di', 'perbaikan', 'kedepannya', 'dengan', 'opsi', 'yang', 'lebih', 'baik', 'lagi']","['mohon', 'benahi', 'sistem', 'verifikasi', 'masuk', 'akun', 'gambar', 'tidak', 'tertahan', 'verifikasi', 'masuk', 'akun', 'mohon', 'perbaikan', 'kedepannya', 'opsi']",43,16,27,mohon benah sistem verifikasi masuk akun gambar tidak tahan verifikasi masuk akun mohon baik depan opsi,16,16
"Sangat user friendly dan bermanfaat utk Karir, Bisnis, maupun layanan profesional lainnya. Bagi yang kesulitan verifikasi dsb, yah berarti seleksi alam bekerja di anda, gausah pake LinkedIn segala macam, dtg langsung aja ke pos satpam bawa map.🤣",positif,2021-10-15,2021,sangat user friendly dan bermanfaat utk karir bisnis maupun layanan profesional lainnya bagi yang kesulitan verifikasi dsb yah berarti seleksi alam bekerja di anda gausah pake linkedin segala macam dtg langsung aja ke pos satpam bawa map,37,37,sangat user friendly dan bermanfaat untuk karir bisnis maupun layanan profesional lainnya bagi yang kesulitan verifikasi dan sebagainya ya berarti seleksi alam bekerja di anda tidak perlu pakai linkedin segala macam datang langsung saja ke pos satpam bawa map,37,39,"['sangat', 'user', 'friendly', 'dan', 'bermanfaat', 'untuk', 'karir', 'bisnis', 'maupun', 'layanan', 'profesional', 'lainnya', 'bagi', 'yang', 'kesulitan', 'verifikasi', 'dan', 'sebagainya', 'ya', 'berarti', 'seleksi', 'alam', 'bekerja', 'di', 'anda', 'tidak', 'perlu', 'pakai', 'linkedin', 'segala', 'macam', 'datang', 'langsung', 'saja', 'ke', 'pos', 'satpam', 'bawa', 'map']","['user', 'friendly', 'bermanfaat', 'karir', 'bisnis', 'layanan', 'profesional', 'kesulitan', 'verifikasi', 'ya', 'seleksi', 'alam', 'tidak', 'pakai', 'linkedin', 'langsung', 'pos', 'satpam', 'bawa', 'map']",39,20,19,user friendly manfaat karir bisnis layan profesional sulit verifikasi ya seleksi alam tidak pakai linkedin langsung pos satpam bawa map,20,20
Aplikasi terkampret yg prnah gw downloadm..mau verifikasi aja susah nya minta ampun pakai kuis segala nebak hewan menghadap ke atas..udah benar semua..pas terakhir salah..ulang lagi dari awal...hidup udah ribet jadi makin ribet...,negatif,2022-06-24,2022,aplikasi terkampret yg prnah gw downloadm mau verifikasi aja susah nya minta ampun pakai kuis segala nebak hewan menghadap ke atas udah benar semua pas terakhir salah ulang lagi dari awal hidup udah ribet jadi makin ribet,32,37,aplikasi terkampret yang pernah saya downloadm mau verifikasi saja susah nya minta ampun pakai kuis segala nebak hewan menghadap ke atas sudah benar semua pas terakhir salah ulang lagi dari awal hidup sudah rumit jadi makin rumit,37,37,"['aplikasi', 'terkampret', 'yang', 'pernah', 'saya', 'downloadm', 'mau', 'verifikasi', 'saja', 'susah', 'nya', 'minta', 'ampun', 'pakai', 'kuis', 'segala', 'nebak', 'hewan', 'menghadap', 'ke', 'atas', 'sudah', 'benar', 'semua', 'pas', 'terakhir', 'salah', 'ulang', 'lagi', 'dari', 'awal', 'hidup', 'sudah', 'rumit', 'jadi', 'makin', 'rumit']","['aplikasi', 'terkampret', 'downloadm', 'verifikasi', 'susah', 'nya', 'ampun', 'pakai', 'kuis', 'nebak', 'hewan', 'menghadap', 'pas', 'salah', 'ulang', 'hidup', 'rumit', 'rumit']",37,18,19,aplikasi kampret downloadm verifikasi susah nya ampun pakai kuis nebak hewan hadap pas salah ulang hidup rumit rumit,18,18
"Aplikasi yg cukup baik, dengan adanya aplikasi ini dapat memudahkan para jobseeker dan recuiter untuk menemukan orang2 profesional, juga memberikan wawasan yg lebih luas dalam hal apapun.",positif,2020-07-01,2020,aplikasi yg cukup baik dengan adanya aplikasi ini dapat memudahkan para jobseeker dan recuiter untuk menemukan orang profesional juga memberikan wawasan yg lebih luas dalam hal apapun,27,27,aplikasi yang cukup baik dengan adanya aplikasi ini dapat memudahkan para jobseeker dan recuiter untuk menemukan orang profesional juga memberikan wawasan yang lebih luas dalam hal apapun,27,27,"['aplikasi', 'yang', 'cukup', 'baik', 'dengan', 'adanya', 'aplikasi', 'ini', 'dapat', 'memudahkan', 'para', 'jobseeker', 'dan', 'recuiter', 'untuk', 'menemukan', 'orang', 'profesional', 'juga', 'memberikan', 'wawasan', 'yang', 'lebih', 'luas', 'dalam', 'hal', 'apapun']","['aplikasi', 'aplikasi', 'memudahkan', 'jobseeker', 'recuiter', 'menemukan', 'orang', 'profesional', 'wawasan', 'luas', 'apapun']",27,11,16,aplikasi aplikasi mudah jobseeker recuiter temu orang profesional wawas luas apa,11,11
"Hai, LinkedIn team, terima kasih telah membuka kesempatan bagi saya bekerja di start up impian. Saran kedepannya, ada reminder to do list yang harus dilakukan oleh pengguna baru. Saya melihat masih banyak yang kebingungan untuk menggunakan app ini pertama kali. Thanks",positif,2021-02-06,2021,hai linkedin team terima kasih telah membuka kesempatan bagi saya bekerja di start up impian saran kedepannya ada reminder to do list yang harus dilakukan oleh pengguna baru saya melihat masih banyak yang kebingungan untuk menggunakan app ini pertama kali thanks,41,41,hai linkedin team terima kasih telah membuka kesempatan bagi saya bekerja di memulai up impian saran kedepannya ada reminder to do list yang harus dilakukan oleh pengguna baru saya melihat masih banyak yang kebingungan untuk menggunakan aplikasi ini pertama kali terima kasih,41,42,"['hai', 'linkedin', 'team', 'terima', 'kasih', 'telah', 'membuka', 'kesempatan', 'bagi', 'saya', 'bekerja', 'di', 'memulai', 'up', 'impian', 'saran', 'kedepannya', 'ada', 'reminder', 'to', 'do', 'list', 'yang', 'harus', 'dilakukan', 'oleh', 'pengguna', 'baru', 'saya', 'melihat', 'masih', 'banyak', 'yang', 'kebingungan', 'untuk', 'menggunakan', 'aplikasi', 'ini', 'pertama', 'kali', 'terima', 'kasih']","['hai', 'linkedin', 'team', 'terima', 'kasih', 'membuka', 'kesempatan', 'up', 'impian', 'saran', 'kedepannya', 'reminder', 'to', 'do', 'list', 'pengguna', 'kebingungan', 'aplikasi', 'kali', 'terima', 'kasih']",42,21,21,hai linkedin team terima kasih buka sempat up impi saran depan reminder to do list guna bingung aplikasi kali terima kasih,21,21
"Saya tidak bisa membuka linkedin baik itu mobile ataupun web, sedangkan notice lowongan kerja selalu masuk ke email saya, ketika saya bukak linked nggak bisa. Ini sungguh membuat saya kesal, saya harap admin bisa secepatnya respon email saya. Thanks",negatif,2020-12-25,2020,saya tidak bisa membuka linkedin baik itu mobile ataupun web sedangkan notice lowongan kerja selalu masuk ke email saya ketika saya bukak linked nggak bisa ini sungguh membuat saya kesal saya harap admin bisa secepatnya respon email saya thanks,39,39,saya tidak bisa membuka linkedin baik itu mobile ataupun web sedangkan notice lowongan kerja selalu masuk ke email saya ketika saya bukak linked tidak bisa ini sungguh membuat saya kesal saya harap admin bisa secepatnya respons email saya terima kasih,39,40,"['saya', 'tidak', 'bisa', 'membuka', 'linkedin', 'baik', 'itu', 'mobile', 'ataupun', 'web', 'sedangkan', 'notice', 'lowongan', 'kerja', 'selalu', 'masuk', 'ke', 'email', 'saya', 'ketika', 'saya', 'bukak', 'linked', 'tidak', 'bisa', 'ini', 'sungguh', 'membuat', 'saya', 'kesal', 'saya', 'harap', 'admin', 'bisa', 'secepatnya', 'respons', 'email', 'saya', 'terima', 'kasih']","['tidak', 'membuka', 'linkedin', 'mobile', 'web', 'notice', 'lowongan', 'kerja', 'masuk', 'email', 'bukak', 'linked', 'tidak', 'sungguh', 'kesal', 'harap', 'admin', 'secepatnya', 'respons', 'email', 'terima', 'kasih']",40,22,18,tidak buka linkedin mobile web notice lowong kerja masuk email bukak linked tidak sungguh kesal harap admin cepat respons email terima kasih,22,22
"Verifikasi nya bikin emosi, udah di klik sampe 30 kali nyoba, msh gak bisa terverifikasi, dikira gue robot apa.. aplikasi yang sok, emang org butuh banget, sampe verifikasi kayak gitu, mending hapus nih aplikasi... Kayak org butuh aja",negatif,2022-08-30,2022,verifikasi nya bikin emosi udah di klik sampe kali nyoba msh gak bisa terverifikasi dikira gue robot apa aplikasi yang sok emang org butuh banget sampe verifikasi kayak gitu mending hapus nih aplikasi kayak org butuh aja,38,37,verifikasi nya bikin emosi sudah di klik sampai kali mencoba masih tidak bisa terverifikasi dikira saya robot apa aplikasi yang sok memang orang butuh banget sampai verifikasi kayak begitu mending hapus nih aplikasi kayak orang butuh saja,37,37,"['verifikasi', 'nya', 'bikin', 'emosi', 'sudah', 'di', 'klik', 'sampai', 'kali', 'mencoba', 'masih', 'tidak', 'bisa', 'terverifikasi', 'dikira', 'saya', 'robot', 'apa', 'aplikasi', 'yang', 'sok', 'memang', 'orang', 'butuh', 'banget', 'sampai', 'verifikasi', 'kayak', 'begitu', 'mending', 'hapus', 'nih', 'aplikasi', 'kayak', 'orang', 'butuh', 'saja']","['verifikasi', 'nya', 'bikin', 'emosi', 'klik', 'kali', 'mencoba', 'tidak', 'terverifikasi', 'robot', 'aplikasi', 'sok', 'orang', 'butuh', 'banget', 'verifikasi', 'kayak', 'mending', 'hapus', 'nih', 'aplikasi', 'kayak', 'orang', 'butuh']",37,24,13,verifikasi nya bikin emosi klik kali coba tidak verifikasi robot aplikasi sok orang butuh banget verifikasi kayak mending hapus nih aplikasi kayak orang butuh,24,24
"Verifikasi tidak efisien membuang waktu dan tenaga saya hanya untuk memilih gambar ke atas yang hasilnya selalu salah, kenapa aplikasi seperti ini menggunakan cara verifikasi yang sangat buruk.",negatif,2022-12-29,2022,verifikasi tidak efisien membuang waktu dan tenaga saya hanya untuk memilih gambar ke atas yang hasilnya selalu salah kenapa aplikasi seperti ini menggunakan cara verifikasi yang sangat buruk,28,28,verifikasi tidak efisien membuang waktu dan tenaga saya hanya untuk memilih gambar ke atas yang hasilnya selalu salah kenapa aplikasi seperti ini menggunakan cara verifikasi yang sangat buruk,28,28,"['verifikasi', 'tidak', 'efisien', 'membuang', 'waktu', 'dan', 'tenaga', 'saya', 'hanya', 'untuk', 'memilih', 'gambar', 'ke', 'atas', 'yang', 'hasilnya', 'selalu', 'salah', 'kenapa', 'aplikasi', 'seperti', 'ini', 'menggunakan', 'cara', 'verifikasi', 'yang', 'sangat', 'buruk']","['verifikasi', 'tidak', 'efisien', 'membuang', 'tenaga', 'memilih', 'gambar', 'hasilnya', 'salah', 'aplikasi', 'verifikasi', 'buruk']",28,12,16,verifikasi tidak efisien buang tenaga pilih gambar hasil salah aplikasi verifikasi buruk,12,12
"Banyak eror, waktu posting sesuatu di notifikasi ada yg komentar tp malah hilang pas mau dibalas, gmn mau ber koneksi ke orang lain klok mau balas komentar di postingan aja hilang tolong diperbaiki",negatif,2024-01-04,2024,banyak eror waktu posting sesuatu di notifikasi ada yg komentar tp malah hilang pas mau dibalas gmn mau ber koneksi ke orang lain klok mau balas komentar di postingan aja hilang tolong diperbaiki,33,33,banyak error waktu posting sesuatu di notifikasi ada yang komentar tapi bahkan hilang pas mau di balas bagaimana mau ber koneksi ke orang lain klok mau balas komentar di postingan saja hilang tolong di perbaiki,33,35,"['banyak', 'error', 'waktu', 'posting', 'sesuatu', 'di', 'notifikasi', 'ada', 'yang', 'komentar', 'tapi', 'bahkan', 'hilang', 'pas', 'mau', 'di', 'balas', 'bagaimana', 'mau', 'ber', 'koneksi', 'ke', 'orang', 'lain', 'klok', 'mau', 'balas', 'komentar', 'di', 'postingan', 'saja', 'hilang', 'tolong', 'di', 'perbaiki']","['error', 'posting', 'notifikasi', 'komentar', 'hilang', 'pas', 'balas', 'ber', 'koneksi', 'orang', 'klok', 'balas', 'komentar', 'postingan', 'hilang', 'tolong', 'perbaiki']",35,17,18,error posting notifikasi komentar hilang pas balas ber koneksi orang klok balas komentar postingan hilang tolong baik,17,17
Aplikasi media sosial yang sangat berguna karena berfokus kepada dunia pekerjaan. Sangat memudahkan saya untuk mencari pekerjaan yang saya minati dan bertemu dengan relasi orang baru.,positif,2021-08-11,2021,aplikasi media sosial yang sangat berguna karena berfokus kepada dunia pekerjaan sangat memudahkan saya untuk mencari pekerjaan yang saya minati dan bertemu dengan relasi orang baru,26,26,aplikasi media sosial yang sangat berguna karena berfokus kepada dunia pekerjaan sangat memudahkan saya untuk mencari pekerjaan yang saya minati dan bertemu dengan relasi orang baru,26,26,"['aplikasi', 'media', 'sosial', 'yang', 'sangat', 'berguna', 'karena', 'berfokus', 'kepada', 'dunia', 'pekerjaan', 'sangat', 'memudahkan', 'saya', 'untuk', 'mencari', 'pekerjaan', 'yang', 'saya', 'minati', 'dan', 'bertemu', 'dengan', 'relasi', 'orang', 'baru']","['aplikasi', 'media', 'sosial', 'berguna', 'berfokus', 'dunia', 'pekerjaan', 'memudahkan', 'mencari', 'pekerjaan', 'minati', 'bertemu', 'relasi', 'orang']",26,14,12,aplikasi media sosial guna fokus dunia kerja mudah cari kerja minat temu relasi orang,14,14
"Aplikasi tertolol yang pernah gua kenal verifikasi dengan pertanyaan terbodoh yang pernah gua liat,, Udh gua klik gambar yang menghadap ke atas malah salah udah gua ulang² ttp salah.. Auto uninstall.. Bye",negatif,2022-12-29,2022,aplikasi tertolol yang pernah gua kenal verifikasi dengan pertanyaan terbodoh yang pernah gua liat udh gua klik gambar yang menghadap ke atas malah salah udah gua ulang² ttp salah auto uninstall bye,32,32,aplikasi tertolol yang pernah saya kenal verifikasi dengan pertanyaan terbodoh yang pernah saya lihat sudah saya klik gambar yang menghadap ke atas bahkan salah sudah saya ulang² tetap salah otomatis uninstall bye,32,32,"['aplikasi', 'tertolol', 'yang', 'pernah', 'saya', 'kenal', 'verifikasi', 'dengan', 'pertanyaan', 'terbodoh', 'yang', 'pernah', 'saya', 'lihat', 'sudah', 'saya', 'klik', 'gambar', 'yang', 'menghadap', 'ke', 'atas', 'bahkan', 'salah', 'sudah', 'saya', 'ulang²', 'tetap', 'salah', 'otomatis', 'uninstall', 'bye']","['aplikasi', 'tertolol', 'kenal', 'verifikasi', 'terbodoh', 'lihat', 'klik', 'gambar', 'menghadap', 'salah', 'ulang²', 'salah', 'otomatis', 'uninstall', 'bye']",32,15,17,aplikasi tolol kenal verifikasi bodoh lihat klik gambar hadap salah ulang salah otomatis uninstall bye,15,15
"Senang menggunakan aplikasi ini. Banyak dapat relasi, bisa berbagi informasi secara cepat. Semoga ke depan akan ada fitur fitur tambahan yg bisa menjadikan aplikasi ini semakin ia the best...",positif,2020-06-28,2020,senang menggunakan aplikasi ini banyak dapat relasi bisa berbagi informasi secara cepat semoga ke depan akan ada fitur fitur tambahan yg bisa menjadikan aplikasi ini semakin ia the best,29,29,senang menggunakan aplikasi ini banyak dapat relasi bisa berbagi informasi secara cepat semoga ke depan akan ada fitur fitur tambahan yang bisa menjadikan aplikasi ini semakin iya the terbaik,29,29,"['senang', 'menggunakan', 'aplikasi', 'ini', 'banyak', 'dapat', 'relasi', 'bisa', 'berbagi', 'informasi', 'secara', 'cepat', 'semoga', 'ke', 'depan', 'akan', 'ada', 'fitur', 'fitur', 'tambahan', 'yang', 'bisa', 'menjadikan', 'aplikasi', 'ini', 'semakin', 'iya', 'the', 'terbaik']","['senang', 'aplikasi', 'relasi', 'berbagi', 'informasi', 'cepat', 'semoga', 'fitur', 'fitur', 'tambahan', 'menjadikan', 'aplikasi', 'iya', 'the', 'terbaik']",29,15,14,senang aplikasi relasi bagi informasi cepat moga fitur fitur tambah jadi aplikasi iya the baik,15,15
Senang bisa terhubung dengan orang orang pintar dan high level di hotel tapi sayang belum pernah beruntung tiap kali coba apply loker yang ada.,positif,2020-06-02,2020,senang bisa terhubung dengan orang orang pintar dan high level di hotel tapi sayang belum pernah beruntung tiap kali coba apply loker yang ada,24,24,senang bisa terhubung dengan orang orang pintar dan high level di hotel tapi sayang belum pernah beruntung tiap kali coba apply loker yang ada,24,24,"['senang', 'bisa', 'terhubung', 'dengan', 'orang', 'orang', 'pintar', 'dan', 'high', 'level', 'di', 'hotel', 'tapi', 'sayang', 'belum', 'pernah', 'beruntung', 'tiap', 'kali', 'coba', 'apply', 'loker', 'yang', 'ada']","['senang', 'terhubung', 'orang', 'orang', 'pintar', 'high', 'level', 'hotel', 'sayang', 'beruntung', 'kali', 'coba', 'apply', 'loker']",24,14,10,senang hubung orang orang pintar high level hotel sayang untung kali coba apply loker,14,14
"Cari gambar menghadap ke atas dengar benar??? Gambar nya ajah mengahadap dengan benar semua. Aneh nih, kenapa bukan gambar kaya lalu lintas / zebra cros / jembatan / mobil",negatif,2022-05-22,2022,cari gambar menghadap ke atas dengar benar gambar nya ajah mengahadap dengan benar semua aneh nih kenapa bukan gambar kaya lalu lintas zebra cros jembatan mobil,29,26,cari gambar menghadap ke atas dengar benar gambar nya ajah mengahadap dengan benar semua aneh nih kenapa bukan gambar kayak lalu lintas zebra cros jembatan mobil,26,26,"['cari', 'gambar', 'menghadap', 'ke', 'atas', 'dengar', 'benar', 'gambar', 'nya', 'ajah', 'mengahadap', 'dengan', 'benar', 'semua', 'aneh', 'nih', 'kenapa', 'bukan', 'gambar', 'kayak', 'lalu', 'lintas', 'zebra', 'cros', 'jembatan', 'mobil']","['cari', 'gambar', 'menghadap', 'dengar', 'gambar', 'nya', 'ajah', 'mengahadap', 'aneh', 'nih', 'gambar', 'kayak', 'lintas', 'zebra', 'cros', 'jembatan', 'mobil']",26,17,9,cari gambar hadap dengar gambar nya ajah mengahadap aneh nih gambar kayak lintas zebra cros jembatan mobil,17,17
"Gak ada guna nya ini app,baru bikin udah keluar lagi masuk lagi harus pake verifikasi lagi ujung"" nya gak bisa masuk...bikin lagi malah keluar lagi kaya gitu aja terus...gak jelas app nya",negatif,2024-03-06,2024,gak ada guna nya ini app baru bikin udah keluar lagi masuk lagi harus pake verifikasi lagi ujung nya gak bisa masuk bikin lagi malah keluar lagi kaya gitu aja terus gak jelas app nya,32,35,tidak ada guna nya ini aplikasi baru bikin sudah keluar lagi masuk lagi harus pakai verifikasi lagi ujung nya tidak bisa masuk bikin lagi bahkan keluar lagi kayak begitu saja terus tidak jelas aplikasi nya,35,35,"['tidak', 'ada', 'guna', 'nya', 'ini', 'aplikasi', 'baru', 'bikin', 'sudah', 'keluar', 'lagi', 'masuk', 'lagi', 'harus', 'pakai', 'verifikasi', 'lagi', 'ujung', 'nya', 'tidak', 'bisa', 'masuk', 'bikin', 'lagi', 'bahkan', 'keluar', 'lagi', 'kayak', 'begitu', 'saja', 'terus', 'tidak', 'jelas', 'aplikasi', 'nya']","['tidak', 'nya', 'aplikasi', 'bikin', 'masuk', 'pakai', 'verifikasi', 'ujung', 'nya', 'tidak', 'masuk', 'bikin', 'kayak', 'tidak', 'aplikasi', 'nya']",35,16,19,tidak nya aplikasi bikin masuk pakai verifikasi ujung nya tidak masuk bikin kayak tidak aplikasi nya,16,16
"Bener2 aplikasi nya kacau. Masa mau login aja verifikasi ribet bgt, okelah biar gak bisa akun dihack. Tp ini sih keterlaluan udh bbrp kali mau login sampe gak bisa2. Cuma aplikasi loe doang yg begini",negatif,2023-06-08,2023,bener aplikasi nya kacau masa mau login aja verifikasi ribet bgt okelah biar gak bisa akun dihack tp ini sih keterlaluan udh bbrp kali mau login sampe gak bisa cuma aplikasi loe doang yg begini,35,35,benar aplikasi nya kacau masa mau login saja verifikasi rumit banget okelah biar tidak bisa akun dihack tapi ini sih keterlaluan sudah beberapa kali mau login sampai tidak bisa cuma aplikasi loe saja yang begini,35,35,"['benar', 'aplikasi', 'nya', 'kacau', 'masa', 'mau', 'login', 'saja', 'verifikasi', 'rumit', 'banget', 'okelah', 'biar', 'tidak', 'bisa', 'akun', 'dihack', 'tapi', 'ini', 'sih', 'keterlaluan', 'sudah', 'beberapa', 'kali', 'mau', 'login', 'sampai', 'tidak', 'bisa', 'cuma', 'aplikasi', 'loe', 'saja', 'yang', 'begini']","['aplikasi', 'nya', 'kacau', 'login', 'verifikasi', 'rumit', 'banget', 'okelah', 'biar', 'tidak', 'akun', 'dihack', 'sih', 'kali', 'login', 'tidak', 'aplikasi', 'loe']",35,18,17,aplikasi nya kacau login verifikasi rumit banget oke biar tidak akun dihack sih kali login tidak aplikasi loe,18,18
Always be communication to others one. And believe in and believe in good body. Jaringan yang empuk dan strategi perjumpaan dalam hubungan antar warga Jawaban dari penjaringan maupun dari dalam yaitu luar dalam nyata betul. Tunjukkan jumlah hal probadi atau wewenang dalam pemikiran yang sangat. Cari yang berpikiran positif dan sejuk iman dan motivasi yang kuat.,negatif,2022-06-16,2022,always be communication to others one and believe in and believe in good body jaringan yang empuk dan strategi perjumpaan dalam hubungan antar warga jawaban dari penjaringan maupun dari dalam yaitu luar dalam nyata betul tunjukkan jumlah hal probadi atau wewenang dalam pemikiran yang sangat cari yang berpikiran positif dan sejuk iman dan motivasi yang kuat,56,56,always be communication to others one and believe in and believe in bagus body jaringan yang empuk dan strategi perjumpaan dalam hubungan antar warga jawaban dari penjaringan maupun dari dalam yaitu luar dalam nyata betul tunjukkan jumlah hal probadi atau wewenang dalam pemikiran yang sangat cari yang berpikiran positif dan sejuk iman dan motivasi yang kuat,56,56,"['always', 'be', 'communication', 'to', 'others', 'one', 'and', 'believe', 'in', 'and', 'believe', 'in', 'bagus', 'body', 'jaringan', 'yang', 'empuk', 'dan', 'strategi', 'perjumpaan', 'dalam', 'hubungan', 'antar', 'warga', 'jawaban', 'dari', 'penjaringan', 'maupun', 'dari', 'dalam', 'yaitu', 'luar', 'dalam', 'nyata', 'betul', 'tunjukkan', 'jumlah', 'hal', 'probadi', 'atau', 'wewenang', 'dalam', 'pemikiran', 'yang', 'sangat', 'cari', 'yang', 'berpikiran', 'positif', 'dan', 'sejuk', 'iman', 'dan', 'motivasi', 'yang', 'kuat']","['always', 'be', 'communication', 'to', 'others', 'one', 'and', 'believe', 'in', 'and', 'believe', 'in', 'bagus', 'body', 'jaringan', 'empuk', 'strategi', 'perjumpaan', 'hubungan', 'warga', 'penjaringan', 'nyata', 'tunjukkan', 'probadi', 'wewenang', 'pemikiran', 'cari', 'berpikiran', 'positif', 'sejuk', 'iman', 'motivasi', 'kuat']",56,33,23,always be communication to others one and believe in and believe in bagus body jaring empuk strategi jumpa hubung warga jaring nyata tunjuk probadi wewenang pikir cari pikir positif sejuk iman motivasi kuat,33,33
"apa ini, baru install mau buat akun aja gabisa lanjut ke tahap selanjutnya, gw kira ngelag ya internetnya, taunya emang apknya aja yg ga jelas gabisa lanjut",negatif,2023-07-17,2023,apa ini baru install mau buat akun aja gabisa lanjut ke tahap selanjutnya gw kira ngelag ya internetnya taunya emang apknya aja yg ga jelas gabisa lanjut,27,27,apa ini baru install mau buat akun saja tidak bisa lanjut ke tahap selanjutnya saya kira lambat ya internetnya taunya memang aplikasinya saja yang tidak jelas tidak bisa lanjut,27,29,"['apa', 'ini', 'baru', 'install', 'mau', 'buat', 'akun', 'saja', 'tidak', 'bisa', 'lanjut', 'ke', 'tahap', 'selanjutnya', 'saya', 'kira', 'lambat', 'ya', 'internetnya', 'taunya', 'memang', 'aplikasinya', 'saja', 'yang', 'tidak', 'jelas', 'tidak', 'bisa', 'lanjut']","['install', 'akun', 'tidak', 'tahap', 'lambat', 'ya', 'internetnya', 'taunya', 'aplikasinya', 'tidak', 'tidak']",29,11,18,install akun tidak tahap lambat ya internetnya tau aplikasi tidak tidak,11,11
"Mantap appsnya, interaksi dan para usernya oke dan yg paling penting info seputar lowongan yg tdk terlewatkan",positif,2020-09-14,2020,mantap appsnya interaksi dan para usernya oke dan yg paling penting info seputar lowongan yg tdk terlewatkan,17,17,mantap aplikasinya interaksi dan para usernya oke dan yang paling penting informasi seputar lowongan yang tidak terlewatkan,17,17,"['mantap', 'aplikasinya', 'interaksi', 'dan', 'para', 'usernya', 'oke', 'dan', 'yang', 'paling', 'penting', 'informasi', 'seputar', 'lowongan', 'yang', 'tidak', 'terlewatkan']","['mantap', 'aplikasinya', 'interaksi', 'usernya', 'oke', 'informasi', 'seputar', 'lowongan', 'tidak', 'terlewatkan']",17,10,7,mantap aplikasi interaksi usernya oke informasi putar lowong tidak lewat,10,10
"Terima kasih telah menggunakan LinkedIn! Kami memperbarui aplikasi secara berkala untuk memperbaiki bug, meningkatkan performa, dan menambahkan fitur baru guna membantu Anda terhubung dengan jaringan profesional dan membina karier Anda.",positif,2021-10-17,2021,terima kasih telah menggunakan linkedin kami memperbarui aplikasi secara berkala untuk memperbaiki bug meningkatkan performa dan menambahkan fitur baru guna membantu anda terhubung dengan jaringan profesional dan membina karier anda,30,30,terima kasih telah menggunakan linkedin kami memperbarui aplikasi secara berkala untuk memperbaiki bug meningkatkan performa dan menambahkan fitur baru guna membantu anda terhubung dengan jaringan profesional dan membina karier anda,30,30,"['terima', 'kasih', 'telah', 'menggunakan', 'linkedin', 'kami', 'memperbarui', 'aplikasi', 'secara', 'berkala', 'untuk', 'memperbaiki', 'bug', 'meningkatkan', 'performa', 'dan', 'menambahkan', 'fitur', 'baru', 'guna', 'membantu', 'anda', 'terhubung', 'dengan', 'jaringan', 'profesional', 'dan', 'membina', 'karier', 'anda']","['terima', 'kasih', 'linkedin', 'memperbarui', 'aplikasi', 'berkala', 'memperbaiki', 'bug', 'meningkatkan', 'performa', 'fitur', 'membantu', 'terhubung', 'jaringan', 'profesional', 'membina', 'karier']",30,17,13,terima kasih linkedin baru aplikasi kala baik bug tingkat performa fitur bantu hubung jaring profesional bina karier,17,17
"Saya sangat membutuhkan pekerjaan. Akan tetapi saya hanya lulusan sma tapi saya akan tetap mencari pekerjaan dimanapun , meskipun saya tahu setelah beberapa bulan saya membaca loker2nya yg dibutuhkan d3/ s1 . Udahlah .terimakasih linkedIn.",positif,2022-09-05,2022,saya sangat membutuhkan pekerjaan akan tetapi saya hanya lulusan sma tapi saya akan tetap mencari pekerjaan dimanapun meskipun saya tahu setelah beberapa bulan saya membaca loker nya yg dibutuhkan d s udahlah terimakasih linkedin,35,34,saya sangat membutuhkan pekerjaan akan tetapi saya hanya lulusan sama tapi saya akan tetap mencari pekerjaan dimanapun meskipun saya tahu setelah beberapa bulan saya membaca loker nya yang dibutuhkan di s udahlah terima kasih linkedin,34,35,"['saya', 'sangat', 'membutuhkan', 'pekerjaan', 'akan', 'tetapi', 'saya', 'hanya', 'lulusan', 'sama', 'tapi', 'saya', 'akan', 'tetap', 'mencari', 'pekerjaan', 'dimanapun', 'meskipun', 'saya', 'tahu', 'setelah', 'beberapa', 'bulan', 'saya', 'membaca', 'loker', 'nya', 'yang', 'dibutuhkan', 'di', 's', 'udahlah', 'terima', 'kasih', 'linkedin']","['membutuhkan', 'pekerjaan', 'lulusan', 'mencari', 'pekerjaan', 'dimanapun', 'membaca', 'loker', 'nya', 'dibutuhkan', 's', 'udahlah', 'terima', 'kasih', 'linkedin']",35,15,20,butuh kerja lulus cari kerja mana baca loker nya butuh s udahlah terima kasih linkedin,15,15
"Suka sekali, sebuah aplikasi yang memberikan manfaat yang besar, dapat berkenalan dengan para praktisi ahli dan profesional di berbagai perusahaan dan berbagai bidang bisnis. Terimakasih",positif,2020-05-22,2020,suka sekali sebuah aplikasi yang memberikan manfaat yang besar dapat berkenalan dengan para praktisi ahli dan profesional di berbagai perusahaan dan berbagai bidang bisnis terimakasih,25,25,suka sekali sebuah aplikasi yang memberikan manfaat yang besar dapat berkenalan dengan para praktisi ahli dan profesional di berbagai perusahaan dan berbagai bidang bisnis terima kasih,25,26,"['suka', 'sekali', 'sebuah', 'aplikasi', 'yang', 'memberikan', 'manfaat', 'yang', 'besar', 'dapat', 'berkenalan', 'dengan', 'para', 'praktisi', 'ahli', 'dan', 'profesional', 'di', 'berbagai', 'perusahaan', 'dan', 'berbagai', 'bidang', 'bisnis', 'terima', 'kasih']","['suka', 'aplikasi', 'manfaat', 'berkenalan', 'praktisi', 'ahli', 'profesional', 'perusahaan', 'bidang', 'bisnis', 'terima', 'kasih']",26,12,14,suka aplikasi manfaat nal praktisi ahli profesional usaha bidang bisnis terima kasih,12,12
"Baru aja instal, suruh verifikasi kodenya ga muncul2, udah pake email, nomor wa, panggilan tlp, ga ada satupun kode yg muncul, gimana cara verifikasinya???",negatif,2023-12-09,2023,baru aja instal suruh verifikasi kodenya ga muncul udah pake email nomor wa panggilan tlp ga ada satupun kode yg muncul gimana cara verifikasinya,24,24,baru saja memasang suruh verifikasi kodenya tidak muncul sudah pakai email nomor whatsapp panggilan telpon tidak ada satupun kode yang muncul bagaimana cara verifikasinya,24,24,"['baru', 'saja', 'memasang', 'suruh', 'verifikasi', 'kodenya', 'tidak', 'muncul', 'sudah', 'pakai', 'email', 'nomor', 'whatsapp', 'panggilan', 'telpon', 'tidak', 'ada', 'satupun', 'kode', 'yang', 'muncul', 'bagaimana', 'cara', 'verifikasinya']","['memasang', 'suruh', 'verifikasi', 'kodenya', 'tidak', 'muncul', 'pakai', 'email', 'nomor', 'whatsapp', 'panggilan', 'telpon', 'tidak', 'satupun', 'kode', 'muncul', 'verifikasinya']",24,17,7,pasang suruh verifikasi kode tidak muncul pakai email nomor whatsapp panggil telpon tidak satu kode muncul verifikasi,17,17
Sangat bagus dan sangat membantu bagi profesional untuk sharing dan pencari lowongan pekerjaan yg prestis.trima kasih link.semoga di devlop trus untuk peningkatan layanan,positif,2021-01-17,2021,sangat bagus dan sangat membantu bagi profesional untuk sharing dan pencari lowongan pekerjaan yg prestis trima kasih link semoga di devlop trus untuk peningkatan layanan,23,25,sangat bagus dan sangat membantu bagi profesional untuk sharing dan pencari lowongan pekerjaan yang prestis terima kasih link semoga di devlop terus untuk peningkatan layanan,25,25,"['sangat', 'bagus', 'dan', 'sangat', 'membantu', 'bagi', 'profesional', 'untuk', 'sharing', 'dan', 'pencari', 'lowongan', 'pekerjaan', 'yang', 'prestis', 'terima', 'kasih', 'link', 'semoga', 'di', 'devlop', 'terus', 'untuk', 'peningkatan', 'layanan']","['bagus', 'membantu', 'profesional', 'sharing', 'pencari', 'lowongan', 'pekerjaan', 'prestis', 'terima', 'kasih', 'link', 'semoga', 'devlop', 'peningkatan', 'layanan']",25,15,10,bagus bantu profesional sharing cari lowong kerja prestis terima kasih link moga devlop tingkat layan,15,15
"Lowongannya lumayan lemgkap, namun sayang kebanyakan membutuhkan pengalaman minimal sekian tahun. Tapi linkedin ini lebih juara daripada aplikasi serupa.",positif,2022-05-09,2022,lowongannya lumayan lemgkap namun sayang kebanyakan membutuhkan pengalaman minimal sekian tahun tapi linkedin ini lebih juara daripada aplikasi serupa,19,19,lowongannya lumayan lemgkap namun sayang kebanyakan membutuhkan pengalaman minimal sekian tahun tapi linkedin ini lebih juara daripada aplikasi serupa,19,19,"['lowongannya', 'lumayan', 'lemgkap', 'namun', 'sayang', 'kebanyakan', 'membutuhkan', 'pengalaman', 'minimal', 'sekian', 'tahun', 'tapi', 'linkedin', 'ini', 'lebih', 'juara', 'daripada', 'aplikasi', 'serupa']","['lowongannya', 'lumayan', 'lemgkap', 'sayang', 'kebanyakan', 'membutuhkan', 'pengalaman', 'minimal', 'sekian', 'linkedin', 'juara', 'aplikasi']",19,12,7,lowong lumayan lemgkap sayang banyak butuh alam minimal sekian linkedin juara aplikasi,12,12
"Perbaiki masalah kode captcha pendaftaran tidak bisa berlanjut, verifikasi gambar terhenti di tahap akhir karena error tidak bisa terbaca dan verifikasi suara juga tidak berhasil terus mengulang kembali.",negatif,2022-05-20,2022,perbaiki masalah kode captcha pendaftaran tidak bisa berlanjut verifikasi gambar terhenti di tahap akhir karena error tidak bisa terbaca dan verifikasi suara juga tidak berhasil terus mengulang kembali,28,28,perbaikan masalah kode captcha pendaftaran tidak bisa berlanjut verifikasi gambar terhenti di tahap akhir karena error tidak bisa terbaca dan verifikasi suara juga tidak berhasil terus mengulang kembali,28,28,"['perbaikan', 'masalah', 'kode', 'captcha', 'pendaftaran', 'tidak', 'bisa', 'berlanjut', 'verifikasi', 'gambar', 'terhenti', 'di', 'tahap', 'akhir', 'karena', 'error', 'tidak', 'bisa', 'terbaca', 'dan', 'verifikasi', 'suara', 'juga', 'tidak', 'berhasil', 'terus', 'mengulang', 'kembali']","['perbaikan', 'kode', 'captcha', 'pendaftaran', 'tidak', 'berlanjut', 'verifikasi', 'gambar', 'terhenti', 'tahap', 'error', 'tidak', 'terbaca', 'verifikasi', 'suara', 'tidak', 'berhasil', 'mengulang']",28,18,10,baik kode captcha daftar tidak lanjut verifikasi gambar henti tahap error tidak baca verifikasi suara tidak hasil ulang,18,18
"Buffering-nya luar biasa. Setiap 10 detik pasti bermasalah, padahal ini premium apps huhu.",negatif,2020-06-26,2020,buffering nya luar biasa setiap detik pasti bermasalah padahal ini premium apps huhu,13,13,buffering nya luar biasa setiap detik pasti bermasalah padahal ini premium aplikasi huhu,13,13,"['buffering', 'nya', 'luar', 'biasa', 'setiap', 'detik', 'pasti', 'bermasalah', 'padahal', 'ini', 'premium', 'aplikasi', 'huhu']","['buffering', 'nya', 'detik', 'bermasalah', 'premium', 'aplikasi', 'huhu']",13,7,6,buffering nya detik masalah premium aplikasi huhu,7,7
"Sudah seharian saya coba login ke linkedin melalui web/mobile, namun hasilnya tetap saja blm bisa dibuka. Saya tidak bisa membalas panggilan pekerjaan yang datang. Sungguh kecewa dengan linkedin",negatif,2020-12-22,2020,sudah seharian saya coba login ke linkedin melalui web mobile namun hasilnya tetap saja blm bisa dibuka saya tidak bisa membalas panggilan pekerjaan yang datang sungguh kecewa dengan linkedin,28,29,sudah seharian saya coba login ke linkedin melalui web mobile namun hasilnya tetap saja belum bisa dibuka saya tidak bisa membalas panggilan pekerjaan yang datang sungguh kecewa dengan linkedin,29,29,"['sudah', 'seharian', 'saya', 'coba', 'login', 'ke', 'linkedin', 'melalui', 'web', 'mobile', 'namun', 'hasilnya', 'tetap', 'saja', 'belum', 'bisa', 'dibuka', 'saya', 'tidak', 'bisa', 'membalas', 'panggilan', 'pekerjaan', 'yang', 'datang', 'sungguh', 'kecewa', 'dengan', 'linkedin']","['seharian', 'coba', 'login', 'linkedin', 'web', 'mobile', 'hasilnya', 'dibuka', 'tidak', 'membalas', 'panggilan', 'pekerjaan', 'sungguh', 'kecewa', 'linkedin']",29,15,14,hari coba login linkedin web mobile hasil buka tidak balas panggil kerja sungguh kecewa linkedin,15,15
punya akun LinkedIn itu nggak bisa jd tolok ukur seseorang profesional di bidangnya & bukan opsi utama unt cari kerja yg ideal. Bahkan bisa dibilang nggak penting2 amat punya akun LinkedIn.,negatif,2023-09-10,2023,punya akun linkedin itu nggak bisa jd tolok ukur seseorang profesional di bidangnya bukan opsi utama unt cari kerja yg ideal bahkan bisa dibilang nggak penting amat punya akun linkedin,31,30,punya akun linkedin itu tidak bisa jadi tolok ukur seseorang profesional di bidangnya bukan opsi utama unt cari kerja yang ideal bahkan bisa dibilang tidak penting amat punya akun linkedin,30,30,"['punya', 'akun', 'linkedin', 'itu', 'tidak', 'bisa', 'jadi', 'tolok', 'ukur', 'seseorang', 'profesional', 'di', 'bidangnya', 'bukan', 'opsi', 'utama', 'unt', 'cari', 'kerja', 'yang', 'ideal', 'bahkan', 'bisa', 'dibilang', 'tidak', 'penting', 'amat', 'punya', 'akun', 'linkedin']","['akun', 'linkedin', 'tidak', 'tolok', 'ukur', 'profesional', 'bidangnya', 'opsi', 'utama', 'unt', 'cari', 'kerja', 'ideal', 'dibilang', 'tidak', 'akun', 'linkedin']",30,17,13,akun linkedin tidak tolok ukur profesional bidang opsi utama unt cari kerja ideal bilang tidak akun linkedin,17,17
"Aplikasi profesional yang dapat memberikan berbagai inspirasi untuk kemajuan diri dan khalayak, sukses selalu dan salam hormat.",positif,2022-10-01,2022,aplikasi profesional yang dapat memberikan berbagai inspirasi untuk kemajuan diri dan khalayak sukses selalu dan salam hormat,17,17,aplikasi profesional yang dapat memberikan berbagai inspirasi untuk kemajuan diri dan khalayak sukses selalu dan salam hormat,17,17,"['aplikasi', 'profesional', 'yang', 'dapat', 'memberikan', 'berbagai', 'inspirasi', 'untuk', 'kemajuan', 'diri', 'dan', 'khalayak', 'sukses', 'selalu', 'dan', 'salam', 'hormat']","['aplikasi', 'profesional', 'inspirasi', 'kemajuan', 'khalayak', 'sukses', 'salam', 'hormat']",17,8,9,aplikasi profesional inspirasi maju khalayak sukses salam hormat,8,8
"Saya sudah beberapa kali masuk, verifikasi nya lama sekali dan tidak ada hasilnya, akun yang lama juga bermasalah dan tidak bisa berinteraksi..",negatif,2023-11-02,2023,saya sudah beberapa kali masuk verifikasi nya lama sekali dan tidak ada hasilnya akun yang lama juga bermasalah dan tidak bisa berinteraksi,22,22,saya sudah beberapa kali masuk verifikasi nya lama sekali dan tidak ada hasilnya akun yang lama juga bermasalah dan tidak bisa berinteraksi,22,22,"['saya', 'sudah', 'beberapa', 'kali', 'masuk', 'verifikasi', 'nya', 'lama', 'sekali', 'dan', 'tidak', 'ada', 'hasilnya', 'akun', 'yang', 'lama', 'juga', 'bermasalah', 'dan', 'tidak', 'bisa', 'berinteraksi']","['kali', 'masuk', 'verifikasi', 'nya', 'tidak', 'hasilnya', 'akun', 'bermasalah', 'tidak', 'berinteraksi']",22,10,12,kali masuk verifikasi nya tidak hasil akun masalah tidak interaksi,10,10
"Linkedln memberi info lowongan terbaik dan pengalaman saya selalu menemukan hal baru, dengan info tidak terbatas memberi wawasan yang luas dan kesempatan besar untuk setiap perubahan. Thanks Linkedln.",positif,2020-01-28,2020,linkedln memberi info lowongan terbaik dan pengalaman saya selalu menemukan hal baru dengan info tidak terbatas memberi wawasan yang luas dan kesempatan besar untuk setiap perubahan thanks linkedln,28,28,linkedln memberi informasi lowongan terbaik dan pengalaman saya selalu menemukan hal baru dengan informasi tidak terbatas memberi wawasan yang luas dan kesempatan besar untuk setiap perubahan terima kasih linkedln,28,29,"['linkedln', 'memberi', 'informasi', 'lowongan', 'terbaik', 'dan', 'pengalaman', 'saya', 'selalu', 'menemukan', 'hal', 'baru', 'dengan', 'informasi', 'tidak', 'terbatas', 'memberi', 'wawasan', 'yang', 'luas', 'dan', 'kesempatan', 'besar', 'untuk', 'setiap', 'perubahan', 'terima', 'kasih', 'linkedln']","['linkedln', 'informasi', 'lowongan', 'terbaik', 'pengalaman', 'menemukan', 'informasi', 'tidak', 'terbatas', 'wawasan', 'luas', 'kesempatan', 'perubahan', 'terima', 'kasih', 'linkedln']",29,16,13,linkedln informasi lowong baik alam temu informasi tidak batas wawas luas sempat ubah terima kasih linkedln,16,16
"ini kenapa pas verifikasi gk bisa2 sih, ribet banget skrg mau login doang, pencet asal2an bener tp aps gambar terakhir selalu salah. Heran klo mau bikin verifikasi yg benerlah",negatif,2023-08-11,2023,ini kenapa pas verifikasi gk bisa sih ribet banget skrg mau login doang pencet asal an bener tp aps gambar terakhir selalu salah heran klo mau bikin verifikasi yg benerlah,29,30,ini kenapa pas verifikasi tidak bisa sih rumit banget sekarang mau login saja tekan asal an benar tapi aps gambar terakhir selalu salah heran kalau mau bikin verifikasi yang benerlah,30,30,"['ini', 'kenapa', 'pas', 'verifikasi', 'tidak', 'bisa', 'sih', 'rumit', 'banget', 'sekarang', 'mau', 'login', 'saja', 'tekan', 'asal', 'an', 'benar', 'tapi', 'aps', 'gambar', 'terakhir', 'selalu', 'salah', 'heran', 'kalau', 'mau', 'bikin', 'verifikasi', 'yang', 'benerlah']","['pas', 'verifikasi', 'tidak', 'sih', 'rumit', 'banget', 'login', 'tekan', 'an', 'aps', 'gambar', 'salah', 'heran', 'bikin', 'verifikasi', 'benerlah']",30,16,14,pas verifikasi tidak sih rumit banget login tekan an aps gambar salah heran bikin verifikasi benerlah,16,16
"Kenapa ya, saya engk bisa login saat menggunakan aplikasi Android padahal Android udh v 8, tapi saat saya pake web dilaptop bisa, saya jg udh instal ulang, tpi tetep engk bisa log in",negatif,2024-01-31,2024,kenapa ya saya engk bisa login saat menggunakan aplikasi android padahal android udh v tapi saat saya pake web dilaptop bisa saya jg udh instal ulang tpi tetep engk bisa log in,33,32,kenapa ya saya engk bisa login saat menggunakan aplikasi android padahal android sudah v tapi saat saya pakai web dilaptop bisa saya juga sudah memasang ulang tetapi tetap engk bisa log in,32,32,"['kenapa', 'ya', 'saya', 'engk', 'bisa', 'login', 'saat', 'menggunakan', 'aplikasi', 'android', 'padahal', 'android', 'sudah', 'v', 'tapi', 'saat', 'saya', 'pakai', 'web', 'dilaptop', 'bisa', 'saya', 'juga', 'sudah', 'memasang', 'ulang', 'tetapi', 'tetap', 'engk', 'bisa', 'log', 'in']","['ya', 'engk', 'login', 'aplikasi', 'android', 'android', 'v', 'pakai', 'web', 'dilaptop', 'memasang', 'ulang', 'engk', 'log', 'in']",32,15,17,ya engk login aplikasi android android v pakai web laptop pasang ulang engk log in,15,15
"App linkedin apa sdg ganguan yaa dr kmaren g bsa d download gagal terus,,, nyampe 91% macet disitu ga maju2,,,",negatif,2022-03-21,2022,app linkedin apa sdg ganguan yaa dr kmaren g bsa d download gagal terus nyampe macet disitu ga maju,20,19,aplikasi linkedin apa sedang ganguan ya dari kemarin tidak bisa di unduh gagal terus sampai macet disitu tidak maju,19,19,"['aplikasi', 'linkedin', 'apa', 'sedang', 'ganguan', 'ya', 'dari', 'kemarin', 'tidak', 'bisa', 'di', 'unduh', 'gagal', 'terus', 'sampai', 'macet', 'disitu', 'tidak', 'maju']","['aplikasi', 'linkedin', 'ganguan', 'ya', 'kemarin', 'tidak', 'unduh', 'gagal', 'macet', 'disitu', 'tidak', 'maju']",19,12,7,aplikasi linkedin ganguan ya kemarin tidak unduh gagal macet situ tidak maju,12,12
"Aplikasi bagus sekali, banyak manfaat nya, selain untuk mencari kerja juga bisa untuk membangun networking dan membangun diri",positif,2022-09-10,2022,aplikasi bagus sekali banyak manfaat nya selain untuk mencari kerja juga bisa untuk membangun networking dan membangun diri,18,18,aplikasi bagus sekali banyak manfaat nya selain untuk mencari kerja juga bisa untuk membangun networking dan membangun diri,18,18,"['aplikasi', 'bagus', 'sekali', 'banyak', 'manfaat', 'nya', 'selain', 'untuk', 'mencari', 'kerja', 'juga', 'bisa', 'untuk', 'membangun', 'networking', 'dan', 'membangun', 'diri']","['aplikasi', 'bagus', 'manfaat', 'nya', 'mencari', 'kerja', 'membangun', 'networking', 'membangun']",18,9,9,aplikasi bagus manfaat nya cari kerja bangun networking bangun,9,9
"Makin ksni makin gak jelas, sudah 1 bln ini mungguin hasil verifikasi data gak ada balasan lagi...entah gak tau knpa tiba² gak bisa login lagi ke akun ku.",negatif,2023-07-18,2023,makin ksni makin gak jelas sudah bln ini mungguin hasil verifikasi data gak ada balasan lagi entah gak tau knpa tiba² gak bisa login lagi ke akun ku,28,28,makin ksni makin tidak jelas sudah bulan ini mungguin hasil verifikasi data tidak ada balasan lagi entah tidak tahu kenapa tiba² tidak bisa login lagi ke akun saya,28,28,"['makin', 'ksni', 'makin', 'tidak', 'jelas', 'sudah', 'bulan', 'ini', 'mungguin', 'hasil', 'verifikasi', 'data', 'tidak', 'ada', 'balasan', 'lagi', 'entah', 'tidak', 'tahu', 'kenapa', 'tiba²', 'tidak', 'bisa', 'login', 'lagi', 'ke', 'akun', 'saya']","['ksni', 'tidak', 'mungguin', 'hasil', 'verifikasi', 'data', 'tidak', 'balasan', 'tidak', 'tiba²', 'tidak', 'login', 'akun']",28,13,15,ksni tidak mungguin hasil verifikasi data tidak balas tidak tiba tidak login akun,13,13
"Orang Pintar/Cerdas itu Banyak, Orang Baik juga Banyak, Tapi...Orang Yang BENAR tidaklah mudah didapat, Hebatlah jika Orang bisa hidupnya Bermanfaat untuk semuanya, Aamiin.",positif,2021-04-05,2021,orang pintar cerdas itu banyak orang baik juga banyak tapi orang yang benar tidaklah mudah didapat hebatlah jika orang bisa hidupnya bermanfaat untuk semuanya aamiin,23,25,orang pintar cerdas itu banyak orang baik juga banyak tapi orang yang benar tidaklah mudah didapat hebatlah jika orang bisa hidupnya bermanfaat untuk semuanya aamiin,25,25,"['orang', 'pintar', 'cerdas', 'itu', 'banyak', 'orang', 'baik', 'juga', 'banyak', 'tapi', 'orang', 'yang', 'benar', 'tidaklah', 'mudah', 'didapat', 'hebatlah', 'jika', 'orang', 'bisa', 'hidupnya', 'bermanfaat', 'untuk', 'semuanya', 'aamiin']","['orang', 'pintar', 'cerdas', 'orang', 'orang', 'tidaklah', 'mudah', 'hebatlah', 'orang', 'hidupnya', 'bermanfaat', 'aamiin']",25,12,13,orang pintar cerdas orang orang tidak mudah hebat orang hidup manfaat aamiin,12,12
"akun saya ditambahkan email yang tidak saya kenal, saya juga tidak bisa login karena tidak pernah mendapat notifikasi 6 digit di email. saat verifikasi harus mengulang terus, data saya apakah sudah dicuri ? tolong diperbaiki",negatif,2023-10-08,2023,akun saya ditambahkan email yang tidak saya kenal saya juga tidak bisa login karena tidak pernah mendapat notifikasi digit di email saat verifikasi harus mengulang terus data saya apakah sudah dicuri tolong diperbaiki,35,33,akun saya ditambahkan email yang tidak saya kenal saya juga tidak bisa login karena tidak pernah mendapat notifikasi digit di email saat verifikasi harus mengulang terus data saya apakah sudah dicuri tolong di perbaiki,33,34,"['akun', 'saya', 'ditambahkan', 'email', 'yang', 'tidak', 'saya', 'kenal', 'saya', 'juga', 'tidak', 'bisa', 'login', 'karena', 'tidak', 'pernah', 'mendapat', 'notifikasi', 'digit', 'di', 'email', 'saat', 'verifikasi', 'harus', 'mengulang', 'terus', 'data', 'saya', 'apakah', 'sudah', 'dicuri', 'tolong', 'di', 'perbaiki']","['akun', 'email', 'tidak', 'kenal', 'tidak', 'login', 'tidak', 'notifikasi', 'digit', 'email', 'verifikasi', 'mengulang', 'data', 'dicuri', 'tolong', 'perbaiki']",34,16,18,akun email tidak kenal tidak login tidak notifikasi digit email verifikasi ulang data curi tolong baik,16,16
"Aplikasi cacat, verifikasi gambar dah benar, akhir2 salah terus, dah nyoba pakek 3 hp, tetep aja salah. Perbaiki aja dulu itu verifikasi gambarnya.",negatif,2022-02-05,2022,aplikasi cacat verifikasi gambar dah benar akhir salah terus dah nyoba pakek hp tetep aja salah perbaiki aja dulu itu verifikasi gambarnya,23,22,aplikasi cacat verifikasi gambar sudah benar akhir salah terus sudah mencoba pakai handphone tetap saja salah perbaikan saja dahulu itu verifikasi gambarnya,22,22,"['aplikasi', 'cacat', 'verifikasi', 'gambar', 'sudah', 'benar', 'akhir', 'salah', 'terus', 'sudah', 'mencoba', 'pakai', 'handphone', 'tetap', 'saja', 'salah', 'perbaikan', 'saja', 'dahulu', 'itu', 'verifikasi', 'gambarnya']","['aplikasi', 'cacat', 'verifikasi', 'gambar', 'salah', 'mencoba', 'pakai', 'handphone', 'salah', 'perbaikan', 'verifikasi', 'gambarnya']",22,12,10,aplikasi cacat verifikasi gambar salah coba pakai handphone salah baik verifikasi gambar,12,12
"Sangat buruk, akun saya terkena hack. Bagaimana bisa? Seharusnya aplikasi sebesar ini bisa menangani hal-hal seperti ini, belum lagi mengganti password yang sulit. Terlalu ribet",negatif,2023-05-11,2023,sangat buruk akun saya terkena hack bagaimana bisa seharusnya aplikasi sebesar ini bisa menangani hal hal seperti ini belum lagi mengganti password yang sulit terlalu ribet,25,26,sangat buruk akun saya terkena hack bagaimana bisa seharusnya aplikasi sebesar ini bisa menangani hal hal seperti ini belum lagi mengganti password yang sulit terlalu rumit,26,26,"['sangat', 'buruk', 'akun', 'saya', 'terkena', 'hack', 'bagaimana', 'bisa', 'seharusnya', 'aplikasi', 'sebesar', 'ini', 'bisa', 'menangani', 'hal', 'hal', 'seperti', 'ini', 'belum', 'lagi', 'mengganti', 'password', 'yang', 'sulit', 'terlalu', 'rumit']","['buruk', 'akun', 'terkena', 'hack', 'aplikasi', 'menangani', 'mengganti', 'password', 'sulit', 'rumit']",26,10,16,buruk akun kena hack aplikasi tangan ganti password sulit rumit,10,10
"Sangat membantu untuk membuat konektifitas dengan kolega lainnya, serta mempermudah dalam mencari dan mendapatkan informasi pekerjaan.",positif,2021-07-07,2021,sangat membantu untuk membuat konektifitas dengan kolega lainnya serta mempermudah dalam mencari dan mendapatkan informasi pekerjaan,16,16,sangat membantu untuk membuat konektifitas dengan kolega lainnya serta mempermudah dalam mencari dan mendapatkan informasi pekerjaan,16,16,"['sangat', 'membantu', 'untuk', 'membuat', 'konektifitas', 'dengan', 'kolega', 'lainnya', 'serta', 'mempermudah', 'dalam', 'mencari', 'dan', 'mendapatkan', 'informasi', 'pekerjaan']","['membantu', 'konektifitas', 'kolega', 'mempermudah', 'mencari', 'informasi', 'pekerjaan']",16,7,9,bantu konektifitas kolega mudah cari informasi kerja,7,7
Aplikasi buat job seeker yang palinh fav karna UI/UX nya enak dipandang dan mudah untuk dipahami.,positif,2022-10-03,2022,aplikasi buat job seeker yang palinh fav karna ui ux nya enak dipandang dan mudah untuk dipahami,16,17,aplikasi buat kerja seeker yang palinh fav karena ui ux nya enak dipandang dan mudah untuk dipahami,17,17,"['aplikasi', 'buat', 'kerja', 'seeker', 'yang', 'palinh', 'fav', 'karena', 'ui', 'ux', 'nya', 'enak', 'dipandang', 'dan', 'mudah', 'untuk', 'dipahami']","['aplikasi', 'kerja', 'seeker', 'palinh', 'fav', 'ui', 'ux', 'nya', 'enak', 'dipandang', 'mudah', 'dipahami']",17,12,5,aplikasi kerja seeker palinh fav ui ux nya enak pandang mudah paham,12,12
"Tidak bisa masuk , sudah verifikasi mengunakan ktp dan sim dengan posisi foto yg benar , selalu muncul terjadi masalah silahkan coba lagi",negatif,2023-06-16,2023,tidak bisa masuk sudah verifikasi mengunakan ktp dan sim dengan posisi foto yg benar selalu muncul terjadi masalah silahkan coba lagi,23,21,tidak bisa masuk sudah verifikasi mengunakan ktp dan sim dengan posisi foto yang benar selalu muncul terjadi masalah silahkan coba lagi,21,21,"['tidak', 'bisa', 'masuk', 'sudah', 'verifikasi', 'mengunakan', 'ktp', 'dan', 'sim', 'dengan', 'posisi', 'foto', 'yang', 'benar', 'selalu', 'muncul', 'terjadi', 'masalah', 'silahkan', 'coba', 'lagi']","['tidak', 'masuk', 'verifikasi', 'mengunakan', 'ktp', 'sim', 'posisi', 'foto', 'muncul', 'silahkan', 'coba']",21,11,10,tidak masuk verifikasi mengunakan ktp sim posisi foto muncul silah coba,11,11
"Aplikasinya sangat bagus, membatu saya dalam mencari pekerjaan dan relasi profesional. Tingkatkan lagi layanannya!",positif,2022-07-16,2022,aplikasinya sangat bagus membatu saya dalam mencari pekerjaan dan relasi profesional tingkatkan lagi layanannya,14,14,aplikasi nya sangat bagus membantu saya dalam mencari pekerjaan dan relasi profesional tingkatkan lagi layanannya,14,15,"['aplikasi', 'nya', 'sangat', 'bagus', 'membantu', 'saya', 'dalam', 'mencari', 'pekerjaan', 'dan', 'relasi', 'profesional', 'tingkatkan', 'lagi', 'layanannya']","['aplikasi', 'nya', 'bagus', 'membantu', 'mencari', 'pekerjaan', 'relasi', 'profesional', 'tingkatkan', 'layanannya']",15,10,5,aplikasi nya bagus bantu cari kerja relasi profesional tingkat layan,10,10
"Apaaa sihhh, diverifikasi susah amat ya. Padahal disuruh pilih gambar yg menghadap ke atas tapi tetep salah. Gatau lagi dahhh kecewa",negatif,2021-10-11,2021,apaaa sihhh diverifikasi susah amat ya padahal disuruh pilih gambar yg menghadap ke atas tapi tetep salah gatau lagi dahhh kecewa,21,21,apaaa sihhh diverifikasi susah amat ya padahal disuruh pilih gambar yang menghadap ke atas tapi tetap salah tidak tahu lagi dahhh kecewa,21,22,"['apaaa', 'sihhh', 'diverifikasi', 'susah', 'amat', 'ya', 'padahal', 'disuruh', 'pilih', 'gambar', 'yang', 'menghadap', 'ke', 'atas', 'tapi', 'tetap', 'salah', 'tidak', 'tahu', 'lagi', 'dahhh', 'kecewa']","['apaaa', 'sihhh', 'diverifikasi', 'susah', 'ya', 'disuruh', 'pilih', 'gambar', 'menghadap', 'salah', 'tidak', 'dahhh', 'kecewa']",22,13,9,apaaa sihhh verifikasi susah ya suruh pilih gambar hadap salah tidak dahhh kecewa,13,13
"aplikasi tidak profesional, tiba2 akun saya dinonaktifkan tanpa pemberitahuan, padahal data real dan akurat dan tak pernah melangar sama sekali",negatif,2021-08-19,2021,aplikasi tidak profesional tiba akun saya dinonaktifkan tanpa pemberitahuan padahal data real dan akurat dan tak pernah melangar sama sekali,20,20,aplikasi tidak profesional tiba akun saya dinonaktifkan tanpa pemberitahuan padahal data real dan akurat dan tidak pernah melangar sama sekali,20,20,"['aplikasi', 'tidak', 'profesional', 'tiba', 'akun', 'saya', 'dinonaktifkan', 'tanpa', 'pemberitahuan', 'padahal', 'data', 'real', 'dan', 'akurat', 'dan', 'tidak', 'pernah', 'melangar', 'sama', 'sekali']","['aplikasi', 'tidak', 'profesional', 'akun', 'dinonaktifkan', 'pemberitahuan', 'data', 'real', 'akurat', 'tidak', 'melangar']",20,11,9,aplikasi tidak profesional akun nonaktif pemberitahuan data real akurat tidak melangar,11,11
"linkedin bego, ga gunaa, masa profil dasboard dah di perbarui beberapa bulan lalu dg perusahan yg baru, tpi waktu di search di browser yg muncul masi pekerjaan lama di laman depan browser -,-",negatif,2021-12-23,2021,linkedin bego ga gunaa masa profil dasboard dah di perbarui beberapa bulan lalu dg perusahan yg baru tpi waktu di search di browser yg muncul masi pekerjaan lama di laman depan browser,33,32,linkedin bodoh tidak gunaa masa profil dasboard sudah di perbarui beberapa bulan lalu dengan perusahan yang baru tetapi waktu di search di browser yang muncul masih pekerjaan lama di laman depan browser,32,32,"['linkedin', 'bodoh', 'tidak', 'gunaa', 'masa', 'profil', 'dasboard', 'sudah', 'di', 'perbarui', 'beberapa', 'bulan', 'lalu', 'dengan', 'perusahan', 'yang', 'baru', 'tetapi', 'waktu', 'di', 'search', 'di', 'browser', 'yang', 'muncul', 'masih', 'pekerjaan', 'lama', 'di', 'laman', 'depan', 'browser']","['linkedin', 'bodoh', 'tidak', 'gunaa', 'profil', 'dasboard', 'perbarui', 'perusahan', 'search', 'browser', 'muncul', 'pekerjaan', 'laman', 'browser']",32,14,18,linkedin bodoh tidak gunaa profil dasboard baru usah search browser muncul kerja laman browser,14,14
"Tidak bisa masuk, pas waktu mengisi kode chapta padahal sudah diisi malahan gak bisa masuk dan ata tulisan rechaptca belum diisi. Aplikasi terburuk yg pernah ada",negatif,2023-08-08,2023,tidak bisa masuk pas waktu mengisi kode chapta padahal sudah diisi malahan gak bisa masuk dan ata tulisan rechaptca belum diisi aplikasi terburuk yg pernah ada,26,26,tidak bisa masuk pas waktu mengisi kode chapta padahal sudah diisi malahan tidak bisa masuk dan ata tulisan rechaptca belum diisi aplikasi terburuk yang pernah ada,26,26,"['tidak', 'bisa', 'masuk', 'pas', 'waktu', 'mengisi', 'kode', 'chapta', 'padahal', 'sudah', 'diisi', 'malahan', 'tidak', 'bisa', 'masuk', 'dan', 'ata', 'tulisan', 'rechaptca', 'belum', 'diisi', 'aplikasi', 'terburuk', 'yang', 'pernah', 'ada']","['tidak', 'masuk', 'pas', 'mengisi', 'kode', 'chapta', 'diisi', 'tidak', 'masuk', 'ata', 'tulisan', 'rechaptca', 'diisi', 'aplikasi', 'terburuk']",26,15,11,tidak masuk pas isi kode chapta isi tidak masuk ata tulis rechaptca isi aplikasi buruk,15,15
Verifikasinya nyusahin. Udah di-klik gambar yang benar muncul notif kode noCaptha Anda tidak Valid atau belum diisi. Dicoba login dengan tebak angka sama aja di alihin ke tebak gambar.,negatif,2023-05-11,2023,verifikasinya nyusahin udah di klik gambar yang benar muncul notif kode nocaptha anda tidak valid atau belum diisi dicoba login dengan tebak angka sama aja di alihin ke tebak gambar,29,30,verifikasinya nyusahin sudah di klik gambar yang benar muncul notif kode nocaptha anda tidak valid atau belum diisi dicoba login dengan tebak angka sama saja di alihin ke tebak gambar,30,30,"['verifikasinya', 'nyusahin', 'sudah', 'di', 'klik', 'gambar', 'yang', 'benar', 'muncul', 'notif', 'kode', 'nocaptha', 'anda', 'tidak', 'valid', 'atau', 'belum', 'diisi', 'dicoba', 'login', 'dengan', 'tebak', 'angka', 'sama', 'saja', 'di', 'alihin', 'ke', 'tebak', 'gambar']","['verifikasinya', 'nyusahin', 'klik', 'gambar', 'muncul', 'notif', 'kode', 'nocaptha', 'tidak', 'valid', 'diisi', 'dicoba', 'login', 'tebak', 'angka', 'alihin', 'tebak', 'gambar']",30,18,12,verifikasi nyusahin klik gambar muncul notif kode nocaptha tidak valid isi coba login tebak angka alihin tebak gambar,18,18
"Cuma beberapa hari ga buka aplikasi, tiba tiba logout otomatis dan saat mencoba login akun sudah dibatasi.",negatif,2023-10-29,2023,cuma beberapa hari ga buka aplikasi tiba tiba logout otomatis dan saat mencoba login akun sudah dibatasi,17,17,cuma beberapa hari tidak buka aplikasi tiba tiba logout otomatis dan saat mencoba login akun sudah dibatasi,17,17,"['cuma', 'beberapa', 'hari', 'tidak', 'buka', 'aplikasi', 'tiba', 'tiba', 'logout', 'otomatis', 'dan', 'saat', 'mencoba', 'login', 'akun', 'sudah', 'dibatasi']","['tidak', 'buka', 'aplikasi', 'logout', 'otomatis', 'mencoba', 'login', 'akun', 'dibatasi']",17,9,8,tidak buka aplikasi logout otomatis coba login akun batas,9,9
"Sangat membantu bagi yang sedang mencari pekerjaan, kontrak mau berakhir dan yang ingin suasana baru dalam pekerjaan. Berbagai bidang pekerjaan, lokasi dalam negeri maupun luar negeri tersedia di sini.",positif,2020-09-07,2020,sangat membantu bagi yang sedang mencari pekerjaan kontrak mau berakhir dan yang ingin suasana baru dalam pekerjaan berbagai bidang pekerjaan lokasi dalam negeri maupun luar negeri tersedia di sini,29,29,sangat membantu bagi yang sedang mencari pekerjaan kontrak mau berakhir dan yang ingin suasana baru dalam pekerjaan berbagai bidang pekerjaan lokasi dalam negeri maupun luar negeri tersedia di sini,29,29,"['sangat', 'membantu', 'bagi', 'yang', 'sedang', 'mencari', 'pekerjaan', 'kontrak', 'mau', 'berakhir', 'dan', 'yang', 'ingin', 'suasana', 'baru', 'dalam', 'pekerjaan', 'berbagai', 'bidang', 'pekerjaan', 'lokasi', 'dalam', 'negeri', 'maupun', 'luar', 'negeri', 'tersedia', 'di', 'sini']","['membantu', 'mencari', 'pekerjaan', 'kontrak', 'suasana', 'pekerjaan', 'bidang', 'pekerjaan', 'lokasi', 'negeri', 'negeri', 'tersedia']",29,12,17,bantu cari kerja kontrak suasana kerja bidang kerja lokasi negeri negeri sedia,12,12
"Bad! mau login/regist susah banget. verifikasi captcha tidak jelas, verifikasi pertama sudah berhasil tiba-tiba disuruh verifikasi lagi dan berulang! SANGAT TIDAK JELAZZZZ",negatif,2023-10-16,2023,bad mau login regist susah banget verifikasi captcha tidak jelas verifikasi pertama sudah berhasil tiba tiba disuruh verifikasi lagi dan berulang sangat tidak jelazzzz,22,24,bad mau login regist susah banget verifikasi captcha tidak jelas verifikasi pertama sudah berhasil tiba tiba disuruh verifikasi lagi dan berulang sangat tidak jelazzzz,24,24,"['bad', 'mau', 'login', 'regist', 'susah', 'banget', 'verifikasi', 'captcha', 'tidak', 'jelas', 'verifikasi', 'pertama', 'sudah', 'berhasil', 'tiba', 'tiba', 'disuruh', 'verifikasi', 'lagi', 'dan', 'berulang', 'sangat', 'tidak', 'jelazzzz']","['bad', 'login', 'regist', 'susah', 'banget', 'verifikasi', 'captcha', 'tidak', 'verifikasi', 'berhasil', 'disuruh', 'verifikasi', 'berulang', 'tidak', 'jelazzzz']",24,15,9,bad login regist susah banget verifikasi captcha tidak verifikasi hasil suruh verifikasi ulang tidak jelazzzz,15,15
"Saya sangat senang dengan aplikasi linkedin, banyak kenalan baru dan bertemu teman teman lama dengan berbagai profesi dan karir..,dan ini saran aja..kalau bisa..jika ada postingan masalah politik dll..diluar fungsi linkedin...,jangan di posting...terima kasih...",positif,2022-10-01,2022,saya sangat senang dengan aplikasi linkedin banyak kenalan baru dan bertemu teman teman lama dengan berbagai profesi dan karir dan ini saran aja kalau bisa jika ada postingan masalah politik dll diluar fungsi linkedin jangan di posting terima kasih,33,39,saya sangat senang dengan aplikasi linkedin banyak kenalan baru dan bertemu teman teman lama dengan berbagai profesi dan karir dan ini saran saja kalau bisa jika ada postingan masalah politik dan lain lain diluar fungsi linkedin jangan di posting terima kasih,39,41,"['saya', 'sangat', 'senang', 'dengan', 'aplikasi', 'linkedin', 'banyak', 'kenalan', 'baru', 'dan', 'bertemu', 'teman', 'teman', 'lama', 'dengan', 'berbagai', 'profesi', 'dan', 'karir', 'dan', 'ini', 'saran', 'saja', 'kalau', 'bisa', 'jika', 'ada', 'postingan', 'masalah', 'politik', 'dan', 'lain', 'lain', 'diluar', 'fungsi', 'linkedin', 'jangan', 'di', 'posting', 'terima', 'kasih']","['senang', 'aplikasi', 'linkedin', 'kenalan', 'bertemu', 'teman', 'teman', 'profesi', 'karir', 'saran', 'postingan', 'politik', 'diluar', 'fungsi', 'linkedin', 'posting', 'terima', 'kasih']",41,18,23,senang aplikasi linkedin kenal temu teman teman profesi karir saran postingan politik luar fungsi linkedin posting terima kasih,18,18
"Sya pengguna aplikasi Linkedln,sangat bermanfaat sekali utk menunjang wawasan berbagai macam disiplin ilmu utk pencapain dunia usaha budaya dri berbagai macam latar belakang,semoga Linkedln semakin sukses.",positif,2020-10-24,2020,sya pengguna aplikasi linkedln sangat bermanfaat sekali utk menunjang wawasan berbagai macam disiplin ilmu utk pencapain dunia usaha budaya dri berbagai macam latar belakang semoga linkedln semakin sukses,26,28,saya pengguna aplikasi linkedln sangat bermanfaat sekali untuk menunjang wawasan berbagai macam disiplin ilmu untuk pencapain dunia usaha budaya dari berbagai macam latar belakang semoga linkedln semakin sukses,28,28,"['saya', 'pengguna', 'aplikasi', 'linkedln', 'sangat', 'bermanfaat', 'sekali', 'untuk', 'menunjang', 'wawasan', 'berbagai', 'macam', 'disiplin', 'ilmu', 'untuk', 'pencapain', 'dunia', 'usaha', 'budaya', 'dari', 'berbagai', 'macam', 'latar', 'belakang', 'semoga', 'linkedln', 'semakin', 'sukses']","['pengguna', 'aplikasi', 'linkedln', 'bermanfaat', 'menunjang', 'wawasan', 'disiplin', 'ilmu', 'pencapain', 'dunia', 'usaha', 'budaya', 'latar', 'semoga', 'linkedln', 'sukses']",28,16,12,guna aplikasi linkedln manfaat tunjang wawas disiplin ilmu pencapain dunia usaha budaya latar moga linkedln sukses,16,16
"Membuat akun baru sulit sekali. Mau minta kode verifikasi saja sulitnya minta ampun, sampai"" satu nomor saya di blokir, tidak bisa dipakai untuk dapat kode lagi. Ampuunnn dahh.",negatif,2023-12-13,2023,membuat akun baru sulit sekali mau minta kode verifikasi saja sulitnya minta ampun sampai satu nomor saya di blokir tidak bisa dipakai untuk dapat kode lagi ampuunnn dahh,28,28,membuat akun baru sulit sekali mau minta kode verifikasi saja sulitnya minta ampun sampai satu nomor saya di blokir tidak bisa dipakai untuk dapat kode lagi ampuunnn deh,28,28,"['membuat', 'akun', 'baru', 'sulit', 'sekali', 'mau', 'minta', 'kode', 'verifikasi', 'saja', 'sulitnya', 'minta', 'ampun', 'sampai', 'satu', 'nomor', 'saya', 'di', 'blokir', 'tidak', 'bisa', 'dipakai', 'untuk', 'dapat', 'kode', 'lagi', 'ampuunnn', 'deh']","['akun', 'sulit', 'kode', 'verifikasi', 'sulitnya', 'ampun', 'nomor', 'blokir', 'tidak', 'dipakai', 'kode', 'ampuunnn', 'deh']",28,13,15,akun sulit kode verifikasi sulit ampun nomor blokir tidak pakai kode ampuunnn deh,13,13
"Bagi yang mau mendaftar, jangan terkecoh dengan soalnya, pilih aja gambar yg normal posisinya. Nanti jg selesai... ''ini informasi yang mungkin berguna buat kalian''",negatif,2021-12-21,2021,bagi yang mau mendaftar jangan terkecoh dengan soalnya pilih aja gambar yg normal posisinya nanti jg selesai ini informasi yang mungkin berguna buat kalian,24,24,bagi yang mau mendaftar jangan terkecoh dengan soalnya pilih saja gambar yang normal posisinya nanti juga selesai ini informasi yang mungkin berguna buat kalian,24,24,"['bagi', 'yang', 'mau', 'mendaftar', 'jangan', 'terkecoh', 'dengan', 'soalnya', 'pilih', 'saja', 'gambar', 'yang', 'normal', 'posisinya', 'nanti', 'juga', 'selesai', 'ini', 'informasi', 'yang', 'mungkin', 'berguna', 'buat', 'kalian']","['mendaftar', 'terkecoh', 'pilih', 'gambar', 'normal', 'posisinya', 'selesai', 'informasi', 'berguna']",24,9,15,daftar kecoh pilih gambar normal posisi selesai informasi guna,9,9
"Jangan download, cmn buat verifikasi aja susahnya minta ampun. Padahal bener malah disalahin, ada lho nyoba verifikasi nyampe 20xan. Apk nya dulu nggak sesusah itu pdhl. Nggak recommended pokoknya, gausah download yg kesabarannya setipis tissue dibagi 2",negatif,2023-03-06,2023,jangan download cmn buat verifikasi aja susahnya minta ampun padahal bener malah disalahin ada lho nyoba verifikasi nyampe xan apk nya dulu nggak sesusah itu pdhl nggak recommended pokoknya gausah download yg kesabarannya setipis tissue dibagi,37,36,jangan unduh cuman buat verifikasi saja susahnya minta ampun padahal benar bahkan disalahin ada loh mencoba verifikasi sampai xan aplikasi nya dahulu tidak sesusah itu padahal tidak rekomendasi pokoknya tidak perlu unduh yang kesabarannya setipis tissue dibagi,36,37,"['jangan', 'unduh', 'cuman', 'buat', 'verifikasi', 'saja', 'susahnya', 'minta', 'ampun', 'padahal', 'benar', 'bahkan', 'disalahin', 'ada', 'loh', 'mencoba', 'verifikasi', 'sampai', 'xan', 'aplikasi', 'nya', 'dahulu', 'tidak', 'sesusah', 'itu', 'padahal', 'tidak', 'rekomendasi', 'pokoknya', 'tidak', 'perlu', 'unduh', 'yang', 'kesabarannya', 'setipis', 'tissue', 'dibagi']","['unduh', 'cuman', 'verifikasi', 'susahnya', 'ampun', 'disalahin', 'loh', 'mencoba', 'verifikasi', 'xan', 'aplikasi', 'nya', 'tidak', 'sesusah', 'tidak', 'rekomendasi', 'pokoknya', 'tidak', 'unduh', 'kesabarannya', 'setipis', 'tissue', 'dibagi']",37,23,14,unduh cuman verifikasi susah ampun disalahin loh coba verifikasi xan aplikasi nya tidak susah tidak rekomendasi pokok tidak unduh sabar setip tissue bagi,23,23
"Tolong dibenahi, mau login aja susahnya kayak mau masuk pns, verifikasi nya ribet banget, ngulang"" mulu, masalah udah setahun lebih kok ga beres beres.",negatif,2023-08-09,2023,tolong dibenahi mau login aja susahnya kayak mau masuk pns verifikasi nya ribet banget ngulang mulu masalah udah setahun lebih kok ga beres beres,24,24,tolong dibenahi mau login saja susahnya kayak mau masuk pns verifikasi nya rumit banget mengulang mulu masalah sudah setahun lebih kok tidak beres beres,24,24,"['tolong', 'dibenahi', 'mau', 'login', 'saja', 'susahnya', 'kayak', 'mau', 'masuk', 'pns', 'verifikasi', 'nya', 'rumit', 'banget', 'mengulang', 'mulu', 'masalah', 'sudah', 'setahun', 'lebih', 'kok', 'tidak', 'beres', 'beres']","['tolong', 'dibenahi', 'login', 'susahnya', 'kayak', 'masuk', 'pns', 'verifikasi', 'nya', 'rumit', 'banget', 'mengulang', 'mulu', 'setahun', 'tidak', 'beres', 'beres']",24,17,7,tolong benah login susah kayak masuk pns verifikasi nya rumit banget ulang mulu tahun tidak beres beres,17,17
"hallo nama saya randy aldhi kurniadi , aplikasi ini ini sangat bagus dan membantu dalam karier saya , saya belum merasakan sistem bug di dalam nya , saya harap dengan adanya aplikasi linkedIn ini membuka jalan saya untuk bekerja di salah satu starup besar di indonesia seperti gojek,ovo, buka lapak dan tokopedia",positif,2020-11-12,2020,hallo nama saya randy aldhi kurniadi aplikasi ini ini sangat bagus dan membantu dalam karier saya saya belum merasakan sistem bug di dalam nya saya harap dengan adanya aplikasi linkedin ini membuka jalan saya untuk bekerja di salah satu starup besar di indonesia seperti gojek ovo buka lapak dan tokopedia,52,50,halo nama saya randy aldhi kurniadi aplikasi ini ini sangat bagus dan membantu dalam karier saya saya belum merasakan sistem bug di dalam nya saya harap dengan adanya aplikasi linkedin ini membuka jalan saya untuk bekerja di salah satu starup besar di indonesia seperti gojek ovo buka lapak dan tokopedia,50,50,"['halo', 'nama', 'saya', 'randy', 'aldhi', 'kurniadi', 'aplikasi', 'ini', 'ini', 'sangat', 'bagus', 'dan', 'membantu', 'dalam', 'karier', 'saya', 'saya', 'belum', 'merasakan', 'sistem', 'bug', 'di', 'dalam', 'nya', 'saya', 'harap', 'dengan', 'adanya', 'aplikasi', 'linkedin', 'ini', 'membuka', 'jalan', 'saya', 'untuk', 'bekerja', 'di', 'salah', 'satu', 'starup', 'besar', 'di', 'indonesia', 'seperti', 'gojek', 'ovo', 'buka', 'lapak', 'dan', 'tokopedia']","['halo', 'nama', 'randy', 'aldhi', 'kurniadi', 'aplikasi', 'bagus', 'membantu', 'karier', 'merasakan', 'sistem', 'bug', 'nya', 'harap', 'aplikasi', 'linkedin', 'membuka', 'jalan', 'salah', 'starup', 'indonesia', 'gojek', 'ovo', 'buka', 'lapak', 'tokopedia']",50,26,24,halo nama randy aldhi kurniadi aplikasi bagus bantu karier rasa sistem bug nya harap aplikasi linkedin buka jalan salah starup indonesia gojek ovo buka lapak tokopedia,26,26
"Sekarang aplikasi ini tidak bisa untuk mengunggah foto. Jika kita tetap memaksa untuk mengunggahnya, maka aplikasi akan secara otomatis tertutup dengan sendirinya.",negatif,2020-07-03,2020,sekarang aplikasi ini tidak bisa untuk mengunggah foto jika kita tetap memaksa untuk mengunggahnya maka aplikasi akan secara otomatis tertutup dengan sendirinya,22,22,sekarang aplikasi ini tidak bisa untuk mengunggah foto jika kita tetap memaksa untuk mengunggahnya maka aplikasi akan secara otomatis tertutup dengan sendirinya,22,22,"['sekarang', 'aplikasi', 'ini', 'tidak', 'bisa', 'untuk', 'mengunggah', 'foto', 'jika', 'kita', 'tetap', 'memaksa', 'untuk', 'mengunggahnya', 'maka', 'aplikasi', 'akan', 'secara', 'otomatis', 'tertutup', 'dengan', 'sendirinya']","['aplikasi', 'tidak', 'mengunggah', 'foto', 'memaksa', 'mengunggahnya', 'aplikasi', 'otomatis', 'tertutup']",22,9,13,aplikasi tidak unggah foto paksa unggah aplikasi otomatis tutup,9,9
"Awalnya saya sudah senang bergabubg di linkedin tapi kmarin akun saya di nonaktifkan tanpa sebab, dan saya menerimanya lalu saya daftr pakai akun yang lain. Dan di nonaktifkan lagi tanpa pemberitauan dan tanpa sebab yg jelas . Akun yg 1 3 hari bergabung di nonaktifkan, yg ke 2 1 hari tiba2 dinonaktifkan dari pihak linkedin. Bgimana ya pdhal saya tdk melakukan apapun mohon infonya",negatif,2020-04-06,2020,awalnya saya sudah senang bergabubg di linkedin tapi kmarin akun saya di nonaktifkan tanpa sebab dan saya menerimanya lalu saya daftr pakai akun yang lain dan di nonaktifkan lagi tanpa pemberitauan dan tanpa sebab yg jelas akun yg hari bergabung di nonaktifkan yg ke hari tiba dinonaktifkan dari pihak linkedin bgimana ya pdhal saya tdk melakukan apapun mohon infonya,64,59,awalnya saya sudah senang bergabubg di linkedin tapi kemarin akun saya di nonaktifkan tanpa sebab dan saya menerimanya lalu saya daftr pakai akun yang lain dan di nonaktifkan lagi tanpa pemberitauan dan tanpa sebab yang jelas akun yang hari bergabung di nonaktifkan yang ke hari tiba dinonaktifkan dari pihak linkedin bgimana ya pdhal saya tidak melakukan apapun mohon informasinya,59,59,"['awalnya', 'saya', 'sudah', 'senang', 'bergabubg', 'di', 'linkedin', 'tapi', 'kemarin', 'akun', 'saya', 'di', 'nonaktifkan', 'tanpa', 'sebab', 'dan', 'saya', 'menerimanya', 'lalu', 'saya', 'daftr', 'pakai', 'akun', 'yang', 'lain', 'dan', 'di', 'nonaktifkan', 'lagi', 'tanpa', 'pemberitauan', 'dan', 'tanpa', 'sebab', 'yang', 'jelas', 'akun', 'yang', 'hari', 'bergabung', 'di', 'nonaktifkan', 'yang', 'ke', 'hari', 'tiba', 'dinonaktifkan', 'dari', 'pihak', 'linkedin', 'bgimana', 'ya', 'pdhal', 'saya', 'tidak', 'melakukan', 'apapun', 'mohon', 'informasinya']","['senang', 'bergabubg', 'linkedin', 'kemarin', 'akun', 'nonaktifkan', 'menerimanya', 'daftr', 'pakai', 'akun', 'nonaktifkan', 'pemberitauan', 'akun', 'bergabung', 'nonaktifkan', 'dinonaktifkan', 'linkedin', 'bgimana', 'ya', 'pdhal', 'tidak', 'apapun', 'mohon', 'informasinya']",59,24,35,senang bergabubg linkedin kemarin akun nonaktif terima daftr pakai akun nonaktif pemberitauan akun gabung nonaktif nonaktif linkedin bgimana ya pdhal tidak apa mohon informasi,24,24
"Verifikasinya jangan gambar kayak gitu, itu hal gak penting dan buang2 waktu ganti dengan gambar-gambar yang lebih mudah!",negatif,2021-12-10,2021,verifikasinya jangan gambar kayak gitu itu hal gak penting dan buang waktu ganti dengan gambar gambar yang lebih mudah,18,19,verifikasinya jangan gambar kayak begitu itu hal tidak penting dan buang waktu ganti dengan gambar gambar yang lebih mudah,19,19,"['verifikasinya', 'jangan', 'gambar', 'kayak', 'begitu', 'itu', 'hal', 'tidak', 'penting', 'dan', 'buang', 'waktu', 'ganti', 'dengan', 'gambar', 'gambar', 'yang', 'lebih', 'mudah']","['verifikasinya', 'gambar', 'kayak', 'tidak', 'buang', 'ganti', 'gambar', 'gambar', 'mudah']",19,9,10,verifikasi gambar kayak tidak buang ganti gambar gambar mudah,9,9
"IN Linksdln sangat bagus dan sangat membantu menemukan teman-teman di kontak atau cari teman baru melalui Linkedln ini.aplikasi yang sangat menarik dan membantu sekali,terima kasih",positif,2023-03-11,2023,in linksdln sangat bagus dan sangat membantu menemukan teman teman di kontak atau cari teman baru melalui linkedln ini aplikasi yang sangat menarik dan membantu sekali terima kasih,25,28,in linksdln sangat bagus dan sangat membantu menemukan teman teman di kontak atau cari teman baru melalui linkedln ini aplikasi yang sangat menarik dan membantu sekali terima kasih,28,28,"['in', 'linksdln', 'sangat', 'bagus', 'dan', 'sangat', 'membantu', 'menemukan', 'teman', 'teman', 'di', 'kontak', 'atau', 'cari', 'teman', 'baru', 'melalui', 'linkedln', 'ini', 'aplikasi', 'yang', 'sangat', 'menarik', 'dan', 'membantu', 'sekali', 'terima', 'kasih']","['in', 'linksdln', 'bagus', 'membantu', 'menemukan', 'teman', 'teman', 'kontak', 'cari', 'teman', 'linkedln', 'aplikasi', 'menarik', 'membantu', 'terima', 'kasih']",28,16,12,in linksdln bagus bantu temu teman teman kontak cari teman linkedln aplikasi tarik bantu terima kasih,16,16
"Tolong aplikasinya diperbaiki, saya kesulitan untuk log in, kendalanya selalu diminta untuk reCaptcha padahal sudah tertera verified. terima kasih",negatif,2023-08-02,2023,tolong aplikasinya diperbaiki saya kesulitan untuk log in kendalanya selalu diminta untuk recaptcha padahal sudah tertera verified terima kasih,19,19,tolong aplikasi nya di perbaiki saya kesulitan untuk log in kendalanya selalu diminta untuk recaptcha padahal sudah tertera verified terima kasih,19,21,"['tolong', 'aplikasi', 'nya', 'di', 'perbaiki', 'saya', 'kesulitan', 'untuk', 'log', 'in', 'kendalanya', 'selalu', 'diminta', 'untuk', 'recaptcha', 'padahal', 'sudah', 'tertera', 'verified', 'terima', 'kasih']","['tolong', 'aplikasi', 'nya', 'perbaiki', 'kesulitan', 'log', 'in', 'kendalanya', 'recaptcha', 'tertera', 'verified', 'terima', 'kasih']",21,13,8,tolong aplikasi nya baik sulit log in kendala recaptcha tera verified terima kasih,13,13
Kenapa aku tidak bisa meposting poto dan vidio di linkedln ini?apa salah akun aku ini tolong beri tahu?TOLONG PERBAIKIN AKUN AKU LINKEdln INI oke aku sudah tidak bisa update poto dan vidio lagi dari kemarin.linkedln aku tidak bisa mengirim ke grup tolong periksa linkedln aku agar aku bisa kirim ke grup lagi kalau mau mengirim ke grup ada tulisan gagal mengirim gitu saja kurang lebih tulisanya.tolong akun linkedln aku kalau posting vidio dari linkedln suka ada tulisan posting berhasil di hapus,negatif,2023-08-04,2023,kenapa aku tidak bisa meposting poto dan vidio di linkedln ini apa salah akun aku ini tolong beri tahu tolong perbaikin akun aku linkedln ini oke aku sudah tidak bisa update poto dan vidio lagi dari kemarin linkedln aku tidak bisa mengirim ke grup tolong periksa linkedln aku agar aku bisa kirim ke grup lagi kalau mau mengirim ke grup ada tulisan gagal mengirim gitu saja kurang lebih tulisanya tolong akun linkedln aku kalau posting vidio dari linkedln suka ada tulisan posting berhasil di hapus,81,85,kenapa aku tidak bisa meposting poto dan vidio di linkedln ini apa salah akun aku ini tolong beri tahu tolong perbaikin akun aku linkedln ini oke aku sudah tidak bisa diperbarui poto dan vidio lagi dari kemarin linkedln aku tidak bisa mengirim ke grup tolong periksa linkedln aku agar aku bisa kirim ke grup lagi kalau mau mengirim ke grup ada tulisan gagal mengirim begitu saja kurang lebih tulisanya tolong akun linkedln aku kalau posting vidio dari linkedln suka ada tulisan posting berhasil di hapus,85,85,"['kenapa', 'aku', 'tidak', 'bisa', 'meposting', 'poto', 'dan', 'vidio', 'di', 'linkedln', 'ini', 'apa', 'salah', 'akun', 'aku', 'ini', 'tolong', 'beri', 'tahu', 'tolong', 'perbaikin', 'akun', 'aku', 'linkedln', 'ini', 'oke', 'aku', 'sudah', 'tidak', 'bisa', 'diperbarui', 'poto', 'dan', 'vidio', 'lagi', 'dari', 'kemarin', 'linkedln', 'aku', 'tidak', 'bisa', 'mengirim', 'ke', 'grup', 'tolong', 'periksa', 'linkedln', 'aku', 'agar', 'aku', 'bisa', 'kirim', 'ke', 'grup', 'lagi', 'kalau', 'mau', 'mengirim', 'ke', 'grup', 'ada', 'tulisan', 'gagal', 'mengirim', 'begitu', 'saja', 'kurang', 'lebih', 'tulisanya', 'tolong', 'akun', 'linkedln', 'aku', 'kalau', 'posting', 'vidio', 'dari', 'linkedln', 'suka', 'ada', 'tulisan', 'posting', 'berhasil', 'di', 'hapus']","['tidak', 'meposting', 'poto', 'vidio', 'linkedln', 'salah', 'akun', 'tolong', 'tolong', 'perbaikin', 'akun', 'linkedln', 'oke', 'tidak', 'diperbarui', 'poto', 'vidio', 'kemarin', 'linkedln', 'tidak', 'mengirim', 'grup', 'tolong', 'periksa', 'linkedln', 'kirim', 'grup', 'mengirim', 'grup', 'tulisan', 'gagal', 'mengirim', 'tulisanya', 'tolong', 'akun', 'linkedln', 'posting', 'vidio', 'linkedln', 'suka', 'tulisan', 'posting', 'berhasil', 'hapus']",85,44,41,tidak meposting poto vidio linkedln salah akun tolong tolong perbaikin akun linkedln oke tidak baru poto vidio kemarin linkedln tidak kirim grup tolong periksa linkedln kirim grup kirim grup tulis gagal kirim tulisanya tolong akun linkedln posting vidio linkedln suka tulis posting hasil hapus,44,44
"verifikasi nomor kodenya ga muncul muncul, sampe akhirnya nomornya gabisa di daftarkan. kenapa coba, baru juga daftar udah susah begitu",negatif,2023-04-30,2023,verifikasi nomor kodenya ga muncul muncul sampe akhirnya nomornya gabisa di daftarkan kenapa coba baru juga daftar udah susah begitu,20,20,verifikasi nomor kodenya tidak muncul muncul sampai akhirnya nomornya tidak bisa di daftarkan kenapa coba baru juga daftar sudah susah begitu,20,21,"['verifikasi', 'nomor', 'kodenya', 'tidak', 'muncul', 'muncul', 'sampai', 'akhirnya', 'nomornya', 'tidak', 'bisa', 'di', 'daftarkan', 'kenapa', 'coba', 'baru', 'juga', 'daftar', 'sudah', 'susah', 'begitu']","['verifikasi', 'nomor', 'kodenya', 'tidak', 'muncul', 'muncul', 'nomornya', 'tidak', 'daftarkan', 'coba', 'daftar', 'susah']",21,12,9,verifikasi nomor kode tidak muncul muncul nomor tidak daftar coba daftar susah,12,12
"Terhubung dengan jaringan profesional, sangat menyenangkan, menambah ilmu dan lingkungan jaringan yang positif.",positif,2021-08-26,2021,terhubung dengan jaringan profesional sangat menyenangkan menambah ilmu dan lingkungan jaringan yang positif,13,13,terhubung dengan jaringan profesional sangat menyenangkan menambah ilmu dan lingkungan jaringan yang positif,13,13,"['terhubung', 'dengan', 'jaringan', 'profesional', 'sangat', 'menyenangkan', 'menambah', 'ilmu', 'dan', 'lingkungan', 'jaringan', 'yang', 'positif']","['terhubung', 'jaringan', 'profesional', 'menyenangkan', 'menambah', 'ilmu', 'lingkungan', 'jaringan', 'positif']",13,9,4,hubung jaring profesional senang tambah ilmu lingkung jaring positif,9,9
Ketika verifikasi security captcha selalu tidak valid padahal captcha sudah benar. Melakukan opsi suara sudah benar tapi selalu gagal login. Tolong bantu saya untuk login,negatif,2024-01-28,2024,ketika verifikasi security captcha selalu tidak valid padahal captcha sudah benar melakukan opsi suara sudah benar tapi selalu gagal login tolong bantu saya untuk login,25,25,ketika verifikasi security captcha selalu tidak valid padahal captcha sudah benar melakukan opsi suara sudah benar tapi selalu gagal login tolong bantu saya untuk login,25,25,"['ketika', 'verifikasi', 'security', 'captcha', 'selalu', 'tidak', 'valid', 'padahal', 'captcha', 'sudah', 'benar', 'melakukan', 'opsi', 'suara', 'sudah', 'benar', 'tapi', 'selalu', 'gagal', 'login', 'tolong', 'bantu', 'saya', 'untuk', 'login']","['verifikasi', 'security', 'captcha', 'tidak', 'valid', 'captcha', 'opsi', 'suara', 'gagal', 'login', 'tolong', 'bantu', 'login']",25,13,12,verifikasi security captcha tidak valid captcha opsi suara gagal login tolong bantu login,13,13
"ini Gimana ya. saya gabisa login ,karna sistem keamanan memilih gambar eror. sudah berpuluh"" kali tetap salah., dan memang gabisa masuk, tolong dibenahi",negatif,2021-10-05,2021,ini gimana ya saya gabisa login karna sistem keamanan memilih gambar eror sudah berpuluh kali tetap salah dan memang gabisa masuk tolong dibenahi,23,23,ini bagaimana ya saya tidak bisa login karena sistem keamanan memilih gambar error sudah berpuluh kali tetap salah dan memang tidak bisa masuk tolong dibenahi,23,25,"['ini', 'bagaimana', 'ya', 'saya', 'tidak', 'bisa', 'login', 'karena', 'sistem', 'keamanan', 'memilih', 'gambar', 'error', 'sudah', 'berpuluh', 'kali', 'tetap', 'salah', 'dan', 'memang', 'tidak', 'bisa', 'masuk', 'tolong', 'dibenahi']","['ya', 'tidak', 'login', 'sistem', 'keamanan', 'memilih', 'gambar', 'error', 'berpuluh', 'kali', 'salah', 'tidak', 'masuk', 'tolong', 'dibenahi']",25,15,10,ya tidak login sistem aman pilih gambar error puluh kali salah tidak masuk tolong benah,15,15
"aplikasi yang kacau, katanya verifikasi sebagai manusia, setelah berhasil dilalui malahan ada catatan merah diatas ""verifikasi tidak berhasil"" aneh..mohon penjelasannya bos admin, berniat atau tidak anda membuat aplikasi ini ?",negatif,2023-05-20,2023,aplikasi yang kacau katanya verifikasi sebagai manusia setelah berhasil dilalui malahan ada catatan merah diatas verifikasi tidak berhasil aneh mohon penjelasannya bos admin berniat atau tidak anda membuat aplikasi ini,30,30,aplikasi yang kacau katanya verifikasi sebagai manusia setelah berhasil dilalui malahan ada catatan merah diatas verifikasi tidak berhasil aneh mohon penjelasannya box admin berniat atau tidak anda membuat aplikasi ini,30,30,"['aplikasi', 'yang', 'kacau', 'katanya', 'verifikasi', 'sebagai', 'manusia', 'setelah', 'berhasil', 'dilalui', 'malahan', 'ada', 'catatan', 'merah', 'diatas', 'verifikasi', 'tidak', 'berhasil', 'aneh', 'mohon', 'penjelasannya', 'box', 'admin', 'berniat', 'atau', 'tidak', 'anda', 'membuat', 'aplikasi', 'ini']","['aplikasi', 'kacau', 'verifikasi', 'manusia', 'berhasil', 'catatan', 'merah', 'diatas', 'verifikasi', 'tidak', 'berhasil', 'aneh', 'mohon', 'penjelasannya', 'box', 'admin', 'berniat', 'tidak', 'aplikasi']",30,19,11,aplikasi kacau verifikasi manusia hasil catat merah atas verifikasi tidak hasil aneh mohon jelas box admin niat tidak aplikasi,19,19
Tolong bagi pengembang aplikasi ini menjelaskan kenapa akun saya dibatasi. Ketika saya login tiba2 akun dibatasi. Saya menjadi sulit ketika ingin melihat lowongan kerja.,negatif,2022-04-29,2022,tolong bagi pengembang aplikasi ini menjelaskan kenapa akun saya dibatasi ketika saya login tiba akun dibatasi saya menjadi sulit ketika ingin melihat lowongan kerja,24,24,tolong bagi pengembang aplikasi ini menjelaskan kenapa akun saya dibatasi ketika saya login tiba akun dibatasi saya menjadi sulit ketika ingin melihat lowongan kerja,24,24,"['tolong', 'bagi', 'pengembang', 'aplikasi', 'ini', 'menjelaskan', 'kenapa', 'akun', 'saya', 'dibatasi', 'ketika', 'saya', 'login', 'tiba', 'akun', 'dibatasi', 'saya', 'menjadi', 'sulit', 'ketika', 'ingin', 'melihat', 'lowongan', 'kerja']","['tolong', 'pengembang', 'aplikasi', 'akun', 'dibatasi', 'login', 'akun', 'dibatasi', 'sulit', 'lowongan', 'kerja']",24,11,13,tolong kembang aplikasi akun batas login akun batas sulit lowong kerja,11,11
"susah banget loginnya, disuruh verifikasi captcha trs padahal gambar yang ditekan udah bener. perbaiki aplikasinya, hilangkan fitur verifikasi captcha",negatif,2024-01-27,2024,susah banget loginnya disuruh verifikasi captcha trs padahal gambar yang ditekan udah bener perbaiki aplikasinya hilangkan fitur verifikasi captcha,19,19,susah banget loginnya disuruh verifikasi captcha terus padahal gambar yang ditekan sudah benar perbaikan aplikasi nya hilangkan fitur verifikasi captcha,19,20,"['susah', 'banget', 'loginnya', 'disuruh', 'verifikasi', 'captcha', 'terus', 'padahal', 'gambar', 'yang', 'ditekan', 'sudah', 'benar', 'perbaikan', 'aplikasi', 'nya', 'hilangkan', 'fitur', 'verifikasi', 'captcha']","['susah', 'banget', 'loginnya', 'disuruh', 'verifikasi', 'captcha', 'gambar', 'ditekan', 'perbaikan', 'aplikasi', 'nya', 'hilangkan', 'fitur', 'verifikasi', 'captcha']",20,15,5,susah banget loginnya suruh verifikasi captcha gambar tekan baik aplikasi nya hilang fitur verifikasi captcha,15,15
"Saya udh pnya akun di linked wktu itu sy buat via kiriman email dr linked tp pas sy donlod aplikasinya waktu login gk bs mengenali email dan no hp saya, hasilnya hrs bikin akun baru...mengecewakan",negatif,2021-03-23,2021,saya udh pnya akun di linked wktu itu sy buat via kiriman email dr linked tp pas sy donlod aplikasinya waktu login gk bs mengenali email dan no hp saya hasilnya hrs bikin akun baru mengecewakan,35,36,saya sudah pnya akun di linked waktu itu saya buat melalui kiriman email dari linked tapi pas saya download aplikasi nya waktu login tidak bisa mengenali email dan nomor handphone saya hasilnya harus bikin akun baru mengecewakan,36,37,"['saya', 'sudah', 'pnya', 'akun', 'di', 'linked', 'waktu', 'itu', 'saya', 'buat', 'melalui', 'kiriman', 'email', 'dari', 'linked', 'tapi', 'pas', 'saya', 'download', 'aplikasi', 'nya', 'waktu', 'login', 'tidak', 'bisa', 'mengenali', 'email', 'dan', 'nomor', 'handphone', 'saya', 'hasilnya', 'harus', 'bikin', 'akun', 'baru', 'mengecewakan']","['pnya', 'akun', 'linked', 'kiriman', 'email', 'linked', 'pas', 'download', 'aplikasi', 'nya', 'login', 'tidak', 'mengenali', 'email', 'nomor', 'handphone', 'hasilnya', 'bikin', 'akun', 'mengecewakan']",37,20,17,pnya akun linked kirim email linked pas download aplikasi nya login tidak nali email nomor handphone hasil bikin akun kecewa,20,20
"Verifikasi kek mau ujian psikotest😁,.. niat beda tp nyusahin end user UX nya benerin lah yg friendly dikit Suruh analisa muka katak yg menghadap ke atas kek mna😒 Pake sound malah di arahin ke gambar lg,tolong di perbaiki login verifikasinya, sayanglah udh bagus ini aplikasi",negatif,2021-03-16,2021,verifikasi kek mau ujian psikotest niat beda tp nyusahin end user ux nya benerin lah yg friendly dikit suruh analisa muka katak yg menghadap ke atas kek mna pake sound malah di arahin ke gambar lg tolong di perbaiki login verifikasinya sayanglah udh bagus ini aplikasi,45,46,verifikasi seperti mau ujian psikotest niat beda tapi nyusahin end user ux nya benerin lah yang friendly dikit suruh analisa muka katak yang menghadap ke atas seperti mana pakai sound bahkan di arahin ke gambar lagi tolong di perbaikan login verifikasinya sayanglah sudah bagus ini aplikasi,46,46,"['verifikasi', 'seperti', 'mau', 'ujian', 'psikotest', 'niat', 'beda', 'tapi', 'nyusahin', 'end', 'user', 'ux', 'nya', 'benerin', 'lah', 'yang', 'friendly', 'dikit', 'suruh', 'analisa', 'muka', 'katak', 'yang', 'menghadap', 'ke', 'atas', 'seperti', 'mana', 'pakai', 'sound', 'bahkan', 'di', 'arahin', 'ke', 'gambar', 'lagi', 'tolong', 'di', 'perbaikan', 'login', 'verifikasinya', 'sayanglah', 'sudah', 'bagus', 'ini', 'aplikasi']","['verifikasi', 'ujian', 'psikotest', 'niat', 'beda', 'nyusahin', 'end', 'user', 'ux', 'nya', 'benerin', 'friendly', 'dikit', 'suruh', 'analisa', 'muka', 'katak', 'menghadap', 'pakai', 'sound', 'arahin', 'gambar', 'tolong', 'perbaikan', 'login', 'verifikasinya', 'sayanglah', 'bagus', 'aplikasi']",46,29,17,verifikasi uji psikotest niat beda nyusahin end user ux nya benerin friendly dikit suruh analisa muka katak hadap pakai sound arahin gambar tolong baik login verifikasi sayang bagus aplikasi,29,29
"Tolong dibantu solusi pemecahan untuk masalah verifikasi tahap ke 2 dengan nomor ponsel, karna nomor ponsel yang terdaftar di acount saya sudah tidak bisa digunakan dan handphone saya sudah berganti. Saya hanya mempunya akses verifikasi melalui email saya. saya hanya berhasil di tahap ke 1",negatif,2022-04-12,2022,tolong dibantu solusi pemecahan untuk masalah verifikasi tahap ke dengan nomor ponsel karna nomor ponsel yang terdaftar di acount saya sudah tidak bisa digunakan dan handphone saya sudah berganti saya hanya mempunya akses verifikasi melalui email saya saya hanya berhasil di tahap ke,45,43,tolong dibantu solusi pemecahan untuk masalah verifikasi tahap ke dengan nomor ponsel karena nomor ponsel yang terdaftar di acount saya sudah tidak bisa digunakan dan handphone saya sudah berganti saya hanya mempunya akses verifikasi melalui email saya saya hanya berhasil di tahap ke,43,43,"['tolong', 'dibantu', 'solusi', 'pemecahan', 'untuk', 'masalah', 'verifikasi', 'tahap', 'ke', 'dengan', 'nomor', 'ponsel', 'karena', 'nomor', 'ponsel', 'yang', 'terdaftar', 'di', 'acount', 'saya', 'sudah', 'tidak', 'bisa', 'digunakan', 'dan', 'handphone', 'saya', 'sudah', 'berganti', 'saya', 'hanya', 'mempunya', 'akses', 'verifikasi', 'melalui', 'email', 'saya', 'saya', 'hanya', 'berhasil', 'di', 'tahap', 'ke']","['tolong', 'dibantu', 'solusi', 'pemecahan', 'verifikasi', 'tahap', 'nomor', 'ponsel', 'nomor', 'ponsel', 'terdaftar', 'acount', 'tidak', 'handphone', 'berganti', 'mempunya', 'akses', 'verifikasi', 'email', 'berhasil', 'tahap']",43,21,22,tolong bantu solusi pecah verifikasi tahap nomor ponsel nomor ponsel daftar acount tidak handphone ganti punya akses verifikasi email hasil tahap,21,21
Keren habis pokoknya,positif,2024-08-29,2024,keren habis pokoknya,3,3,keren habis pokoknya,3,3,"['keren', 'habis', 'pokoknya']","['keren', 'habis', 'pokoknya']",3,3,0,keren habis pokok,3,3
"Aplikasi ini Main komersil mulu, katanya ada premium gratis tapi masih tetap bayar, mending gak usah tampilin premium gratisnya",negatif,2024-02-01,2024,aplikasi ini main komersil mulu katanya ada premium gratis tapi masih tetap bayar mending gak usah tampilin premium gratisnya,19,19,aplikasi ini main komersil mulu katanya ada premium gratis tapi masih tetap bayar mending tidak usah tampilin premium gratisnya,19,19,"['aplikasi', 'ini', 'main', 'komersil', 'mulu', 'katanya', 'ada', 'premium', 'gratis', 'tapi', 'masih', 'tetap', 'bayar', 'mending', 'tidak', 'usah', 'tampilin', 'premium', 'gratisnya']","['aplikasi', 'main', 'komersil', 'mulu', 'premium', 'gratis', 'bayar', 'mending', 'tidak', 'tampilin', 'premium', 'gratisnya']",19,12,7,aplikasi main komersil mulu premium gratis bayar mending tidak tampilin premium gratis,12,12
"Maaf, aplikasinya rumit",negatif,2024-07-19,2024,maaf aplikasinya rumit,3,3,maaf aplikasi nya rumit,3,4,"['maaf', 'aplikasi', 'nya', 'rumit']","['maaf', 'aplikasi', 'nya', 'rumit']",4,4,0,maaf aplikasi nya rumit,4,4
"Msuk ny ja sulit,,pdhal saya kira app yang benar membantu",negatif,2024-04-28,2024,msuk ny ja sulit pdhal saya kira app yang benar membantu,10,11,msuk nya ja sulit pdhal saya kira aplikasi yang benar membantu,11,11,"['msuk', 'nya', 'ja', 'sulit', 'pdhal', 'saya', 'kira', 'aplikasi', 'yang', 'benar', 'membantu']","['msuk', 'nya', 'ja', 'sulit', 'pdhal', 'aplikasi', 'membantu']",11,7,4,msuk nya ja sulit pdhal aplikasi bantu,7,7
"HADUH MENGHABISKAN WAKTU 3 JAM CUMA BUAT VERIFIKASI GAMBAR GAJELAS, JAWABAN UDAH BENER SEMUA MALAH SALAH, GABISA GANTI PASSWORD PULA",negatif,2024-06-19,2024,haduh menghabiskan waktu jam cuma buat verifikasi gambar gajelas jawaban udah bener semua malah salah gabisa ganti password pula,20,19,haduh menghabiskan waktu jam cuma buat verifikasi gambar tidak jelas jawaban sudah benar semua bahkan salah tidak bisa ganti password pula,19,21,"['haduh', 'menghabiskan', 'waktu', 'jam', 'cuma', 'buat', 'verifikasi', 'gambar', 'tidak', 'jelas', 'jawaban', 'sudah', 'benar', 'semua', 'bahkan', 'salah', 'tidak', 'bisa', 'ganti', 'password', 'pula']","['haduh', 'menghabiskan', 'jam', 'verifikasi', 'gambar', 'tidak', 'salah', 'tidak', 'ganti', 'password']",21,10,11,haduh habis jam verifikasi gambar tidak salah tidak ganti password,10,10
"Bagaimana bisa akun saya dimasukin orang asing dan mengganti gmail terkait saya dengan gmail dia dan menghapus gmail saya sehingga akun saya berpindah tangan dengan mudahnya, kemudian saya membuat akun baru ternyata akses dibatasi padahal baru sehari akun saya dibuat dan tidak melanggar apapun. Saya dipersulit untuk mengakses akun saya sendiri sedangkan orang asing dengan mudahnya mengambil alih akun saya. Platform sekelas linkedin ternyata seperti ini ya. Kapok saya wes. Thx",negatif,2023-11-01,2023,bagaimana bisa akun saya dimasukin orang asing dan mengganti gmail terkait saya dengan gmail dia dan menghapus gmail saya sehingga akun saya berpindah tangan dengan mudahnya kemudian saya membuat akun baru ternyata akses dibatasi padahal baru sehari akun saya dibuat dan tidak melanggar apapun saya dipersulit untuk mengakses akun saya sendiri sedangkan orang asing dengan mudahnya mengambil alih akun saya platform sekelas linkedin ternyata seperti ini ya kapok saya wes thx,71,71,bagaimana bisa akun saya di masuk in orang asing dan mengganti gmail terkait saya dengan gmail dia dan menghapus gmail saya sehingga akun saya berpindah tangan dengan mudahnya kemudian saya membuat akun baru ternyata akses dibatasi padahal baru sehari akun saya dibuat dan tidak melanggar apapun saya dipersulit untuk mengakses akun saya sendiri sedangkan orang asing dengan mudahnya mengambil alih akun saya platform sekelas linkedin ternyata seperti ini ya kapok saya kita terima kasih,71,74,"['bagaimana', 'bisa', 'akun', 'saya', 'di', 'masuk', 'in', 'orang', 'asing', 'dan', 'mengganti', 'gmail', 'terkait', 'saya', 'dengan', 'gmail', 'dia', 'dan', 'menghapus', 'gmail', 'saya', 'sehingga', 'akun', 'saya', 'berpindah', 'tangan', 'dengan', 'mudahnya', 'kemudian', 'saya', 'membuat', 'akun', 'baru', 'ternyata', 'akses', 'dibatasi', 'padahal', 'baru', 'sehari', 'akun', 'saya', 'dibuat', 'dan', 'tidak', 'melanggar', 'apapun', 'saya', 'dipersulit', 'untuk', 'mengakses', 'akun', 'saya', 'sendiri', 'sedangkan', 'orang', 'asing', 'dengan', 'mudahnya', 'mengambil', 'alih', 'akun', 'saya', 'platform', 'sekelas', 'linkedin', 'ternyata', 'seperti', 'ini', 'ya', 'kapok', 'saya', 'kita', 'terima', 'kasih']","['akun', 'masuk', 'in', 'orang', 'asing', 'mengganti', 'gmail', 'terkait', 'gmail', 'menghapus', 'gmail', 'akun', 'berpindah', 'tangan', 'mudahnya', 'akun', 'akses', 'dibatasi', 'sehari', 'akun', 'tidak', 'melanggar', 'apapun', 'dipersulit', 'mengakses', 'akun', 'orang', 'asing', 'mudahnya', 'mengambil', 'alih', 'akun', 'platform', 'sekelas', 'linkedin', 'ya', 'kapok', 'terima', 'kasih']",74,39,35,akun masuk in orang asing ganti gmail kait gmail hapus gmail akun pindah tangan mudah akun akses batas hari akun tidak langgar apa sulit akses akun orang asing mudah ambil alih akun platform kelas linkedin ya kapok terima kasih,39,39
"Akun saya tidak bisa di akses. Dan pada saat login disuruh verifikasi data diri dgn tanda pengenal, tapi saat memverifikasi data tidak pernah disetujui. Itu kenapa ya?",negatif,2024-01-23,2024,akun saya tidak bisa di akses dan pada saat login disuruh verifikasi data diri dgn tanda pengenal tapi saat memverifikasi data tidak pernah disetujui itu kenapa ya,27,27,akun saya tidak bisa di akses dan pada saat login disuruh verifikasi data diri dengan tanda pengenal tapi saat memverifikasi data tidak pernah disetujui itu kenapa ya,27,27,"['akun', 'saya', 'tidak', 'bisa', 'di', 'akses', 'dan', 'pada', 'saat', 'login', 'disuruh', 'verifikasi', 'data', 'diri', 'dengan', 'tanda', 'pengenal', 'tapi', 'saat', 'memverifikasi', 'data', 'tidak', 'pernah', 'disetujui', 'itu', 'kenapa', 'ya']","['akun', 'tidak', 'akses', 'login', 'disuruh', 'verifikasi', 'data', 'tanda', 'pengenal', 'memverifikasi', 'data', 'tidak', 'disetujui', 'ya']",27,14,13,akun tidak akses login suruh verifikasi data tanda kenal verifikasi data tidak tuju ya,14,14
"Loginnya sulit, udh setengah jam lebih ngabisin waktu buat isi keamanan doank.. Mau di website atau di apps sama smua",negatif,2023-05-13,2023,loginnya sulit udh setengah jam lebih ngabisin waktu buat isi keamanan doank mau di website atau di apps sama smua,20,20,loginnya sulit sudah setengah jam lebih ngabisin waktu buat isi keamanan doank mau di website atau di aplikasi sama semua,20,20,"['loginnya', 'sulit', 'sudah', 'setengah', 'jam', 'lebih', 'ngabisin', 'waktu', 'buat', 'isi', 'keamanan', 'doank', 'mau', 'di', 'website', 'atau', 'di', 'aplikasi', 'sama', 'semua']","['loginnya', 'sulit', 'jam', 'ngabisin', 'isi', 'keamanan', 'doank', 'website', 'aplikasi']",20,9,11,loginnya sulit jam ngabisin isi aman doank website aplikasi,9,9
Muncul notif Kode noCAPTCHA tidak valid meski udah berulang kali verifikasi. Alhasil gabisa login. Aplikasi yang payah.,negatif,2023-08-27,2023,muncul notif kode nocaptcha tidak valid meski udah berulang kali verifikasi alhasil gabisa login aplikasi yang payah,17,17,muncul notif kode nocaptcha tidak valid meski sudah berulang kali verifikasi alhasil tidak bisa login aplikasi yang payah,17,18,"['muncul', 'notif', 'kode', 'nocaptcha', 'tidak', 'valid', 'meski', 'sudah', 'berulang', 'kali', 'verifikasi', 'alhasil', 'tidak', 'bisa', 'login', 'aplikasi', 'yang', 'payah']","['muncul', 'notif', 'kode', 'nocaptcha', 'tidak', 'valid', 'berulang', 'kali', 'verifikasi', 'alhasil', 'tidak', 'login', 'aplikasi', 'payah']",18,14,4,muncul notif kode nocaptcha tidak valid ulang kali verifikasi alhasil tidak login aplikasi payah,14,14
"Melalui Linkedln, kita bertemu dengan banyak orang didalamnya, dari berbagai negara, saling mengenal satu sama yg lainnya, saling membantu Informasi, dan diLinkedln bisa membuka jendela dunia, luar biasaaa",positif,2020-10-14,2020,melalui linkedln kita bertemu dengan banyak orang didalamnya dari berbagai negara saling mengenal satu sama yg lainnya saling membantu informasi dan dilinkedln bisa membuka jendela dunia luar biasaaa,28,28,melalui linkedln kita bertemu dengan banyak orang didalamnya dari berbagai negara saling mengenal satu sama yang lainnya saling membantu informasi dan dilinkedln bisa membuka jendela dunia luar biasaaa,28,28,"['melalui', 'linkedln', 'kita', 'bertemu', 'dengan', 'banyak', 'orang', 'didalamnya', 'dari', 'berbagai', 'negara', 'saling', 'mengenal', 'satu', 'sama', 'yang', 'lainnya', 'saling', 'membantu', 'informasi', 'dan', 'dilinkedln', 'bisa', 'membuka', 'jendela', 'dunia', 'luar', 'biasaaa']","['linkedln', 'bertemu', 'orang', 'didalamnya', 'negara', 'mengenal', 'membantu', 'informasi', 'dilinkedln', 'membuka', 'jendela', 'dunia', 'biasaaa']",28,13,15,linkedln temu orang dalam negara kenal bantu informasi dilinkedln buka jendela dunia biasaaa,13,13
"Tolong diperbaiki sistemnya. Masa saya setiap buka LinkedIn harus login, verifikasi akun dengan upload ktp. Udah berkali kali tapi gabisa login.",negatif,2023-10-14,2023,tolong diperbaiki sistemnya masa saya setiap buka linkedin harus login verifikasi akun dengan upload ktp udah berkali kali tapi gabisa login,21,21,tolong di perbaiki sistemnya masa saya setiap buka linkedin harus login verifikasi akun dengan unggah ktp sudah berkali kali tapi tidak bisa login,21,23,"['tolong', 'di', 'perbaiki', 'sistemnya', 'masa', 'saya', 'setiap', 'buka', 'linkedin', 'harus', 'login', 'verifikasi', 'akun', 'dengan', 'unggah', 'ktp', 'sudah', 'berkali', 'kali', 'tapi', 'tidak', 'bisa', 'login']","['tolong', 'perbaiki', 'sistemnya', 'buka', 'linkedin', 'login', 'verifikasi', 'akun', 'unggah', 'ktp', 'berkali', 'kali', 'tidak', 'login']",23,14,9,tolong baik sistem buka linkedin login verifikasi akun unggah ktp kali kali tidak login,14,14
"Tolong admin aplikasinya dì benahi kembali, saya sudah berulang kali login kode verifikasi tidak valid dan sudaj benar benar memilih gambar verifikasi dengan benar, jangan di buat susah orang lebih banyak",negatif,2023-08-10,2023,tolong admin aplikasinya dì benahi kembali saya sudah berulang kali login kode verifikasi tidak valid dan sudaj benar benar memilih gambar verifikasi dengan benar jangan di buat susah orang lebih banyak,31,31,tolong admin aplikasi nya dì benahi kembali saya sudah berulang kali login kode verifikasi tidak valid dan sudaj benar benar memilih gambar verifikasi dengan benar jangan di buat susah orang lebih banyak,31,32,"['tolong', 'admin', 'aplikasi', 'nya', 'dì', 'benahi', 'kembali', 'saya', 'sudah', 'berulang', 'kali', 'login', 'kode', 'verifikasi', 'tidak', 'valid', 'dan', 'sudaj', 'benar', 'benar', 'memilih', 'gambar', 'verifikasi', 'dengan', 'benar', 'jangan', 'di', 'buat', 'susah', 'orang', 'lebih', 'banyak']","['tolong', 'admin', 'aplikasi', 'nya', 'dì', 'benahi', 'berulang', 'kali', 'login', 'kode', 'verifikasi', 'tidak', 'valid', 'sudaj', 'memilih', 'gambar', 'verifikasi', 'susah', 'orang']",32,19,13,tolong admin aplikasi nya d benah ulang kali login kode verifikasi tidak valid sudaj pilih gambar verifikasi susah orang,19,19
"mohon diperbaiki aplikasi nya, mengakses di web bisa kalo di aplikasi gak bisa kan aneh saya pake android versi 7 sekian terimakasih.",negatif,2021-04-22,2021,mohon diperbaiki aplikasi nya mengakses di web bisa kalo di aplikasi gak bisa kan aneh saya pake android versi sekian terimakasih,22,21,mohon di perbaiki aplikasi nya mengakses di web bisa kalau di aplikasi tidak bisa akan aneh saya pakai android versi sekian terima kasih,21,23,"['mohon', 'di', 'perbaiki', 'aplikasi', 'nya', 'mengakses', 'di', 'web', 'bisa', 'kalau', 'di', 'aplikasi', 'tidak', 'bisa', 'akan', 'aneh', 'saya', 'pakai', 'android', 'versi', 'sekian', 'terima', 'kasih']","['mohon', 'perbaiki', 'aplikasi', 'nya', 'mengakses', 'web', 'aplikasi', 'tidak', 'aneh', 'pakai', 'android', 'versi', 'sekian', 'terima', 'kasih']",23,15,8,mohon baik aplikasi nya akses web aplikasi tidak aneh pakai android versi sekian terima kasih,15,15
"Saya tidak bisa daftar ataupun login karena masalah verifikasi, tolong diperbaiki.",negatif,2024-08-09,2024,saya tidak bisa daftar ataupun login karena masalah verifikasi tolong diperbaiki,11,11,saya tidak bisa daftar ataupun login karena masalah verifikasi tolong di perbaiki,11,12,"['saya', 'tidak', 'bisa', 'daftar', 'ataupun', 'login', 'karena', 'masalah', 'verifikasi', 'tolong', 'di', 'perbaiki']","['tidak', 'daftar', 'login', 'verifikasi', 'tolong', 'perbaiki']",12,6,6,tidak daftar login verifikasi tolong baik,6,6
"Mau pake yang prenium, di suruh uji coba gratis 1 bulan, Tapi bayar duluan, itu namanya bukan ujicoba gratis tapi uji coba bayar, kalau bayarnya 10rb gak papa, ini 590rb pulak hadeh, manipulasi bahasa nya itu lo",negatif,2022-08-19,2022,mau pake yang prenium di suruh uji coba gratis bulan tapi bayar duluan itu namanya bukan ujicoba gratis tapi uji coba bayar kalau bayarnya rb gak papa ini rb pulak hadeh manipulasi bahasa nya itu lo,37,36,mau pakai yang prenium di suruh uji coba gratis bulan tapi bayar duluan itu namanya bukan ujicoba gratis tapi uji coba bayar kalau bayarnya ribu tidak papa ini ribu pula hadeh manipulasi bahasa nya itu lo,36,36,"['mau', 'pakai', 'yang', 'prenium', 'di', 'suruh', 'uji', 'coba', 'gratis', 'bulan', 'tapi', 'bayar', 'duluan', 'itu', 'namanya', 'bukan', 'ujicoba', 'gratis', 'tapi', 'uji', 'coba', 'bayar', 'kalau', 'bayarnya', 'ribu', 'tidak', 'papa', 'ini', 'ribu', 'pula', 'hadeh', 'manipulasi', 'bahasa', 'nya', 'itu', 'lo']","['pakai', 'prenium', 'suruh', 'uji', 'coba', 'gratis', 'bayar', 'duluan', 'namanya', 'ujicoba', 'gratis', 'uji', 'coba', 'bayar', 'bayarnya', 'ribu', 'tidak', 'papa', 'ribu', 'hadeh', 'manipulasi', 'bahasa', 'nya', 'lo']",36,24,12,pakai prenium suruh uji coba gratis bayar duluan nama ujicoba gratis uji coba bayar bayar ribu tidak papa ribu hadeh manipulasi bahasa nya lo,24,24
"Ini aplikasi macam apa ya , daftar doang susah nya minta ampun",negatif,2024-05-08,2024,ini aplikasi macam apa ya daftar doang susah nya minta ampun,12,11,ini aplikasi macam apa ya daftar saja susah nya minta ampun,11,11,"['ini', 'aplikasi', 'macam', 'apa', 'ya', 'daftar', 'saja', 'susah', 'nya', 'minta', 'ampun']","['aplikasi', 'ya', 'daftar', 'susah', 'nya', 'ampun']",11,6,5,aplikasi ya daftar susah nya ampun,6,6
Terlalu banyak iklan 👎,negatif,2024-06-27,2024,terlalu banyak iklan,4,3,terlalu banyak iklan,3,3,"['terlalu', 'banyak', 'iklan']",['iklan'],3,1,2,iklan,1,1
Kenapa linkedin sekarang terkadang bisa dibuka dan terkadang tidak bisa. Agak aneh sih ini apk sekarang tidak seperti dulu yg lancar lancar saja. Mungkin bisa ditangani kendalanya apa. Thanks,negatif,2022-01-09,2022,kenapa linkedin sekarang terkadang bisa dibuka dan terkadang tidak bisa agak aneh sih ini apk sekarang tidak seperti dulu yg lancar lancar saja mungkin bisa ditangani kendalanya apa thanks,29,29,kenapa linkedin sekarang terkadang bisa dibuka dan terkadang tidak bisa agak aneh sih ini aplikasi sekarang tidak seperti dahulu yang lancar lancar saja mungkin bisa ditangani kendalanya apa terima kasih,29,30,"['kenapa', 'linkedin', 'sekarang', 'terkadang', 'bisa', 'dibuka', 'dan', 'terkadang', 'tidak', 'bisa', 'agak', 'aneh', 'sih', 'ini', 'aplikasi', 'sekarang', 'tidak', 'seperti', 'dahulu', 'yang', 'lancar', 'lancar', 'saja', 'mungkin', 'bisa', 'ditangani', 'kendalanya', 'apa', 'terima', 'kasih']","['linkedin', 'terkadang', 'dibuka', 'terkadang', 'tidak', 'aneh', 'sih', 'aplikasi', 'tidak', 'lancar', 'lancar', 'ditangani', 'kendalanya', 'terima', 'kasih']",30,15,15,linkedin terkadang buka terkadang tidak aneh sih aplikasi tidak lancar lancar tangan kendala terima kasih,15,15
Lumayan bermanfaat untuk yg blm dpt pekerjaan,positif,2024-04-29,2024,lumayan bermanfaat untuk yg blm dpt pekerjaan,7,7,lumayan bermanfaat untuk yang belum dapat pekerjaan,7,7,"['lumayan', 'bermanfaat', 'untuk', 'yang', 'belum', 'dapat', 'pekerjaan']","['lumayan', 'bermanfaat', 'pekerjaan']",7,3,4,lumayan manfaat kerja,3,3
"aplikasi sampah, log in di suruh ngisi security check, pas udah selesai tiba tiba akun di tangguhkan, padahal gak melakukan kesalahan apapun. Sumpah ini aplikasi sampah tersampah di muka bumi.",negatif,2024-01-06,2024,aplikasi sampah log in di suruh ngisi security check pas udah selesai tiba tiba akun di tangguhkan padahal gak melakukan kesalahan apapun sumpah ini aplikasi sampah tersampah di muka bumi,30,30,aplikasi sampah log in di suruh mengisi security cek pas sudah selesai tiba tiba akun di tangguhkan padahal tidak melakukan kesalahan apapun sumpah ini aplikasi sampah tersampah di muka bumi,30,30,"['aplikasi', 'sampah', 'log', 'in', 'di', 'suruh', 'mengisi', 'security', 'cek', 'pas', 'sudah', 'selesai', 'tiba', 'tiba', 'akun', 'di', 'tangguhkan', 'padahal', 'tidak', 'melakukan', 'kesalahan', 'apapun', 'sumpah', 'ini', 'aplikasi', 'sampah', 'tersampah', 'di', 'muka', 'bumi']","['aplikasi', 'sampah', 'log', 'in', 'suruh', 'mengisi', 'security', 'cek', 'pas', 'selesai', 'akun', 'tangguhkan', 'tidak', 'kesalahan', 'apapun', 'sumpah', 'aplikasi', 'sampah', 'tersampah', 'muka', 'bumi']",30,21,9,aplikasi sampah log in suruh isi security cek pas selesai akun tangguh tidak salah apa sumpah aplikasi sampah sampah muka bumi,21,21
Kenapa tiba-tiba ngebug??????,negatif,2024-04-05,2024,kenapa tiba tiba ngebug,3,4,kenapa tiba tiba nge bug,4,5,"['kenapa', 'tiba', 'tiba', 'nge', 'bug']","['nge', 'bug']",5,2,3,nge bug,2,2
"Saya ingin melaporkan bahwa siang ini akun saya diretas oleh oknum tidak bertanggungjawab. Akun saya diretas oleh seorang wanita dari luar negeri. Pelaku menghapus semua data yang sudah terlampir dan menggantinya dengan data diri dia. Saat ini akun saya sudah kembali, tetapi apakah kemanannya akan terjamin? Mohon bantuannya lebih lanjut. Terimakasih",negatif,2023-11-02,2023,saya ingin melaporkan bahwa siang ini akun saya diretas oleh oknum tidak bertanggungjawab akun saya diretas oleh seorang wanita dari luar negeri pelaku menghapus semua data yang sudah terlampir dan menggantinya dengan data diri dia saat ini akun saya sudah kembali tetapi apakah kemanannya akan terjamin mohon bantuannya lebih lanjut terimakasih,51,51,saya ingin melaporkan bahwa siang ini akun saya diretas oleh oknum tidak bertanggungjawab akun saya diretas oleh seorang wanita dari luar negeri pelaku menghapus semua data yang sudah terlampir dan menggantinya dengan data diri dia saat ini akun saya sudah kembali tetapi apakah kemanannya akan terjamin mohon bantuannya lebih lanjut terima kasih,51,52,"['saya', 'ingin', 'melaporkan', 'bahwa', 'siang', 'ini', 'akun', 'saya', 'diretas', 'oleh', 'oknum', 'tidak', 'bertanggungjawab', 'akun', 'saya', 'diretas', 'oleh', 'seorang', 'wanita', 'dari', 'luar', 'negeri', 'pelaku', 'menghapus', 'semua', 'data', 'yang', 'sudah', 'terlampir', 'dan', 'menggantinya', 'dengan', 'data', 'diri', 'dia', 'saat', 'ini', 'akun', 'saya', 'sudah', 'kembali', 'tetapi', 'apakah', 'kemanannya', 'akan', 'terjamin', 'mohon', 'bantuannya', 'lebih', 'lanjut', 'terima', 'kasih']","['melaporkan', 'siang', 'akun', 'diretas', 'oknum', 'tidak', 'bertanggungjawab', 'akun', 'diretas', 'wanita', 'negeri', 'pelaku', 'menghapus', 'data', 'terlampir', 'menggantinya', 'data', 'akun', 'kemanannya', 'terjamin', 'mohon', 'bantuannya', 'terima', 'kasih']",52,24,28,lapor siang akun retas oknum tidak bertanggungjawab akun retas wanita negeri laku hapus data lampir ganti data akun keman jamin mohon bantu terima kasih,24,24
"Setelah d update koq foto profil nya hilang dan wkt d tambah lg tetap gak muncul, sama semakin lemot postingan org pun foto, video gak bs muncul",negatif,2021-08-08,2021,setelah d update koq foto profil nya hilang dan wkt d tambah lg tetap gak muncul sama semakin lemot postingan org pun foto video gak bs muncul,27,27,setelah di diperbarui kok foto profil nya hilang dan waktu di tambah lagi tetap tidak muncul sama semakin lambat postingan orang pun foto video tidak bisa muncul,27,27,"['setelah', 'di', 'diperbarui', 'kok', 'foto', 'profil', 'nya', 'hilang', 'dan', 'waktu', 'di', 'tambah', 'lagi', 'tetap', 'tidak', 'muncul', 'sama', 'semakin', 'lambat', 'postingan', 'orang', 'pun', 'foto', 'video', 'tidak', 'bisa', 'muncul']","['diperbarui', 'foto', 'profil', 'nya', 'hilang', 'tidak', 'muncul', 'lambat', 'postingan', 'orang', 'foto', 'video', 'tidak', 'muncul']",27,14,13,baru foto profil nya hilang tidak muncul lambat postingan orang foto video tidak muncul,14,14
"Apkikasi tidak jelas motong2 saldo sembarangan, jangan pernah download ini apk",negatif,2024-06-11,2024,apkikasi tidak jelas motong saldo sembarangan jangan pernah download ini apk,11,11,apkikasi tidak jelas motong saldo sembarangan jangan pernah unduh ini aplikasi,11,11,"['apkikasi', 'tidak', 'jelas', 'motong', 'saldo', 'sembarangan', 'jangan', 'pernah', 'unduh', 'ini', 'aplikasi']","['apkikasi', 'tidak', 'motong', 'saldo', 'sembarangan', 'unduh', 'aplikasi']",11,7,4,apkikasi tidak motong saldo sembarang unduh aplikasi,7,7
"Aplikasi yang sangat membantu profesional membangun koneksi dan jaringan baru, sukses terus linkedIn..",positif,2020-10-22,2020,aplikasi yang sangat membantu profesional membangun koneksi dan jaringan baru sukses terus linkedin,13,13,aplikasi yang sangat membantu profesional membangun koneksi dan jaringan baru sukses terus linkedin,13,13,"['aplikasi', 'yang', 'sangat', 'membantu', 'profesional', 'membangun', 'koneksi', 'dan', 'jaringan', 'baru', 'sukses', 'terus', 'linkedin']","['aplikasi', 'membantu', 'profesional', 'membangun', 'koneksi', 'jaringan', 'sukses', 'linkedin']",13,8,5,aplikasi bantu profesional bangun koneksi jaring sukses linkedin,8,8
"Saya sangat suka karena di sini saya bisa menginfokan berbagai hal seputar skill, pengalaman, dan lainnya. Isi yang ada pada CV bisa diurutkan dengan rapi dan jelas di sini. Juga bisa terhubung dengan industri maupun perusahaan yang diminati",positif,2021-11-01,2021,saya sangat suka karena di sini saya bisa menginfokan berbagai hal seputar skill pengalaman dan lainnya isi yang ada pada cv bisa diurutkan dengan rapi dan jelas di sini juga bisa terhubung dengan industri maupun perusahaan yang diminati,38,38,saya sangat suka karena di sini saya bisa menginfokan berbagai hal seputar skill pengalaman dan lainnya isi yang ada pada cv bisa diurutkan dengan rapi dan jelas di sini juga bisa terhubung dengan industri maupun perusahaan yang diminati,38,38,"['saya', 'sangat', 'suka', 'karena', 'di', 'sini', 'saya', 'bisa', 'menginfokan', 'berbagai', 'hal', 'seputar', 'skill', 'pengalaman', 'dan', 'lainnya', 'isi', 'yang', 'ada', 'pada', 'cv', 'bisa', 'diurutkan', 'dengan', 'rapi', 'dan', 'jelas', 'di', 'sini', 'juga', 'bisa', 'terhubung', 'dengan', 'industri', 'maupun', 'perusahaan', 'yang', 'diminati']","['suka', 'menginfokan', 'seputar', 'skill', 'pengalaman', 'isi', 'cv', 'diurutkan', 'rapi', 'terhubung', 'industri', 'perusahaan', 'diminati']",38,13,25,suka info putar skill alam isi cv urut rapi hubung industri usaha mati,13,13
Tetap tergabung dalam grup family laman web browser ini yang selalu terlindungi terhubung tersinkron bersama grup family Rewards Brave Token lebih mudah cepat aman terkendali dan selalu beruntung sangat memuaskan.,positif,2023-02-28,2023,tetap tergabung dalam grup family laman web browser ini yang selalu terlindungi terhubung tersinkron bersama grup family rewards brave token lebih mudah cepat aman terkendali dan selalu beruntung sangat memuaskan,30,30,tetap tergabung dalam grup family laman web browser ini yang selalu terlindungi terhubung tersinkron bersama grup family rewards brave token lebih mudah cepat aman terkendali dan selalu beruntung sangat memuaskan,30,30,"['tetap', 'tergabung', 'dalam', 'grup', 'family', 'laman', 'web', 'browser', 'ini', 'yang', 'selalu', 'terlindungi', 'terhubung', 'tersinkron', 'bersama', 'grup', 'family', 'rewards', 'brave', 'token', 'lebih', 'mudah', 'cepat', 'aman', 'terkendali', 'dan', 'selalu', 'beruntung', 'sangat', 'memuaskan']","['tergabung', 'grup', 'family', 'laman', 'web', 'browser', 'terlindungi', 'terhubung', 'tersinkron', 'grup', 'family', 'rewards', 'brave', 'token', 'mudah', 'cepat', 'aman', 'terkendali', 'beruntung', 'memuaskan']",30,20,10,gabung grup family laman web browser lindung hubung sinkron grup family rewards brave token mudah cepat aman kendali untung muas,20,20
"Aplikasi yang cukup menarik, tapi saat mau verifikasi akun malah gagal terus entah kenapa, padahal sinyal WiFi bagus... Mohon diperbaiki sistemnya...",negatif,2023-09-10,2023,aplikasi yang cukup menarik tapi saat mau verifikasi akun malah gagal terus entah kenapa padahal sinyal wifi bagus mohon diperbaiki sistemnya,21,21,aplikasi yang cukup menarik tapi saat mau verifikasi akun bahkan gagal terus entah kenapa padahal sinyal wifi bagus mohon di perbaiki sistemnya,21,22,"['aplikasi', 'yang', 'cukup', 'menarik', 'tapi', 'saat', 'mau', 'verifikasi', 'akun', 'bahkan', 'gagal', 'terus', 'entah', 'kenapa', 'padahal', 'sinyal', 'wifi', 'bagus', 'mohon', 'di', 'perbaiki', 'sistemnya']","['aplikasi', 'menarik', 'verifikasi', 'akun', 'gagal', 'sinyal', 'wifi', 'bagus', 'mohon', 'perbaiki', 'sistemnya']",22,11,11,aplikasi tarik verifikasi akun gagal sinyal wifi bagus mohon baik sistem,11,11
"Ribet bgt buat akun,baru aj masukkan nomor telfon udh ad keterangan nya sesi kadaluarsa, blm lg verifikasi nya yg lumayan ribet",negatif,2024-04-20,2024,ribet bgt buat akun baru aj masukkan nomor telfon udh ad keterangan nya sesi kadaluarsa blm lg verifikasi nya yg lumayan ribet,21,22,rumit banget buat akun baru saja masukkan nomor telpon sudah ada keterangan nya sesi kadaluarsa belum lagi verifikasi nya yang lumayan rumit,22,22,"['rumit', 'banget', 'buat', 'akun', 'baru', 'saja', 'masukkan', 'nomor', 'telpon', 'sudah', 'ada', 'keterangan', 'nya', 'sesi', 'kadaluarsa', 'belum', 'lagi', 'verifikasi', 'nya', 'yang', 'lumayan', 'rumit']","['rumit', 'banget', 'akun', 'masukkan', 'nomor', 'telpon', 'keterangan', 'nya', 'sesi', 'kadaluarsa', 'verifikasi', 'nya', 'lumayan', 'rumit']",22,14,8,rumit banget akun masuk nomor telpon terang nya sesi kadaluarsa verifikasi nya lumayan rumit,14,14
"Up to date, semoga ada updaten terbaru atau dikembangkan untuk pengoptimalan LinkeIn yang lebih maksimal dan membantu para penggunannya",positif,2024-04-20,2024,up to date semoga ada updaten terbaru atau dikembangkan untuk pengoptimalan linkein yang lebih maksimal dan membantu para penggunannya,19,19,up to date semoga ada updaten terbaru atau dikembangkan untuk pengoptimalan linkein yang lebih maksimal dan membantu para penggunannya,19,19,"['up', 'to', 'date', 'semoga', 'ada', 'updaten', 'terbaru', 'atau', 'dikembangkan', 'untuk', 'pengoptimalan', 'linkein', 'yang', 'lebih', 'maksimal', 'dan', 'membantu', 'para', 'penggunannya']","['up', 'to', 'date', 'semoga', 'updaten', 'terbaru', 'dikembangkan', 'pengoptimalan', 'linkein', 'maksimal', 'membantu', 'penggunannya']",19,12,7,up to date moga updaten baru kembang optimal linkein maksimal bantu gun,12,12
aplikasi ga jelas verifikasi susah skli ga jelas ga jelas ga jelas ihhhhh sebel org udah bener malah salah salah muluuuu org gambarnya udah bener di pilih menghadap ke atas malah salahhhhhhhhhhhhhh,negatif,2024-03-13,2024,aplikasi ga jelas verifikasi susah skli ga jelas ga jelas ga jelas ihhhhh sebel org udah bener malah salah salah muluuuu org gambarnya udah bener di pilih menghadap ke atas malah salahhhhhhhhhhhhhh,32,32,aplikasi tidak jelas verifikasi susah skli tidak jelas tidak jelas tidak jelas ihhhhh sebel orang sudah benar bahkan salah salah muluuuu orang gambarnya sudah benar di pilih menghadap ke atas bahkan salahhhhhhhhhhhhhh,32,32,"['aplikasi', 'tidak', 'jelas', 'verifikasi', 'susah', 'skli', 'tidak', 'jelas', 'tidak', 'jelas', 'tidak', 'jelas', 'ihhhhh', 'sebel', 'orang', 'sudah', 'benar', 'bahkan', 'salah', 'salah', 'muluuuu', 'orang', 'gambarnya', 'sudah', 'benar', 'di', 'pilih', 'menghadap', 'ke', 'atas', 'bahkan', 'salahhhhhhhhhhhhhh']","['aplikasi', 'tidak', 'verifikasi', 'susah', 'skli', 'tidak', 'tidak', 'tidak', 'ihhhhh', 'sebel', 'orang', 'salah', 'salah', 'muluuuu', 'orang', 'gambarnya', 'pilih', 'menghadap', 'salahhhhhhhhhhhhhh']",32,19,13,aplikasi tidak verifikasi susah skli tidak tidak tidak ihhhhh sebel orang salah salah muluuuu orang gambar pilih hadap salahhhhhhhhhhhhhh,19,19
"Tolong developer mendengarkan keluhan dari usernya jangan merasa sudah diatas terus semaunya sendiri ini saya mau login udah upload ktp, verifikasi wajah tetep aja kena pembatasan sementara",negatif,2024-03-15,2024,tolong developer mendengarkan keluhan dari usernya jangan merasa sudah diatas terus semaunya sendiri ini saya mau login udah upload ktp verifikasi wajah tetep aja kena pembatasan sementara,27,27,tolong developer mendengarkan keluhan dari usernya jangan merasa sudah diatas terus semaunya sendiri ini saya mau login sudah unggah ktp verifikasi wajah tetap saja kena pembatasan sementara,27,27,"['tolong', 'developer', 'mendengarkan', 'keluhan', 'dari', 'usernya', 'jangan', 'merasa', 'sudah', 'diatas', 'terus', 'semaunya', 'sendiri', 'ini', 'saya', 'mau', 'login', 'sudah', 'unggah', 'ktp', 'verifikasi', 'wajah', 'tetap', 'saja', 'kena', 'pembatasan', 'sementara']","['tolong', 'developer', 'mendengarkan', 'keluhan', 'usernya', 'diatas', 'login', 'unggah', 'ktp', 'verifikasi', 'wajah', 'kena', 'pembatasan']",27,13,14,tolong developer dengar keluh usernya atas login unggah ktp verifikasi wajah kena batas,13,13
Ini apl muncul trs di game yg gw mainin. Dan susah bnget di skip walopun ad tanda X nya,negatif,2024-05-29,2024,ini apl muncul trs di game yg gw mainin dan susah bnget di skip walopun ad tanda x nya,19,19,ini aplikasi muncul terus di game yang saya mainin dan susah banget di skip walopun ada tanda x nya,19,19,"['ini', 'aplikasi', 'muncul', 'terus', 'di', 'game', 'yang', 'saya', 'mainin', 'dan', 'susah', 'banget', 'di', 'skip', 'walopun', 'ada', 'tanda', 'x', 'nya']","['aplikasi', 'muncul', 'game', 'mainin', 'susah', 'banget', 'skip', 'walopun', 'tanda', 'x', 'nya']",19,11,8,aplikasi muncul game mainin susah banget skip walopun tanda x nya,11,11
Jangan terlalu percaya aplikasi seperti ini. Buang buang waktu dan biaya untuk interview ujung ujungnya penipuan. Telite terlebih dahulu. Apa lagi iming imingan PT nya lebay. Waspadalaaaaaaah,negatif,2024-03-09,2024,jangan terlalu percaya aplikasi seperti ini buang buang waktu dan biaya untuk interview ujung ujungnya penipuan telite terlebih dahulu apa lagi iming imingan pt nya lebay waspadalaaaaaaah,27,27,jangan terlalu percaya aplikasi seperti ini buang buang waktu dan biaya untuk interview ujung ujungnya penipuan telite terlebih dahulu apa lagi iming imingan perseroan terbatas nya berlebihan waspadalaaaaaaah,27,28,"['jangan', 'terlalu', 'percaya', 'aplikasi', 'seperti', 'ini', 'buang', 'buang', 'waktu', 'dan', 'biaya', 'untuk', 'interview', 'ujung', 'ujungnya', 'penipuan', 'telite', 'terlebih', 'dahulu', 'apa', 'lagi', 'iming', 'imingan', 'perseroan', 'terbatas', 'nya', 'berlebihan', 'waspadalaaaaaaah']","['percaya', 'aplikasi', 'buang', 'buang', 'biaya', 'interview', 'ujung', 'ujungnya', 'penipuan', 'telite', 'iming', 'imingan', 'perseroan', 'terbatas', 'nya', 'waspadalaaaaaaah']",28,16,12,percaya aplikasi buang buang biaya interview ujung ujung tipu telite iming imingan persero batas nya waspadalaaaaaaah,16,16
Semakin mudah temukan tujuan dengan tetap terdukung penuh dan selalu berhasil sangat memuaskan serta penuh keberuntingan,positif,2022-12-20,2022,semakin mudah temukan tujuan dengan tetap terdukung penuh dan selalu berhasil sangat memuaskan serta penuh keberuntingan,16,16,semakin mudah temukan tujuan dengan tetap terdukung penuh dan selalu berhasil sangat memuaskan serta penuh keberuntingan,16,16,"['semakin', 'mudah', 'temukan', 'tujuan', 'dengan', 'tetap', 'terdukung', 'penuh', 'dan', 'selalu', 'berhasil', 'sangat', 'memuaskan', 'serta', 'penuh', 'keberuntingan']","['mudah', 'temukan', 'tujuan', 'terdukung', 'penuh', 'berhasil', 'memuaskan', 'penuh', 'keberuntingan']",16,9,7,mudah temu tuju dukung penuh hasil muas penuh unting,9,9
"Verifikasi dengan pesona Selalu keluar sendiri tiba tiba, mohon untuk diperbaiki",negatif,2024-05-23,2024,verifikasi dengan pesona selalu keluar sendiri tiba tiba mohon untuk diperbaiki,11,11,verifikasi dengan pesona selalu keluar sendiri tiba tiba mohon untuk di perbaiki,11,12,"['verifikasi', 'dengan', 'pesona', 'selalu', 'keluar', 'sendiri', 'tiba', 'tiba', 'mohon', 'untuk', 'di', 'perbaiki']","['verifikasi', 'pesona', 'mohon', 'perbaiki']",12,4,8,verifikasi pesona mohon baik,4,4
"Aplikasinya makin sampah untuk login aja verifikasi nya sulit bngt tidak valid mulu, tolong untuk diperbaiki",negatif,2024-03-23,2024,aplikasinya makin sampah untuk login aja verifikasi nya sulit bngt tidak valid mulu tolong untuk diperbaiki,16,16,aplikasi nya makin sampah untuk login saja verifikasi nya sulit banget tidak valid mulu tolong untuk di perbaiki,16,18,"['aplikasi', 'nya', 'makin', 'sampah', 'untuk', 'login', 'saja', 'verifikasi', 'nya', 'sulit', 'banget', 'tidak', 'valid', 'mulu', 'tolong', 'untuk', 'di', 'perbaiki']","['aplikasi', 'nya', 'sampah', 'login', 'verifikasi', 'nya', 'sulit', 'banget', 'tidak', 'valid', 'mulu', 'tolong', 'perbaiki']",18,13,5,aplikasi nya sampah login verifikasi nya sulit banget tidak valid mulu tolong baik,13,13
"Aplikasi ini sangat membantu sekali, khususnya untuk para pelajar yg baru lulus sekolah, khususnya yg ingin dapet kerja sesuai yg kita inginkan, ✊",positif,2023-03-24,2023,aplikasi ini sangat membantu sekali khususnya untuk para pelajar yg baru lulus sekolah khususnya yg ingin dapet kerja sesuai yg kita inginkan,23,22,aplikasi ini sangat membantu sekali khususnya untuk para pelajar yang baru lulus sekolah khususnya yang ingin dapat kerja sesuai yang kita inginkan,22,22,"['aplikasi', 'ini', 'sangat', 'membantu', 'sekali', 'khususnya', 'untuk', 'para', 'pelajar', 'yang', 'baru', 'lulus', 'sekolah', 'khususnya', 'yang', 'ingin', 'dapat', 'kerja', 'sesuai', 'yang', 'kita', 'inginkan']","['aplikasi', 'membantu', 'pelajar', 'lulus', 'sekolah', 'kerja', 'sesuai']",22,7,15,aplikasi bantu ajar lulus sekolah kerja sesuai,7,7
"Aplikasi sampahh mau login malah di suruh jawab teka teki terus malah bilang ""jawab teka teki biar kami tau kalau anda benar manusia"" woyy ngotak dikit lah emang ada BINATANG YANG MAU DONLOD APLIKASI INI DASAR MANUSIA TOLOL!!",negatif,2024-03-16,2024,aplikasi sampahh mau login malah di suruh jawab teka teki terus malah bilang jawab teka teki biar kami tau kalau anda benar manusia woyy ngotak dikit lah emang ada binatang yang mau donlod aplikasi ini dasar manusia tolol,38,38,aplikasi sampahh mau login bahkan di suruh jawab teka teki terus bahkan bilang jawab teka teki biar kami tahu kalau anda benar manusia woyy ngotak dikit lah memang ada binatang yang mau download aplikasi ini dasar manusia tolol,38,38,"['aplikasi', 'sampahh', 'mau', 'login', 'bahkan', 'di', 'suruh', 'jawab', 'teka', 'teki', 'terus', 'bahkan', 'bilang', 'jawab', 'teka', 'teki', 'biar', 'kami', 'tahu', 'kalau', 'anda', 'benar', 'manusia', 'woyy', 'ngotak', 'dikit', 'lah', 'memang', 'ada', 'binatang', 'yang', 'mau', 'download', 'aplikasi', 'ini', 'dasar', 'manusia', 'tolol']","['aplikasi', 'sampahh', 'login', 'suruh', 'teka', 'teki', 'bilang', 'teka', 'teki', 'biar', 'manusia', 'woyy', 'ngotak', 'dikit', 'binatang', 'download', 'aplikasi', 'dasar', 'manusia', 'tolol']",38,20,18,aplikasi sampahh login suruh teka teki bilang teka teki biar manusia woyy ngotak dikit binatang download aplikasi dasar manusia tolol,20,20
"Ga salah ni ratingnya, Developer Useless, scam. ga bisa login dan verifikasi sulit banget..",negatif,2024-03-18,2024,ga salah ni ratingnya developer useless scam ga bisa login dan verifikasi sulit banget,14,14,tidak salah ini ratingnya developer useless scam tidak bisa login dan verifikasi sulit banget,14,14,"['tidak', 'salah', 'ini', 'ratingnya', 'developer', 'useless', 'scam', 'tidak', 'bisa', 'login', 'dan', 'verifikasi', 'sulit', 'banget']","['tidak', 'salah', 'ratingnya', 'developer', 'useless', 'scam', 'tidak', 'login', 'verifikasi', 'sulit', 'banget']",14,11,3,tidak salah ratingnya developer useless scam tidak login verifikasi sulit banget,11,11
Aplikasi LinkedIn ni sangat bagus untuk di pakai tugas tugas seperti ppt dan lain-lain.,positif,2024-04-02,2024,aplikasi linkedin ni sangat bagus untuk di pakai tugas tugas seperti ppt dan lain lain,14,15,aplikasi linkedin ini sangat bagus untuk di pakai tugas tugas seperti ppt dan lain lain,15,15,"['aplikasi', 'linkedin', 'ini', 'sangat', 'bagus', 'untuk', 'di', 'pakai', 'tugas', 'tugas', 'seperti', 'ppt', 'dan', 'lain', 'lain']","['aplikasi', 'linkedin', 'bagus', 'pakai', 'tugas', 'tugas', 'ppt']",15,7,8,aplikasi linkedin bagus pakai tugas tugas ppt,7,7
Aplikasi sampah mendadak keluar ga bisa login lagi padahal email ama pasword udah sesuai,negatif,2024-05-03,2024,aplikasi sampah mendadak keluar ga bisa login lagi padahal email ama pasword udah sesuai,14,14,aplikasi sampah mendadak keluar tidak bisa login lagi padahal email sama pasword sudah sesuai,14,14,"['aplikasi', 'sampah', 'mendadak', 'keluar', 'tidak', 'bisa', 'login', 'lagi', 'padahal', 'email', 'sama', 'pasword', 'sudah', 'sesuai']","['aplikasi', 'sampah', 'mendadak', 'tidak', 'login', 'email', 'pasword', 'sesuai']",14,8,6,aplikasi sampah dadak tidak login email pasword sesuai,8,8
Terima kasih sudah membantu,positif,2024-06-14,2024,terima kasih sudah membantu,4,4,terima kasih sudah membantu,4,4,"['terima', 'kasih', 'sudah', 'membantu']","['terima', 'kasih', 'membantu']",4,3,1,terima kasih bantu,3,3
"Knp suka log out sendiri ya,,,,udah login susah banget buat konfirmasi. tolong dong itu akun saya udah dua gak bisa di masukin lagi",negatif,2024-05-27,2024,knp suka log out sendiri ya udah login susah banget buat konfirmasi tolong dong itu akun saya udah dua gak bisa di masukin lagi,23,24,kenapa suka log out sendiri ya sudah login susah banget buat konfirmasi tolong dong itu akun saya sudah dua tidak bisa di masukkan lagi,24,24,"['kenapa', 'suka', 'log', 'out', 'sendiri', 'ya', 'sudah', 'login', 'susah', 'banget', 'buat', 'konfirmasi', 'tolong', 'dong', 'itu', 'akun', 'saya', 'sudah', 'dua', 'tidak', 'bisa', 'di', 'masukkan', 'lagi']","['suka', 'log', 'out', 'ya', 'login', 'susah', 'banget', 'konfirmasi', 'tolong', 'akun', 'tidak', 'masukkan']",24,12,12,suka log out ya login susah banget konfirmasi tolong akun tidak masuk,12,12
"Fiturnya sulit di pahami. Udah ngatur lokasi jambi, tapi tetep aja yang muncul loker dari kota lain.",negatif,2024-06-03,2024,fiturnya sulit di pahami udah ngatur lokasi jambi tapi tetep aja yang muncul loker dari kota lain,17,17,fitur nya sulit di pahami sudah ngatur lokasi jambi tapi tetap saja yang muncul loker dari kota lain,17,18,"['fitur', 'nya', 'sulit', 'di', 'pahami', 'sudah', 'ngatur', 'lokasi', 'jambi', 'tapi', 'tetap', 'saja', 'yang', 'muncul', 'loker', 'dari', 'kota', 'lain']","['fitur', 'nya', 'sulit', 'pahami', 'ngatur', 'lokasi', 'jambi', 'muncul', 'loker', 'kota']",18,10,8,fitur nya sulit paham ngatur lokasi jambi muncul loker kota,10,10
"Security yg memilih hewan menghadap ke atas terlalu rumit, mempersulit dalam proses login/buat akun",negatif,2024-05-23,2024,security yg memilih hewan menghadap ke atas terlalu rumit mempersulit dalam proses login buat akun,14,15,security yang memilih hewan menghadap ke atas terlalu rumit mempersulit dalam proses login buat akun,15,15,"['security', 'yang', 'memilih', 'hewan', 'menghadap', 'ke', 'atas', 'terlalu', 'rumit', 'mempersulit', 'dalam', 'proses', 'login', 'buat', 'akun']","['security', 'memilih', 'hewan', 'menghadap', 'rumit', 'mempersulit', 'proses', 'login', 'akun']",15,9,6,security pilih hewan hadap rumit sulit proses login akun,9,9
Dear Developer LinkedIn. Untuk Aplikasi LinkedIn Sudah Sangat Bagus. Tolong Tambahkan Lagi Fitur Yang Berguna Di Aplikasi Ini ☺️,positif,2023-12-23,2023,dear developer linkedin untuk aplikasi linkedin sudah sangat bagus tolong tambahkan lagi fitur yang berguna di aplikasi ini,19,18,dear developer linkedin untuk aplikasi linkedin sudah sangat bagus tolong tambahkan lagi fitur yang berguna di aplikasi ini,18,18,"['dear', 'developer', 'linkedin', 'untuk', 'aplikasi', 'linkedin', 'sudah', 'sangat', 'bagus', 'tolong', 'tambahkan', 'lagi', 'fitur', 'yang', 'berguna', 'di', 'aplikasi', 'ini']","['dear', 'developer', 'linkedin', 'aplikasi', 'linkedin', 'bagus', 'tolong', 'tambahkan', 'fitur', 'berguna', 'aplikasi']",18,11,7,dear developer linkedin aplikasi linkedin bagus tolong tambah fitur guna aplikasi,11,11
Verifikasi id/sim lama banget asli. Udah dikirim prosesnya LELET BANGET!,negatif,2024-05-27,2024,verifikasi id sim lama banget asli udah dikirim prosesnya lelet banget,10,11,verifikasi id sim lama banget asli sudah dikirim prosesnya lelet banget,11,11,"['verifikasi', 'id', 'sim', 'lama', 'banget', 'asli', 'sudah', 'dikirim', 'prosesnya', 'lelet', 'banget']","['verifikasi', 'id', 'sim', 'banget', 'asli', 'dikirim', 'prosesnya', 'lelet', 'banget']",11,9,2,verifikasi id sim banget asli kirim proses lelet banget,9,9
Aplikasi apa ini. mau login Nungguin code berjam-jam enggk ada juga.,negatif,2024-05-20,2024,aplikasi apa ini mau login nungguin code berjam jam enggk ada juga,11,12,aplikasi apa ini mau login menunggu code berjam jam enggk ada juga,12,12,"['aplikasi', 'apa', 'ini', 'mau', 'login', 'menunggu', 'code', 'berjam', 'jam', 'enggk', 'ada', 'juga']","['aplikasi', 'login', 'menunggu', 'code', 'berjam', 'jam', 'enggk']",12,7,5,aplikasi login tunggu code jam jam enggk,7,7
"Bagus, selain mencari loker juga bisa cari relasi. Bisa cari referensi juga. Hanya saja beberapa teman pas aku kasih tau ttg apk ini, dia bingung cara pakainya.",positif,2020-12-05,2020,bagus selain mencari loker juga bisa cari relasi bisa cari referensi juga hanya saja beberapa teman pas aku kasih tau ttg apk ini dia bingung cara pakainya,27,27,bagus selain mencari loker juga bisa cari relasi bisa cari referensi juga hanya saja beberapa teman pas aku kasih tahu tentang aplikasi ini dia bingung cara pakainya,27,27,"['bagus', 'selain', 'mencari', 'loker', 'juga', 'bisa', 'cari', 'relasi', 'bisa', 'cari', 'referensi', 'juga', 'hanya', 'saja', 'beberapa', 'teman', 'pas', 'aku', 'kasih', 'tahu', 'tentang', 'aplikasi', 'ini', 'dia', 'bingung', 'cara', 'pakainya']","['bagus', 'mencari', 'loker', 'cari', 'relasi', 'cari', 'referensi', 'teman', 'pas', 'kasih', 'aplikasi', 'bingung', 'pakainya']",27,13,14,bagus cari loker cari relasi cari referensi teman pas kasih aplikasi bingung pakai,13,13
Sangat membantu,positif,2024-08-05,2024,sangat membantu,2,2,sangat membantu,2,2,"['sangat', 'membantu']",['membantu'],2,1,1,bantu,1,1
Ga ikut langganan malah di potong sepihak mana mahal lagi 700 rb ga ikhlas banget minta refund lama banget,negatif,2024-04-05,2024,ga ikut langganan malah di potong sepihak mana mahal lagi rb ga ikhlas banget minta refund lama banget,19,18,tidak ikut langganan bahkan di potong sepihak mana mahal lagi ribu tidak ikhlas banget minta refund lama banget,18,18,"['tidak', 'ikut', 'langganan', 'bahkan', 'di', 'potong', 'sepihak', 'mana', 'mahal', 'lagi', 'ribu', 'tidak', 'ikhlas', 'banget', 'minta', 'refund', 'lama', 'banget']","['tidak', 'langganan', 'potong', 'mahal', 'ribu', 'tidak', 'ikhlas', 'banget', 'refund', 'banget']",18,10,8,tidak langgan potong mahal ribu tidak ikhlas banget refund banget,10,10
Aplikasi terburuk gk profesional akun akun pialang bisa aman akun saya gk salah apa apa diblokir parah sumpah sampah diapk sampai 6 email di saya diblokir permanen padahal saya komplain resmi disertai bukti dan saya hanya menginformasikan bahwa salah satu kandidat dilinkedin mengunakan pengalaman palsu eh akun saya yg dblokir ini berarti LinkedIn gk transparan ya parah dah mudah mudahan LinkedIn kedepak dr playstore,negatif,2022-12-09,2022,aplikasi terburuk gk profesional akun akun pialang bisa aman akun saya gk salah apa apa diblokir parah sumpah sampah diapk sampai email di saya diblokir permanen padahal saya komplain resmi disertai bukti dan saya hanya menginformasikan bahwa salah satu kandidat dilinkedin mengunakan pengalaman palsu eh akun saya yg dblokir ini berarti linkedin gk transparan ya parah dah mudah mudahan linkedin kedepak dr playstore,64,63,aplikasi terburuk tidak profesional akun akun pialang bisa aman akun saya tidak salah apa apa diblokir parah sumpah sampah diapk sampai email di saya diblokir permanen padahal saya komplain resmi disertai bukti dan saya hanya menginformasikan bahwa salah satu kandidat dilinkedin mengunakan pengalaman palsu eh akun saya yang dblokir ini berarti linkedin tidak transparan ya parah sudah mudah mudahan linkedin kedepak dari playstore,63,63,"['aplikasi', 'terburuk', 'tidak', 'profesional', 'akun', 'akun', 'pialang', 'bisa', 'aman', 'akun', 'saya', 'tidak', 'salah', 'apa', 'apa', 'diblokir', 'parah', 'sumpah', 'sampah', 'diapk', 'sampai', 'email', 'di', 'saya', 'diblokir', 'permanen', 'padahal', 'saya', 'komplain', 'resmi', 'disertai', 'bukti', 'dan', 'saya', 'hanya', 'menginformasikan', 'bahwa', 'salah', 'satu', 'kandidat', 'dilinkedin', 'mengunakan', 'pengalaman', 'palsu', 'eh', 'akun', 'saya', 'yang', 'dblokir', 'ini', 'berarti', 'linkedin', 'tidak', 'transparan', 'ya', 'parah', 'sudah', 'mudah', 'mudahan', 'linkedin', 'kedepak', 'dari', 'playstore']","['aplikasi', 'terburuk', 'tidak', 'profesional', 'akun', 'akun', 'pialang', 'aman', 'akun', 'tidak', 'salah', 'diblokir', 'parah', 'sumpah', 'sampah', 'diapk', 'email', 'diblokir', 'permanen', 'komplain', 'resmi', 'disertai', 'bukti', 'menginformasikan', 'salah', 'kandidat', 'dilinkedin', 'mengunakan', 'pengalaman', 'palsu', 'eh', 'akun', 'dblokir', 'linkedin', 'tidak', 'transparan', 'ya', 'parah', 'mudah', 'mudahan', 'linkedin', 'kedepak', 'playstore']",63,43,20,aplikasi buruk tidak profesional akun akun pialang aman akun tidak salah blokir parah sumpah sampah diapk email blokir permanen komplain resmi serta bukti informasi salah kandidat dilinkedin mengunakan alam palsu eh akun dblokir linkedin tidak transparan ya parah mudah mudah linkedin depak playstore,43,43
"Ini gimana? Kok industrinya gabisa diisi, udah saya isi tetep aja jdnya kosong lagi kosong lagi. Dan juga gaada optional buat milih industri apa aja. Tolong bantuannya, kalau pesan ini dijawab dan diberi solusi, saya akan kasih bintang 5",negatif,2022-03-23,2022,ini gimana kok industrinya gabisa diisi udah saya isi tetep aja jdnya kosong lagi kosong lagi dan juga gaada optional buat milih industri apa aja tolong bantuannya kalau pesan ini dijawab dan diberi solusi saya akan kasih bintang,39,38,ini bagaimana kok industrinya tidak bisa diisi sudah saya isi tetap saja jdnya kosong lagi kosong lagi dan juga tidak ada optional buat memilih industri apa saja tolong bantuannya kalau pesan ini dijawab dan diberi solusi saya akan kasih bintang,38,40,"['ini', 'bagaimana', 'kok', 'industrinya', 'tidak', 'bisa', 'diisi', 'sudah', 'saya', 'isi', 'tetap', 'saja', 'jdnya', 'kosong', 'lagi', 'kosong', 'lagi', 'dan', 'juga', 'tidak', 'ada', 'optional', 'buat', 'memilih', 'industri', 'apa', 'saja', 'tolong', 'bantuannya', 'kalau', 'pesan', 'ini', 'dijawab', 'dan', 'diberi', 'solusi', 'saya', 'akan', 'kasih', 'bintang']","['industrinya', 'tidak', 'diisi', 'isi', 'jdnya', 'kosong', 'kosong', 'tidak', 'optional', 'memilih', 'industri', 'tolong', 'bantuannya', 'pesan', 'solusi', 'kasih', 'bintang']",40,17,23,industri tidak isi isi jdnya kosong kosong tidak optional pilih industri tolong bantu pesan solusi kasih bintang,17,17
"Bisa""nya saldo dana saya dipotong katanya tagihan aplikasi padahal saya gk buat apa"" Apk gk jelas balikin itu saldo saya",negatif,2024-04-26,2024,bisa nya saldo dana saya dipotong katanya tagihan aplikasi padahal saya gk buat apa apk gk jelas balikin itu saldo saya,20,21,bisa nya saldo dana saya dipotong katanya tagihan aplikasi padahal saya tidak buat apa aplikasi tidak jelas balikin itu saldo saya,21,21,"['bisa', 'nya', 'saldo', 'dana', 'saya', 'dipotong', 'katanya', 'tagihan', 'aplikasi', 'padahal', 'saya', 'tidak', 'buat', 'apa', 'aplikasi', 'tidak', 'jelas', 'balikin', 'itu', 'saldo', 'saya']","['nya', 'saldo', 'dana', 'dipotong', 'tagihan', 'aplikasi', 'tidak', 'aplikasi', 'tidak', 'balikin', 'saldo']",21,11,10,nya saldo dana potong tagih aplikasi tidak aplikasi tidak balikin saldo,11,11
"bukan untuk mencari kerja saja, diaplikasi ini bisa mendapat ilmu, tergantung dengan bagaimna kita mnggunakan untuk mencari relasi ,",positif,2022-02-03,2022,bukan untuk mencari kerja saja diaplikasi ini bisa mendapat ilmu tergantung dengan bagaimna kita mnggunakan untuk mencari relasi,19,18,bukan untuk mencari kerja saja diaplikasi ini bisa mendapat ilmu tergantung dengan bagaimana kita mnggunakan untuk mencari relasi,18,18,"['bukan', 'untuk', 'mencari', 'kerja', 'saja', 'diaplikasi', 'ini', 'bisa', 'mendapat', 'ilmu', 'tergantung', 'dengan', 'bagaimana', 'kita', 'mnggunakan', 'untuk', 'mencari', 'relasi']","['mencari', 'kerja', 'diaplikasi', 'ilmu', 'tergantung', 'mnggunakan', 'mencari', 'relasi']",18,8,10,cari kerja aplikasi ilmu gantung mnggunakan cari relasi,8,8
Dari 2017 sampe sekarang pake ini belom ada satu pun di panggil gila stress indo indo,negatif,2024-05-02,2024,dari sampe sekarang pake ini belom ada satu pun di panggil gila stress indo indo,16,15,dari sampai sekarang pakai ini belum ada satu pun di panggil gila stress indo indo,15,15,"['dari', 'sampai', 'sekarang', 'pakai', 'ini', 'belum', 'ada', 'satu', 'pun', 'di', 'panggil', 'gila', 'stress', 'indo', 'indo']","['pakai', 'panggil', 'gila', 'stress', 'indo', 'indo']",15,6,9,pakai panggil gila stress indo indo,6,6
"Akun saya diblokir dengan alasan kebanyakan kirim permintaan koneksi. Padahal itu saya pake cara manual, bukan pake alat otomasi apapun. Terus saya bikin baru sama juga ga bisa akses pas udh daftar. Kenapa ya ? Makin ribet",negatif,2022-11-20,2022,akun saya diblokir dengan alasan kebanyakan kirim permintaan koneksi padahal itu saya pake cara manual bukan pake alat otomasi apapun terus saya bikin baru sama juga ga bisa akses pas udh daftar kenapa ya makin ribet,37,36,akun saya diblokir dengan alasan kebanyakan kirim permintaan koneksi padahal itu saya pakai cara manual bukan pakai alat otomasi apapun terus saya bikin baru sama juga tidak bisa akses pas sudah daftar kenapa ya makin rumit,36,36,"['akun', 'saya', 'diblokir', 'dengan', 'alasan', 'kebanyakan', 'kirim', 'permintaan', 'koneksi', 'padahal', 'itu', 'saya', 'pakai', 'cara', 'manual', 'bukan', 'pakai', 'alat', 'otomasi', 'apapun', 'terus', 'saya', 'bikin', 'baru', 'sama', 'juga', 'tidak', 'bisa', 'akses', 'pas', 'sudah', 'daftar', 'kenapa', 'ya', 'makin', 'rumit']","['akun', 'diblokir', 'alasan', 'kebanyakan', 'kirim', 'permintaan', 'koneksi', 'pakai', 'manual', 'pakai', 'alat', 'otomasi', 'apapun', 'bikin', 'tidak', 'akses', 'pas', 'daftar', 'ya', 'rumit']",36,20,16,akun blokir alas banyak kirim minta koneksi pakai manual pakai alat otomasi apa bikin tidak akses pas daftar ya rumit,20,20
"Upload file dokumen untuk portfolio gagal terus, tulisannya eror padahal uk. file juga ga lebih dr 10 mb, berhasil upload tbtb eror tanpa sebab",negatif,2023-02-21,2023,upload file dokumen untuk portfolio gagal terus tulisannya eror padahal uk file juga ga lebih dr mb berhasil upload tbtb eror tanpa sebab,24,23,unggah file dokumen untuk portfolio gagal terus tulisannya error padahal uk file juga tidak lebih dari mb berhasil unggah tbtb error tanpa sebab,23,23,"['unggah', 'file', 'dokumen', 'untuk', 'portfolio', 'gagal', 'terus', 'tulisannya', 'error', 'padahal', 'uk', 'file', 'juga', 'tidak', 'lebih', 'dari', 'mb', 'berhasil', 'unggah', 'tbtb', 'error', 'tanpa', 'sebab']","['unggah', 'file', 'dokumen', 'portfolio', 'gagal', 'tulisannya', 'error', 'uk', 'file', 'tidak', 'mb', 'berhasil', 'unggah', 'tbtb', 'error']",23,15,8,unggah file dokumen portfolio gagal tulis error uk file tidak mb hasil unggah tbtb error,15,15
"terimakasih linkedin sudah memberikan saya kesempatan mendapatkan pekerjaan 10 bulan lalu, orang2 di linkedin juga seru2 kok, dan gapernah kecewa sama aplikasi ini selama pemakaian. jd aplikasi pertama yg sering saya buka dan schroll setiap harinya",positif,2022-07-22,2022,terimakasih linkedin sudah memberikan saya kesempatan mendapatkan pekerjaan bulan lalu orang di linkedin juga seru kok dan gapernah kecewa sama aplikasi ini selama pemakaian jd aplikasi pertama yg sering saya buka dan schroll setiap harinya,36,35,terima kasih linkedin sudah memberikan saya kesempatan mendapatkan pekerjaan bulan lalu orang di linkedin juga seru kok dan tidak pernah kecewa sama aplikasi ini selama pemakaian jadi aplikasi pertama yang sering saya buka dan schroll setiap harinya,35,37,"['terima', 'kasih', 'linkedin', 'sudah', 'memberikan', 'saya', 'kesempatan', 'mendapatkan', 'pekerjaan', 'bulan', 'lalu', 'orang', 'di', 'linkedin', 'juga', 'seru', 'kok', 'dan', 'tidak', 'pernah', 'kecewa', 'sama', 'aplikasi', 'ini', 'selama', 'pemakaian', 'jadi', 'aplikasi', 'pertama', 'yang', 'sering', 'saya', 'buka', 'dan', 'schroll', 'setiap', 'harinya']","['terima', 'kasih', 'linkedin', 'kesempatan', 'pekerjaan', 'orang', 'linkedin', 'seru', 'tidak', 'kecewa', 'aplikasi', 'pemakaian', 'aplikasi', 'buka', 'schroll', 'harinya']",37,16,21,terima kasih linkedin sempat kerja orang linkedin seru tidak kecewa aplikasi pakai aplikasi buka schroll hari,16,16
"Tolong pihak LinkedIn yang tidak berwenang, saldo dana saya terpotong untuk pembayaran google LinkedIn, OTOMATIS TANPA PIN. Dan saya tidak merasa melakukannya. Dan saya tidak melakukan pembayaran apapun. Dan bagaimana caranya agar uang saya kembali",negatif,2022-08-25,2022,tolong pihak linkedin yang tidak berwenang saldo dana saya terpotong untuk pembayaran google linkedin otomatis tanpa pin dan saya tidak merasa melakukannya dan saya tidak melakukan pembayaran apapun dan bagaimana caranya agar uang saya kembali,35,35,tolong pihak linkedin yang tidak berwenang saldo dana saya terpotong untuk pembayaran google linkedin otomatis tanpa pin dan saya tidak merasa melakukannya dan saya tidak melakukan pembayaran apapun dan bagaimana caranya agar uang saya kembali,35,35,"['tolong', 'pihak', 'linkedin', 'yang', 'tidak', 'berwenang', 'saldo', 'dana', 'saya', 'terpotong', 'untuk', 'pembayaran', 'google', 'linkedin', 'otomatis', 'tanpa', 'pin', 'dan', 'saya', 'tidak', 'merasa', 'melakukannya', 'dan', 'saya', 'tidak', 'melakukan', 'pembayaran', 'apapun', 'dan', 'bagaimana', 'caranya', 'agar', 'uang', 'saya', 'kembali']","['tolong', 'linkedin', 'tidak', 'berwenang', 'saldo', 'dana', 'terpotong', 'pembayaran', 'google', 'linkedin', 'otomatis', 'pin', 'tidak', 'melakukannya', 'tidak', 'pembayaran', 'apapun', 'uang']",35,18,17,tolong linkedin tidak wenang saldo dana potong bayar google linkedin otomatis pin tidak laku tidak bayar apa uang,18,18
Sulit masuknya bos que,negatif,2024-06-29,2024,sulit masuknya bos que,4,4,sulit masuknya box que,4,4,"['sulit', 'masuknya', 'box', 'que']","['sulit', 'masuknya', 'box', 'que']",4,4,0,sulit masuk box que,4,4
"ini kenap aplikasi nya setelah di update malah di bagian sumarry deskripsi job and fill requerment malah jadi blank hanya mucul review titik2, tolong di repond.",negatif,2023-02-28,2023,ini kenap aplikasi nya setelah di update malah di bagian sumarry deskripsi job and fill requerment malah jadi blank hanya mucul review titik tolong di repond,26,26,ini kenap aplikasi nya setelah di diperbarui bahkan di bagian sumarry deskripsi kerja and fill requerment bahkan jadi blank hanya mucul ulasan titik tolong di repond,26,26,"['ini', 'kenap', 'aplikasi', 'nya', 'setelah', 'di', 'diperbarui', 'bahkan', 'di', 'bagian', 'sumarry', 'deskripsi', 'kerja', 'and', 'fill', 'requerment', 'bahkan', 'jadi', 'blank', 'hanya', 'mucul', 'ulasan', 'titik', 'tolong', 'di', 'repond']","['kenap', 'aplikasi', 'nya', 'diperbarui', 'sumarry', 'deskripsi', 'kerja', 'and', 'fill', 'requerment', 'blank', 'mucul', 'ulasan', 'titik', 'tolong', 'repond']",26,16,10,kenap aplikasi nya baru sumarry deskripsi kerja and fill requerment blank mucul ulas titik tolong repond,16,16
Mau login susah woi itu gambar badak lo benerin,negatif,2024-06-09,2024,mau login susah woi itu gambar badak lo benerin,9,9,mau login susah woi itu gambar badak lo benerin,9,9,"['mau', 'login', 'susah', 'woi', 'itu', 'gambar', 'badak', 'lo', 'benerin']","['login', 'susah', 'woi', 'gambar', 'badak', 'lo', 'benerin']",9,7,2,login susah woi gambar badak lo benerin,7,7
Gk jelas gk bisa masuk,negatif,2024-08-02,2024,gk jelas gk bisa masuk,5,5,tidak jelas tidak bisa masuk,5,5,"['tidak', 'jelas', 'tidak', 'bisa', 'masuk']","['tidak', 'tidak', 'masuk']",5,3,2,tidak tidak masuk,3,3
Salah satu jejaring sosial yang sangat profesional dan diakses hanya orang-orang kalangan profesional saja dan sangat aksessibel untuk profesional muda Disabilitas Sensorik Netra,positif,2021-08-06,2021,salah satu jejaring sosial yang sangat profesional dan diakses hanya orang orang kalangan profesional saja dan sangat aksessibel untuk profesional muda disabilitas sensorik netra,23,24,salah satu jejaring sosial yang sangat profesional dan diakses hanya orang orang kalangan profesional saja dan sangat aksessibel untuk profesional muda disabilitas sensorik netra,24,24,"['salah', 'satu', 'jejaring', 'sosial', 'yang', 'sangat', 'profesional', 'dan', 'diakses', 'hanya', 'orang', 'orang', 'kalangan', 'profesional', 'saja', 'dan', 'sangat', 'aksessibel', 'untuk', 'profesional', 'muda', 'disabilitas', 'sensorik', 'netra']","['salah', 'jejaring', 'sosial', 'profesional', 'diakses', 'orang', 'orang', 'kalangan', 'profesional', 'aksessibel', 'profesional', 'muda', 'disabilitas', 'sensorik', 'netra']",24,15,9,salah jejaring sosial profesional akses orang orang kalang profesional aksessibel profesional muda disabilitas sensorik netra,15,15
"Ntah kenapa selalu gagal verifikasi gambar terakhir disaat mau buat akun baru, padahal udah dipilih sesuai perintah (menghadap keatas), tapi dari sistem jawabannya salah.",negatif,2021-05-24,2021,ntah kenapa selalu gagal verifikasi gambar terakhir disaat mau buat akun baru padahal udah dipilih sesuai perintah menghadap keatas tapi dari sistem jawabannya salah,24,24,entah kenapa selalu gagal verifikasi gambar terakhir disaat mau buat akun baru padahal sudah dipilih sesuai perintah menghadap keatas tapi dari sistem jawabannya salah,24,24,"['entah', 'kenapa', 'selalu', 'gagal', 'verifikasi', 'gambar', 'terakhir', 'disaat', 'mau', 'buat', 'akun', 'baru', 'padahal', 'sudah', 'dipilih', 'sesuai', 'perintah', 'menghadap', 'keatas', 'tapi', 'dari', 'sistem', 'jawabannya', 'salah']","['gagal', 'verifikasi', 'gambar', 'disaat', 'akun', 'dipilih', 'sesuai', 'perintah', 'menghadap', 'keatas', 'sistem', 'jawabannya', 'salah']",24,13,11,gagal verifikasi gambar saat akun pilih sesuai perintah hadap atas sistem jawab salah,13,13
"App berhenti/menutup paksa ketika menekan tombol untuk halaman ""posting"" di sticky footer. Saya akan tingkatkan bintang setika ini teratasi.",negatif,2022-01-31,2022,app berhenti menutup paksa ketika menekan tombol untuk halaman posting di sticky footer saya akan tingkatkan bintang setika ini teratasi,19,20,aplikasi berhenti menutup paksa ketika menekan tombol untuk halaman posting di sticky footer saya akan tingkatkan bintang setika ini teratasi,20,20,"['aplikasi', 'berhenti', 'menutup', 'paksa', 'ketika', 'menekan', 'tombol', 'untuk', 'halaman', 'posting', 'di', 'sticky', 'footer', 'saya', 'akan', 'tingkatkan', 'bintang', 'setika', 'ini', 'teratasi']","['aplikasi', 'berhenti', 'menutup', 'paksa', 'menekan', 'tombol', 'halaman', 'posting', 'sticky', 'footer', 'tingkatkan', 'bintang', 'setika', 'teratasi']",20,14,6,aplikasi henti tutup paksa tekan tombol halaman posting sticky footer tingkat bintang tika atas,14,14
Dalam kurun waktu 4 minggu Berpuluh puluh lamaran sudah di lamar. Tapi gak ada yg di panggil sama sekali. Giliran ada email masuk dari perusahaan setelah di telusuri ternyata kantor gak jelas.alias penipuan Udah bosen kali orang yang mau nyoba nipu saya di linkedin. Dan lagi pula LinkedIn dan kawan kawan nya seperti jobstreet dll. sekarang isinya iklan lowongan penipuan semua. Coba ajah cek satu persatu Semua lowongan itu. And on the way you uninstal. Pembohongan.,negatif,2021-04-03,2021,dalam kurun waktu minggu berpuluh puluh lamaran sudah di lamar tapi gak ada yg di panggil sama sekali giliran ada email masuk dari perusahaan setelah di telusuri ternyata kantor gak jelas alias penipuan udah bosen kali orang yang mau nyoba nipu saya di linkedin dan lagi pula linkedin dan kawan kawan nya seperti jobstreet dll sekarang isinya iklan lowongan penipuan semua coba ajah cek satu persatu semua lowongan itu and on the way you uninstal pembohongan,76,76,dalam kurun waktu minggu berpuluh puluh lamaran sudah di lamar tapi tidak ada yang di panggil sama sekali giliran ada email masuk dari perusahaan setelah di telusuri ternyata kantor tidak jelas alias penipuan sudah bosen kali orang yang mau mencoba tipu saya di linkedin dan lagi pula linkedin dan kawan kawan nya seperti jobstreet dan lain lain sekarang isinya iklan lowongan penipuan semua coba ajah cek satu persatu semua lowongan itu and on the way you hapus instalan pembohongan,76,79,"['dalam', 'kurun', 'waktu', 'minggu', 'berpuluh', 'puluh', 'lamaran', 'sudah', 'di', 'lamar', 'tapi', 'tidak', 'ada', 'yang', 'di', 'panggil', 'sama', 'sekali', 'giliran', 'ada', 'email', 'masuk', 'dari', 'perusahaan', 'setelah', 'di', 'telusuri', 'ternyata', 'kantor', 'tidak', 'jelas', 'alias', 'penipuan', 'sudah', 'bosen', 'kali', 'orang', 'yang', 'mau', 'mencoba', 'tipu', 'saya', 'di', 'linkedin', 'dan', 'lagi', 'pula', 'linkedin', 'dan', 'kawan', 'kawan', 'nya', 'seperti', 'jobstreet', 'dan', 'lain', 'lain', 'sekarang', 'isinya', 'iklan', 'lowongan', 'penipuan', 'semua', 'coba', 'ajah', 'cek', 'satu', 'persatu', 'semua', 'lowongan', 'itu', 'and', 'on', 'the', 'way', 'you', 'hapus', 'instalan', 'pembohongan']","['kurun', 'minggu', 'berpuluh', 'puluh', 'lamaran', 'lamar', 'tidak', 'panggil', 'giliran', 'email', 'masuk', 'perusahaan', 'telusuri', 'kantor', 'tidak', 'alias', 'penipuan', 'bosen', 'kali', 'orang', 'mencoba', 'tipu', 'linkedin', 'linkedin', 'kawan', 'kawan', 'nya', 'jobstreet', 'isinya', 'iklan', 'lowongan', 'penipuan', 'coba', 'ajah', 'cek', 'persatu', 'lowongan', 'and', 'on', 'the', 'way', 'you', 'hapus', 'instalan', 'pembohongan']",79,45,34,kurun minggu puluh puluh lamar lamar tidak panggil gilir email masuk usaha telusur kantor tidak alias tipu bosen kali orang coba tipu linkedin linkedin kawan kawan nya jobstreet isi iklan lowong tipu coba ajah cek satu lowong and on the way you hapus instalan bohong,45,45
"Gak tau kenapa, saat mencari perusahaan di kolom pencarian tidak pernah muncul. Ada yang sama? Error atau apa ya? Padahal koneksi lancar kaya",negatif,2023-06-10,2023,gak tau kenapa saat mencari perusahaan di kolom pencarian tidak pernah muncul ada yang sama error atau apa ya padahal koneksi lancar kaya,23,23,tidak tahu kenapa saat mencari perusahaan di kolom pencarian tidak pernah muncul ada yang sama error atau apa ya padahal koneksi lancar kayak,23,23,"['tidak', 'tahu', 'kenapa', 'saat', 'mencari', 'perusahaan', 'di', 'kolom', 'pencarian', 'tidak', 'pernah', 'muncul', 'ada', 'yang', 'sama', 'error', 'atau', 'apa', 'ya', 'padahal', 'koneksi', 'lancar', 'kayak']","['tidak', 'mencari', 'perusahaan', 'kolom', 'pencarian', 'tidak', 'muncul', 'error', 'ya', 'koneksi', 'lancar', 'kayak']",23,12,11,tidak cari usaha kolom cari tidak muncul error ya koneksi lancar kayak,12,12
"Ini kenapa pas saya login dan ada isi kode recaptcha ga bisa terus ya? Sudah 8x betul menjawab pertanyaan keamanan, tapi dari sistem aplikasi ini ga bisa di acc. Ada apa dengan aplikasi ini?",negatif,2021-10-11,2021,ini kenapa pas saya login dan ada isi kode recaptcha ga bisa terus ya sudah x betul menjawab pertanyaan keamanan tapi dari sistem aplikasi ini ga bisa di acc ada apa dengan aplikasi ini,34,34,ini kenapa pas saya login dan ada isi kode recaptcha tidak bisa terus ya sudah x betul menjawab pertanyaan keamanan tapi dari sistem aplikasi ini tidak bisa di acc ada apa dengan aplikasi ini,34,34,"['ini', 'kenapa', 'pas', 'saya', 'login', 'dan', 'ada', 'isi', 'kode', 'recaptcha', 'tidak', 'bisa', 'terus', 'ya', 'sudah', 'x', 'betul', 'menjawab', 'pertanyaan', 'keamanan', 'tapi', 'dari', 'sistem', 'aplikasi', 'ini', 'tidak', 'bisa', 'di', 'acc', 'ada', 'apa', 'dengan', 'aplikasi', 'ini']","['pas', 'login', 'isi', 'kode', 'recaptcha', 'tidak', 'ya', 'x', 'keamanan', 'sistem', 'aplikasi', 'tidak', 'acc', 'aplikasi']",34,14,20,pas login isi kode recaptcha tidak ya x aman sistem aplikasi tidak acc aplikasi,14,14
"Gila! Ini aplikasi yg paling susah buat daftar heran!!! Di web susah verifikasi, kode gak masuk masuk... KALIAN BISA MAINTAIN APLIKASI INI GAK SIH!!!!",negatif,2023-09-08,2023,gila ini aplikasi yg paling susah buat daftar heran di web susah verifikasi kode gak masuk masuk kalian bisa maintain aplikasi ini gak sih,24,24,gila ini aplikasi yang paling susah buat daftar heran di web susah verifikasi kode tidak masuk masuk kalian bisa maintain aplikasi ini tidak sih,24,24,"['gila', 'ini', 'aplikasi', 'yang', 'paling', 'susah', 'buat', 'daftar', 'heran', 'di', 'web', 'susah', 'verifikasi', 'kode', 'tidak', 'masuk', 'masuk', 'kalian', 'bisa', 'maintain', 'aplikasi', 'ini', 'tidak', 'sih']","['gila', 'aplikasi', 'susah', 'daftar', 'heran', 'web', 'susah', 'verifikasi', 'kode', 'tidak', 'masuk', 'masuk', 'maintain', 'aplikasi', 'tidak', 'sih']",24,16,8,gila aplikasi susah daftar heran web susah verifikasi kode tidak masuk masuk maintain aplikasi tidak sih,16,16
Saya suka banget karena informasi nya terbaru,positif,2024-06-22,2024,saya suka banget karena informasi nya terbaru,7,7,saya suka banget karena informasi nya terbaru,7,7,"['saya', 'suka', 'banget', 'karena', 'informasi', 'nya', 'terbaru']","['suka', 'banget', 'informasi', 'nya', 'terbaru']",7,5,2,suka banget informasi nya baru,5,5
Sangat membantu,positif,2024-06-18,2024,sangat membantu,2,2,sangat membantu,2,2,"['sangat', 'membantu']",['membantu'],2,1,1,bantu,1,1
"B1 lah ,,registrasi sampe 2 email aja ga bisa masuk,di tambah capchanya sulit..sangat tidak friendly user.",negatif,2022-12-24,2022,b lah registrasi sampe email aja ga bisa masuk di tambah capchanya sulit sangat tidak friendly user,16,17,biasa lah registrasi sampai email saja tidak bisa masuk di tambah capchanya sulit sangat tidak friendly user,17,17,"['biasa', 'lah', 'registrasi', 'sampai', 'email', 'saja', 'tidak', 'bisa', 'masuk', 'di', 'tambah', 'capchanya', 'sulit', 'sangat', 'tidak', 'friendly', 'user']","['registrasi', 'email', 'tidak', 'masuk', 'capchanya', 'sulit', 'tidak', 'friendly', 'user']",17,9,8,registrasi email tidak masuk capchanya sulit tidak friendly user,9,9
Memperluas jaringan bisnis dan relasi semoga kedepan bisa berlangganan yg berbayar agar semakin mempermudah menjangkau target yang lebih luas.Salam sukses untuk tim Linkedln,positif,2022-01-07,2022,memperluas jaringan bisnis dan relasi semoga kedepan bisa berlangganan yg berbayar agar semakin mempermudah menjangkau target yang lebih luas salam sukses untuk tim linkedln,23,24,memperluas jaringan bisnis dan relasi semoga kedepan bisa berlangganan yang berbayar agar semakin mempermudah menjangkau target yang lebih luas salam sukses untuk tim linkedln,24,24,"['memperluas', 'jaringan', 'bisnis', 'dan', 'relasi', 'semoga', 'kedepan', 'bisa', 'berlangganan', 'yang', 'berbayar', 'agar', 'semakin', 'mempermudah', 'menjangkau', 'target', 'yang', 'lebih', 'luas', 'salam', 'sukses', 'untuk', 'tim', 'linkedln']","['memperluas', 'jaringan', 'bisnis', 'relasi', 'semoga', 'kedepan', 'berlangganan', 'berbayar', 'mempermudah', 'menjangkau', 'target', 'luas', 'salam', 'sukses', 'tim', 'linkedln']",24,16,8,luas jaring bisnis relasi moga depan langgan bayar mudah jangkau target luas salam sukses tim linkedln,16,16
proses log in kelamaan dan dipersulit,negatif,2024-04-22,2024,proses log in kelamaan dan dipersulit,6,6,proses log in kelamaan dan dipersulit,6,6,"['proses', 'log', 'in', 'kelamaan', 'dan', 'dipersulit']","['proses', 'log', 'in', 'dipersulit']",6,4,2,proses log in sulit,4,4
Wey ini PLIS ga bisa login pakai Gmaillll,negatif,2024-04-20,2024,wey ini plis ga bisa login pakai gmaillll,8,8,wey ini tolong tidak bisa login pakai gmaillll,8,8,"['wey', 'ini', 'tolong', 'tidak', 'bisa', 'login', 'pakai', 'gmaillll']","['wey', 'tolong', 'tidak', 'login', 'pakai', 'gmaillll']",8,6,2,wey tolong tidak login pakai gmaillll,6,6
Ajg lah verivikasi susah amat lu niat ngk sih buat apk,negatif,2024-06-07,2024,ajg lah verivikasi susah amat lu niat ngk sih buat apk,11,11,ajg lah verivikasi susah amat lu niat tidak sih buat aplikasi,11,11,"['ajg', 'lah', 'verivikasi', 'susah', 'amat', 'lu', 'niat', 'tidak', 'sih', 'buat', 'aplikasi']","['ajg', 'verivikasi', 'susah', 'lu', 'niat', 'tidak', 'sih', 'aplikasi']",11,8,3,ajg verivikasi susah lu niat tidak sih aplikasi,8,8
Sangat bagus dan membantu Saya kasih bintang 5,positif,2024-06-16,2024,sangat bagus dan membantu saya kasih bintang,8,7,sangat bagus dan membantu saya kasih bintang,7,7,"['sangat', 'bagus', 'dan', 'membantu', 'saya', 'kasih', 'bintang']","['bagus', 'membantu', 'kasih', 'bintang']",7,4,3,bagus bantu kasih bintang,4,4
Sangat membantu,positif,2024-07-04,2024,sangat membantu,2,2,sangat membantu,2,2,"['sangat', 'membantu']",['membantu'],2,1,1,bantu,1,1
"Tolong perbaiki bug nya, aplikasi nya ga bisa dibuka. Sudah coba diinstall ulang tetap tidak bisa terbuka. Device Poco F2 Pro.",negatif,2021-08-04,2021,tolong perbaiki bug nya aplikasi nya ga bisa dibuka sudah coba diinstall ulang tetap tidak bisa terbuka device poco f pro,21,21,tolong perbaikan bug nya aplikasi nya tidak bisa dibuka sudah coba diinstall ulang tetap tidak bisa terbuka device poco f pro,21,21,"['tolong', 'perbaikan', 'bug', 'nya', 'aplikasi', 'nya', 'tidak', 'bisa', 'dibuka', 'sudah', 'coba', 'diinstall', 'ulang', 'tetap', 'tidak', 'bisa', 'terbuka', 'device', 'poco', 'f', 'pro']","['tolong', 'perbaikan', 'bug', 'nya', 'aplikasi', 'nya', 'tidak', 'dibuka', 'coba', 'diinstall', 'ulang', 'tidak', 'terbuka', 'device', 'poco', 'f', 'pro']",21,17,4,tolong baik bug nya aplikasi nya tidak buka coba diinstall ulang tidak buka device poco f pro,17,17
"LinkedIn sangat informatif ,profesional,mudah digunakan,sederhana,lengkap dan memiliki tantangan baru dalam mencari pekerjaan",positif,2022-05-24,2022,linkedin sangat informatif profesional mudah digunakan sederhana lengkap dan memiliki tantangan baru dalam mencari pekerjaan,12,15,linkedin sangat informatif profesional mudah digunakan sederhana lengkap dan memiliki tantangan baru dalam mencari pekerjaan,15,15,"['linkedin', 'sangat', 'informatif', 'profesional', 'mudah', 'digunakan', 'sederhana', 'lengkap', 'dan', 'memiliki', 'tantangan', 'baru', 'dalam', 'mencari', 'pekerjaan']","['linkedin', 'informatif', 'profesional', 'mudah', 'sederhana', 'lengkap', 'memiliki', 'tantangan', 'mencari', 'pekerjaan']",15,10,5,linkedin informatif profesional mudah sederhana lengkap milik tantang cari kerja,10,10
"kasusnya sama seperti yang lain. Saya tiba-tiba dapat pembatasan akun, ketika saya mau memverifikasi selalu gagal. saya pun sudah mengirim pengaduan, cuma belum dapat balasan sampai sekarang",negatif,2023-08-18,2023,kasusnya sama seperti yang lain saya tiba tiba dapat pembatasan akun ketika saya mau memverifikasi selalu gagal saya pun sudah mengirim pengaduan cuma belum dapat balasan sampai sekarang,27,28,kasusnya sama seperti yang lain saya tiba tiba dapat pembatasan akun ketika saya mau memverifikasi selalu gagal saya pun sudah mengirim pengaduan cuma belum dapat balasan sampai sekarang,28,28,"['kasusnya', 'sama', 'seperti', 'yang', 'lain', 'saya', 'tiba', 'tiba', 'dapat', 'pembatasan', 'akun', 'ketika', 'saya', 'mau', 'memverifikasi', 'selalu', 'gagal', 'saya', 'pun', 'sudah', 'mengirim', 'pengaduan', 'cuma', 'belum', 'dapat', 'balasan', 'sampai', 'sekarang']","['kasusnya', 'pembatasan', 'akun', 'memverifikasi', 'gagal', 'mengirim', 'pengaduan', 'balasan']",28,8,20,kasus batas akun verifikasi gagal kirim adu balas,8,8
"Aplikasi yang bagus untuk membangun relasi, mendapat informasi yang bahkan tidak terjangkau sebelumnya. Bisa mendapatkan pekerjaan juga.",positif,2021-04-17,2021,aplikasi yang bagus untuk membangun relasi mendapat informasi yang bahkan tidak terjangkau sebelumnya bisa mendapatkan pekerjaan juga,17,17,aplikasi yang bagus untuk membangun relasi mendapat informasi yang bahkan tidak terjangkau sebelumnya bisa mendapatkan pekerjaan juga,17,17,"['aplikasi', 'yang', 'bagus', 'untuk', 'membangun', 'relasi', 'mendapat', 'informasi', 'yang', 'bahkan', 'tidak', 'terjangkau', 'sebelumnya', 'bisa', 'mendapatkan', 'pekerjaan', 'juga']","['aplikasi', 'bagus', 'membangun', 'relasi', 'informasi', 'tidak', 'terjangkau', 'pekerjaan']",17,8,9,aplikasi bagus bangun relasi informasi tidak jangkau kerja,8,8
"Sangat bagus ,dan membantu",positif,2024-06-13,2024,sangat bagus dan membantu,4,4,sangat bagus dan membantu,4,4,"['sangat', 'bagus', 'dan', 'membantu']","['bagus', 'membantu']",4,2,2,bagus bantu,2,2
sangat membantu,positif,2024-06-23,2024,sangat membantu,2,2,sangat membantu,2,2,"['sangat', 'membantu']",['membantu'],2,1,1,bantu,1,1
Aplikasi yang sangat membantu dan menambah ilmu untuk saya. Karena didalam aplikasi ini begitu banyak orang yang sangat hebat yang dapat memberi inspirasi untuk saya terapkan. Terimakasih LINKEDIN.,positif,2021-10-28,2021,aplikasi yang sangat membantu dan menambah ilmu untuk saya karena didalam aplikasi ini begitu banyak orang yang sangat hebat yang dapat memberi inspirasi untuk saya terapkan terimakasih linkedin,28,28,aplikasi yang sangat membantu dan menambah ilmu untuk saya karena didalam aplikasi ini begitu banyak orang yang sangat hebat yang dapat memberi inspirasi untuk saya terapkan terima kasih linkedin,28,29,"['aplikasi', 'yang', 'sangat', 'membantu', 'dan', 'menambah', 'ilmu', 'untuk', 'saya', 'karena', 'didalam', 'aplikasi', 'ini', 'begitu', 'banyak', 'orang', 'yang', 'sangat', 'hebat', 'yang', 'dapat', 'memberi', 'inspirasi', 'untuk', 'saya', 'terapkan', 'terima', 'kasih', 'linkedin']","['aplikasi', 'membantu', 'menambah', 'ilmu', 'didalam', 'aplikasi', 'orang', 'hebat', 'inspirasi', 'terapkan', 'terima', 'kasih', 'linkedin']",29,13,16,aplikasi bantu tambah ilmu dalam aplikasi orang hebat inspirasi terap terima kasih linkedin,13,13
"Awal mula tidak bisa refresh page linkedIn mobile, padahal saya memiliki akun premium. Sudah coba uninstall dan log in kembali namun tetap gagal. Tolong perbaikannya",negatif,2021-01-10,2021,awal mula tidak bisa refresh page linkedin mobile padahal saya memiliki akun premium sudah coba uninstall dan log in kembali namun tetap gagal tolong perbaikannya,25,25,awal mula tidak bisa refresh page linkedin mobile padahal saya memiliki akun premium sudah coba uninstall dan log in kembali namun tetap gagal tolong perbaikannya,25,25,"['awal', 'mula', 'tidak', 'bisa', 'refresh', 'page', 'linkedin', 'mobile', 'padahal', 'saya', 'memiliki', 'akun', 'premium', 'sudah', 'coba', 'uninstall', 'dan', 'log', 'in', 'kembali', 'namun', 'tetap', 'gagal', 'tolong', 'perbaikannya']","['tidak', 'refresh', 'page', 'linkedin', 'mobile', 'memiliki', 'akun', 'premium', 'coba', 'uninstall', 'log', 'in', 'gagal', 'tolong', 'perbaikannya']",25,15,10,tidak refresh page linkedin mobile milik akun premium coba uninstall log in gagal tolong baik,15,15
"Saya sudah punya akun dan login namun mengapa saat buka lagi aplikasi harus konfirmasi email. Susah Login, sudah konfirmasi email namun tidak dikirim link login di email.",negatif,2021-04-01,2021,saya sudah punya akun dan login namun mengapa saat buka lagi aplikasi harus konfirmasi email susah login sudah konfirmasi email namun tidak dikirim link login di email,27,27,saya sudah punya akun dan login namun mengapa saat buka lagi aplikasi harus konfirmasi email susah login sudah konfirmasi email namun tidak dikirim link login di email,27,27,"['saya', 'sudah', 'punya', 'akun', 'dan', 'login', 'namun', 'mengapa', 'saat', 'buka', 'lagi', 'aplikasi', 'harus', 'konfirmasi', 'email', 'susah', 'login', 'sudah', 'konfirmasi', 'email', 'namun', 'tidak', 'dikirim', 'link', 'login', 'di', 'email']","['akun', 'login', 'buka', 'aplikasi', 'konfirmasi', 'email', 'susah', 'login', 'konfirmasi', 'email', 'tidak', 'dikirim', 'link', 'login', 'email']",27,15,12,akun login buka aplikasi konfirmasi email susah login konfirmasi email tidak kirim link login email,15,15
Mecahin teka teki susah amat pdhl udah jelas jelas ngadep ke atas dinosaurusnya,negatif,2024-07-04,2024,mecahin teka teki susah amat pdhl udah jelas jelas ngadep ke atas dinosaurusnya,13,13,mecahin teka teki susah amat padahal sudah jelas jelas ngadep ke atas dinosaurusnya,13,13,"['mecahin', 'teka', 'teki', 'susah', 'amat', 'padahal', 'sudah', 'jelas', 'jelas', 'ngadep', 'ke', 'atas', 'dinosaurusnya']","['mecahin', 'teka', 'teki', 'susah', 'ngadep', 'dinosaurusnya']",13,6,7,mecahin teka teki susah ngadep dinosaurus,6,6
"Mau login gak bisa alasan error lagian ngapain kali pake masuki reCaptcha ke aplikasi yang make juga manusia kali, berkali kali coba login gak bisa reCaptcha katanya invalid",negatif,2024-01-14,2024,mau login gak bisa alasan error lagian ngapain kali pake masuki recaptcha ke aplikasi yang make juga manusia kali berkali kali coba login gak bisa recaptcha katanya invalid,28,28,mau login tidak bisa alasan error lagian buat apa kali pakai masuki recaptcha ke aplikasi yang make juga manusia kali berkali kali coba login tidak bisa recaptcha katanya invalid,28,29,"['mau', 'login', 'tidak', 'bisa', 'alasan', 'error', 'lagian', 'buat', 'apa', 'kali', 'pakai', 'masuki', 'recaptcha', 'ke', 'aplikasi', 'yang', 'make', 'juga', 'manusia', 'kali', 'berkali', 'kali', 'coba', 'login', 'tidak', 'bisa', 'recaptcha', 'katanya', 'invalid']","['login', 'tidak', 'alasan', 'error', 'kali', 'pakai', 'masuki', 'recaptcha', 'aplikasi', 'make', 'manusia', 'kali', 'berkali', 'kali', 'coba', 'login', 'tidak', 'recaptcha', 'invalid']",29,19,10,login tidak alas error kali pakai masuk recaptcha aplikasi make manusia kali kali kali coba login tidak recaptcha invalid,19,19
Iklan terlalu lama,negatif,2024-05-30,2024,iklan terlalu lama,3,3,iklan terlalu lama,3,3,"['iklan', 'terlalu', 'lama']",['iklan'],3,1,2,iklan,1,1
"Sangat bagus apk ini,",positif,2024-06-21,2024,sangat bagus apk ini,4,4,sangat bagus aplikasi ini,4,4,"['sangat', 'bagus', 'aplikasi', 'ini']","['bagus', 'aplikasi']",4,2,2,bagus aplikasi,2,2
Filter gak masuk akal.. udh input lokasi jakarta tapi masih nampilin lowongan dari seluruh dunia.. gak bsa diurut dari yg terbaru.. masa kalah ama jobstreett.. hei muhasabah diri kalian kapitalis..,negatif,2020-03-27,2020,filter gak masuk akal udh input lokasi jakarta tapi masih nampilin lowongan dari seluruh dunia gak bsa diurut dari yg terbaru masa kalah ama jobstreett hei muhasabah diri kalian kapitalis,30,30,filter tidak masuk akal sudah input lokasi jakarta tapi masih nampilin lowongan dari seluruh dunia tidak bisa diurut dari yang terbaru masa kalah sama jobstreett hei muhasabah diri kalian kapitalis,30,30,"['filter', 'tidak', 'masuk', 'akal', 'sudah', 'input', 'lokasi', 'jakarta', 'tapi', 'masih', 'nampilin', 'lowongan', 'dari', 'seluruh', 'dunia', 'tidak', 'bisa', 'diurut', 'dari', 'yang', 'terbaru', 'masa', 'kalah', 'sama', 'jobstreett', 'hei', 'muhasabah', 'diri', 'kalian', 'kapitalis']","['filter', 'tidak', 'masuk', 'akal', 'input', 'lokasi', 'jakarta', 'nampilin', 'lowongan', 'dunia', 'tidak', 'diurut', 'terbaru', 'kalah', 'jobstreett', 'hei', 'muhasabah', 'kapitalis']",30,18,12,filter tidak masuk akal input lokasi jakarta nampilin lowong dunia tidak urut baru kalah jobstreett hei muhasabah kapitalis,18,18
"Tampilan Nya bagus, jaringan terperdaya, cocok yang ingin punya relasi bermutu.",positif,2021-01-22,2021,tampilan nya bagus jaringan terperdaya cocok yang ingin punya relasi bermutu,11,11,tampilan nya bagus jaringan terperdaya cocok yang ingin punya relasi bermutu,11,11,"['tampilan', 'nya', 'bagus', 'jaringan', 'terperdaya', 'cocok', 'yang', 'ingin', 'punya', 'relasi', 'bermutu']","['tampilan', 'nya', 'bagus', 'jaringan', 'terperdaya', 'cocok', 'relasi', 'bermutu']",11,8,3,tampil nya bagus jaring daya cocok relasi mutu,8,8
"gabisa login, captcha gaje",negatif,2024-06-04,2024,gabisa login captcha gaje,4,4,tidak bisa login captcha gaje,4,5,"['tidak', 'bisa', 'login', 'captcha', 'gaje']","['tidak', 'login', 'captcha', 'gaje']",5,4,1,tidak login captcha gaje,4,4
Pekerjaan yang tersedia diaplikasi ini mayoritas 80% halaman tidak bisa dibuka (dilamar). Justru lowongan yg telah expired bisa di akses. Not recommended !!,negatif,2020-06-26,2020,pekerjaan yang tersedia diaplikasi ini mayoritas halaman tidak bisa dibuka dilamar justru lowongan yg telah expired bisa di akses not recommended,23,21,pekerjaan yang tersedia diaplikasi ini mayoritas halaman tidak bisa dibuka dilamar justru lowongan yang telah expired bisa di akses not rekomendasi,21,21,"['pekerjaan', 'yang', 'tersedia', 'diaplikasi', 'ini', 'mayoritas', 'halaman', 'tidak', 'bisa', 'dibuka', 'dilamar', 'justru', 'lowongan', 'yang', 'telah', 'expired', 'bisa', 'di', 'akses', 'not', 'rekomendasi']","['pekerjaan', 'tersedia', 'diaplikasi', 'mayoritas', 'halaman', 'tidak', 'dibuka', 'dilamar', 'lowongan', 'expired', 'akses', 'not', 'rekomendasi']",21,13,8,kerja sedia aplikasi mayoritas halaman tidak buka lamar lowong expired akses not rekomendasi,13,13
"Selalu minta verifikasi setiap login, udh dijawab malah ngulang terus, pas cari bantuan malah disuruh login dan minta verifikasi lagi, pihak developer mohon diperbaiki",negatif,2023-07-30,2023,selalu minta verifikasi setiap login udh dijawab malah ngulang terus pas cari bantuan malah disuruh login dan minta verifikasi lagi pihak developer mohon diperbaiki,24,24,selalu minta verifikasi setiap login sudah dijawab bahkan mengulang terus pas cari bantuan bahkan disuruh login dan minta verifikasi lagi pihak developer mohon di perbaiki,24,25,"['selalu', 'minta', 'verifikasi', 'setiap', 'login', 'sudah', 'dijawab', 'bahkan', 'mengulang', 'terus', 'pas', 'cari', 'bantuan', 'bahkan', 'disuruh', 'login', 'dan', 'minta', 'verifikasi', 'lagi', 'pihak', 'developer', 'mohon', 'di', 'perbaiki']","['verifikasi', 'login', 'mengulang', 'pas', 'cari', 'bantuan', 'disuruh', 'login', 'verifikasi', 'developer', 'mohon', 'perbaiki']",25,12,13,verifikasi login ulang pas cari bantu suruh login verifikasi developer mohon baik,12,12
"aneh banget woi verifikasi nya gak bisa bisa Mulu dah, nyuri data yaa ini aplikasi?",negatif,2024-08-05,2024,aneh banget woi verifikasi nya gak bisa bisa mulu dah nyuri data yaa ini aplikasi,15,15,aneh banget woi verifikasi nya tidak bisa bisa mulu sudah nyuri data ya ini aplikasi,15,15,"['aneh', 'banget', 'woi', 'verifikasi', 'nya', 'tidak', 'bisa', 'bisa', 'mulu', 'sudah', 'nyuri', 'data', 'ya', 'ini', 'aplikasi']","['aneh', 'banget', 'woi', 'verifikasi', 'nya', 'tidak', 'mulu', 'nyuri', 'data', 'ya', 'aplikasi']",15,11,4,aneh banget woi verifikasi nya tidak mulu nyuri data ya aplikasi,11,11
"Sudah berulang kali membuat akun dan selalu tersuspend, padahal saya hanya ingin menggunakan aplikasi ini untuk tugas kuliah, tidak untuk hal yang merugikan. Tolong diperbaiki lagi sistemnya.",negatif,2023-08-18,2023,sudah berulang kali membuat akun dan selalu tersuspend padahal saya hanya ingin menggunakan aplikasi ini untuk tugas kuliah tidak untuk hal yang merugikan tolong diperbaiki lagi sistemnya,27,27,sudah berulang kali membuat akun dan selalu tersuspend padahal saya hanya ingin menggunakan aplikasi ini untuk tugas kuliah tidak untuk hal yang merugikan tolong di perbaiki lagi sistemnya,27,28,"['sudah', 'berulang', 'kali', 'membuat', 'akun', 'dan', 'selalu', 'tersuspend', 'padahal', 'saya', 'hanya', 'ingin', 'menggunakan', 'aplikasi', 'ini', 'untuk', 'tugas', 'kuliah', 'tidak', 'untuk', 'hal', 'yang', 'merugikan', 'tolong', 'di', 'perbaiki', 'lagi', 'sistemnya']","['berulang', 'kali', 'akun', 'tersuspend', 'aplikasi', 'tugas', 'kuliah', 'tidak', 'merugikan', 'tolong', 'perbaiki', 'sistemnya']",28,12,16,ulang kali akun tersuspend aplikasi tugas kuliah tidak rugi tolong baik sistem,12,12
aplikasi wajib buat org2 yg punya usaha/ jualan tuh ya gopay merchant,positif,2024-06-09,2024,aplikasi wajib buat org yg punya usaha jualan tuh ya gopay merchant,12,12,aplikasi wajib buat orang yang punya usaha jualan tuh ya gopay merchant,12,12,"['aplikasi', 'wajib', 'buat', 'orang', 'yang', 'punya', 'usaha', 'jualan', 'tuh', 'ya', 'gopay', 'merchant']","['aplikasi', 'wajib', 'orang', 'usaha', 'jualan', 'tuh', 'ya', 'gopay', 'merchant']",12,9,3,aplikasi wajib orang usaha jual tuh ya gopay merchant,9,9
Tolong diperbaiki masalah force close saat akan mengisi form data apapun . Jika sudah kembali ke 5 . Terimakasih :),negatif,2020-07-12,2020,tolong diperbaiki masalah force close saat akan mengisi form data apapun jika sudah kembali ke terimakasih,20,16,tolong di perbaiki masalah force close saat akan mengisi form data apapun jika sudah kembali ke terima kasih,16,18,"['tolong', 'di', 'perbaiki', 'masalah', 'force', 'close', 'saat', 'akan', 'mengisi', 'form', 'data', 'apapun', 'jika', 'sudah', 'kembali', 'ke', 'terima', 'kasih']","['tolong', 'perbaiki', 'force', 'close', 'mengisi', 'form', 'data', 'apapun', 'terima', 'kasih']",18,10,8,tolong baik force close isi form data apa terima kasih,10,10
Setelah di update malah saya gabisa posting di linkedin dan tiba tiba keluar sendiri Mohon di perbaiki,negatif,2021-12-16,2021,setelah di update malah saya gabisa posting di linkedin dan tiba tiba keluar sendiri mohon di perbaiki,17,17,setelah di diperbarui bahkan saya tidak bisa posting di linkedin dan tiba tiba keluar sendiri mohon di perbaikan,17,18,"['setelah', 'di', 'diperbarui', 'bahkan', 'saya', 'tidak', 'bisa', 'posting', 'di', 'linkedin', 'dan', 'tiba', 'tiba', 'keluar', 'sendiri', 'mohon', 'di', 'perbaikan']","['diperbarui', 'tidak', 'posting', 'linkedin', 'mohon', 'perbaikan']",18,6,12,baru tidak posting linkedin mohon baik,6,6
"Parah, masa dah di upload pake identitas asli tetep gx bisa, malah ada notifikasi *terjadi masalah, harap cba lagi*, kan aneh 🤐",negatif,2023-06-14,2023,parah masa dah di upload pake identitas asli tetep gx bisa malah ada notifikasi terjadi masalah harap cba lagi kan aneh,22,21,parah masa sudah di unggah pakai identitas asli tetap tidak bisa bahkan ada notifikasi terjadi masalah harap cba lagi akan aneh,21,21,"['parah', 'masa', 'sudah', 'di', 'unggah', 'pakai', 'identitas', 'asli', 'tetap', 'tidak', 'bisa', 'bahkan', 'ada', 'notifikasi', 'terjadi', 'masalah', 'harap', 'cba', 'lagi', 'akan', 'aneh']","['parah', 'unggah', 'pakai', 'identitas', 'asli', 'tidak', 'notifikasi', 'harap', 'cba', 'aneh']",21,10,11,parah unggah pakai identitas asli tidak notifikasi harap cba aneh,10,10
Terima Kasih Untuk Linkedin dan Semua relasi Ku. Perlahan namun pasti Bisnis Logistik Ku berkembang dengan baik.,positif,2021-02-26,2021,terima kasih untuk linkedin dan semua relasi ku perlahan namun pasti bisnis logistik ku berkembang dengan baik,17,17,terima kasih untuk linkedin dan semua relasi saya perlahan namun pasti bisnis logistik saya berkembang dengan baik,17,17,"['terima', 'kasih', 'untuk', 'linkedin', 'dan', 'semua', 'relasi', 'saya', 'perlahan', 'namun', 'pasti', 'bisnis', 'logistik', 'saya', 'berkembang', 'dengan', 'baik']","['terima', 'kasih', 'linkedin', 'relasi', 'perlahan', 'bisnis', 'logistik', 'berkembang']",17,8,9,terima kasih linkedin relasi perlahan bisnis logistik kembang,8,8
"Sekedar informasi bagi yang ausah untuk mendaftar saat pilih gambar,pilih gambar kodok yang poaisinya normal,kalo masih susah silahkan kunjungi website LinkedIn nya untuk mendaftar",negatif,2021-12-27,2021,sekedar informasi bagi yang ausah untuk mendaftar saat pilih gambar pilih gambar kodok yang poaisinya normal kalo masih susah silahkan kunjungi website linkedin nya untuk mendaftar,24,26,sekadar informasi bagi yang ausah untuk mendaftar saat pilih gambar pilih gambar kodok yang poaisinya normal kalau masih susah silahkan kunjungi website linkedin nya untuk mendaftar,26,26,"['sekadar', 'informasi', 'bagi', 'yang', 'ausah', 'untuk', 'mendaftar', 'saat', 'pilih', 'gambar', 'pilih', 'gambar', 'kodok', 'yang', 'poaisinya', 'normal', 'kalau', 'masih', 'susah', 'silahkan', 'kunjungi', 'website', 'linkedin', 'nya', 'untuk', 'mendaftar']","['informasi', 'ausah', 'mendaftar', 'pilih', 'gambar', 'pilih', 'gambar', 'kodok', 'poaisinya', 'normal', 'susah', 'silahkan', 'kunjungi', 'website', 'linkedin', 'nya', 'mendaftar']",26,17,9,informasi ausah daftar pilih gambar pilih gambar kodok poaisinya normal susah silah kunjung website linkedin nya daftar,17,17
"Bagus banget aplikasinya, saya sarankan buat para kaum muda, LinkedIn ini penting banget bahkan kalo bisa semenjak anda liat postinganku ini langsung bikin terus buat personal branding kamu ya",positif,2022-03-02,2022,bagus banget aplikasinya saya sarankan buat para kaum muda linkedin ini penting banget bahkan kalo bisa semenjak anda liat postinganku ini langsung bikin terus buat personal branding kamu ya,29,29,bagus banget aplikasi nya saya sarankan buat para kaum muda linkedin ini penting banget bahkan kalau bisa semenjak anda lihat postinganku ini langsung bikin terus buat personal branding kamu ya,29,30,"['bagus', 'banget', 'aplikasi', 'nya', 'saya', 'sarankan', 'buat', 'para', 'kaum', 'muda', 'linkedin', 'ini', 'penting', 'banget', 'bahkan', 'kalau', 'bisa', 'semenjak', 'anda', 'lihat', 'postinganku', 'ini', 'langsung', 'bikin', 'terus', 'buat', 'personal', 'branding', 'kamu', 'ya']","['bagus', 'banget', 'aplikasi', 'nya', 'sarankan', 'kaum', 'muda', 'linkedin', 'banget', 'semenjak', 'lihat', 'postinganku', 'langsung', 'bikin', 'personal', 'branding', 'ya']",30,17,13,bagus banget aplikasi nya saran kaum muda linkedin banget semenjak lihat postinganku langsung bikin personal branding ya,17,17
Aplikasi paling jelek ketika dibuka ulang captcha muncul terus dan gak bisa gabung padahal sdh jadi member lama,negatif,2024-01-27,2024,aplikasi paling jelek ketika dibuka ulang captcha muncul terus dan gak bisa gabung padahal sdh jadi member lama,18,18,aplikasi paling jelek ketika dibuka ulang captcha muncul terus dan tidak bisa gabung padahal sudah jadi member lama,18,18,"['aplikasi', 'paling', 'jelek', 'ketika', 'dibuka', 'ulang', 'captcha', 'muncul', 'terus', 'dan', 'tidak', 'bisa', 'gabung', 'padahal', 'sudah', 'jadi', 'member', 'lama']","['aplikasi', 'jelek', 'dibuka', 'ulang', 'captcha', 'muncul', 'tidak', 'gabung', 'member']",18,9,9,aplikasi jelek buka ulang captcha muncul tidak gabung member,9,9
"klo iklan kasih besar sedikit napa tanda silangnya, susah dipencet tau",negatif,2024-06-07,2024,klo iklan kasih besar sedikit napa tanda silangnya susah dipencet tau,11,11,kalau iklan kasih besar sedikit napa tanda silangnya susah dipencet tahu,11,11,"['kalau', 'iklan', 'kasih', 'besar', 'sedikit', 'napa', 'tanda', 'silangnya', 'susah', 'dipencet', 'tahu']","['iklan', 'kasih', 'napa', 'tanda', 'silangnya', 'susah', 'dipencet']",11,7,4,iklan kasih napa tanda silang susah pencet,7,7
Udah login berkali-kali malah dapat security check kode chapta yang makin bertambah banyak lah gimana ceritanya mau cari kerja aja dipersulit gini,negatif,2024-01-08,2024,udah login berkali kali malah dapat security check kode chapta yang makin bertambah banyak lah gimana ceritanya mau cari kerja aja dipersulit gini,22,23,sudah login berkali kali bahkan dapat security cek kode chapta yang makin bertambah banyak lah bagaimana ceritanya mau cari kerja saja dipersulit begini,23,23,"['sudah', 'login', 'berkali', 'kali', 'bahkan', 'dapat', 'security', 'cek', 'kode', 'chapta', 'yang', 'makin', 'bertambah', 'banyak', 'lah', 'bagaimana', 'ceritanya', 'mau', 'cari', 'kerja', 'saja', 'dipersulit', 'begini']","['login', 'berkali', 'kali', 'security', 'cek', 'kode', 'chapta', 'bertambah', 'ceritanya', 'cari', 'kerja', 'dipersulit']",23,12,11,login kali kali security cek kode chapta tambah cerita cari kerja sulit,12,12
Linkedin luar biasa mengenal berbagai macam karakter orang..dari situ kita jadi banyak belajar...linkedin mantap pisan,positif,2020-09-24,2020,linkedin luar biasa mengenal berbagai macam karakter orang dari situ kita jadi banyak belajar linkedin mantap pisan,15,17,linkedin luar biasa mengenal berbagai macam karakter orang dari situ kita jadi banyak belajar linkedin mantap pisan,17,17,"['linkedin', 'luar', 'biasa', 'mengenal', 'berbagai', 'macam', 'karakter', 'orang', 'dari', 'situ', 'kita', 'jadi', 'banyak', 'belajar', 'linkedin', 'mantap', 'pisan']","['linkedin', 'mengenal', 'karakter', 'orang', 'situ', 'belajar', 'linkedin', 'mantap', 'pisan']",17,9,8,linkedin kenal karakter orang situ ajar linkedin mantap pis,9,9
Sangat membantu dan menarik menurut saya pribadi kita bisa sharing informasi dan tau berita ter update di dunia Oil&gas khususnya saya pribadi. Nice..Very Nice cheers for you all,positif,2021-07-08,2021,sangat membantu dan menarik menurut saya pribadi kita bisa sharing informasi dan tau berita ter update di dunia oil gas khususnya saya pribadi nice very nice cheers for you all,28,30,sangat membantu dan menarik menurut saya pribadi kita bisa sharing informasi dan tahu berita ter diperbarui di dunia oil gas khususnya saya pribadi baik sangat baik cheers for you all,30,30,"['sangat', 'membantu', 'dan', 'menarik', 'menurut', 'saya', 'pribadi', 'kita', 'bisa', 'sharing', 'informasi', 'dan', 'tahu', 'berita', 'ter', 'diperbarui', 'di', 'dunia', 'oil', 'gas', 'khususnya', 'saya', 'pribadi', 'baik', 'sangat', 'baik', 'cheers', 'for', 'you', 'all']","['membantu', 'menarik', 'pribadi', 'sharing', 'informasi', 'berita', 'ter', 'diperbarui', 'dunia', 'oil', 'gas', 'pribadi', 'cheers', 'for', 'you', 'all']",30,16,14,bantu tarik pribadi sharing informasi berita ter baru dunia oil gas pribadi cheers for you all,16,16
"Linkedin apps utk android 13, di MIUI 14 XIAOMI selalu gagal dalam Verifikasi captcha baik dgn image ataupun audio.",negatif,2023-07-30,2023,linkedin apps utk android di miui xiaomi selalu gagal dalam verifikasi captcha baik dgn image ataupun audio,19,17,linkedin aplikasi untuk android di miui xiaomi selalu gagal dalam verifikasi captcha baik dengan image ataupun audio,17,17,"['linkedin', 'aplikasi', 'untuk', 'android', 'di', 'miui', 'xiaomi', 'selalu', 'gagal', 'dalam', 'verifikasi', 'captcha', 'baik', 'dengan', 'image', 'ataupun', 'audio']","['linkedin', 'aplikasi', 'android', 'miui', 'xiaomi', 'gagal', 'verifikasi', 'captcha', 'image', 'audio']",17,10,7,linkedin aplikasi android miui xiaomi gagal verifikasi captcha image audio,10,10
Aplikasi yang benar-benar menambah relasi dari berbagai kalangan pekerjaan serta alumni jurusan dan info terbaru terkait lowongan kerja. Mantapp LinkedIn!,positif,2021-08-02,2021,aplikasi yang benar benar menambah relasi dari berbagai kalangan pekerjaan serta alumni jurusan dan info terbaru terkait lowongan kerja mantapp linkedin,20,21,aplikasi yang benar benar menambah relasi dari berbagai kalangan pekerjaan serta alumni jurusan dan informasi terbaru terkait lowongan kerja mantap linkedin,21,21,"['aplikasi', 'yang', 'benar', 'benar', 'menambah', 'relasi', 'dari', 'berbagai', 'kalangan', 'pekerjaan', 'serta', 'alumni', 'jurusan', 'dan', 'informasi', 'terbaru', 'terkait', 'lowongan', 'kerja', 'mantap', 'linkedin']","['aplikasi', 'menambah', 'relasi', 'kalangan', 'pekerjaan', 'alumni', 'jurusan', 'informasi', 'terbaru', 'terkait', 'lowongan', 'kerja', 'mantap', 'linkedin']",21,14,7,aplikasi tambah relasi kalang kerja alumni jurus informasi baru kait lowong kerja mantap linkedin,14,14
wau saya senang sekali.. apk yang selama ini saya cari2 ternyata ada beneran.. walailupun saya tidak tau apa fungsinya.,positif,2020-05-27,2020,wau saya senang sekali apk yang selama ini saya cari ternyata ada beneran walailupun saya tidak tau apa fungsinya,19,19,wau saya senang sekali aplikasi yang selama ini saya cari ternyata ada benaran walailupun saya tidak tahu apa fungsinya,19,19,"['wau', 'saya', 'senang', 'sekali', 'aplikasi', 'yang', 'selama', 'ini', 'saya', 'cari', 'ternyata', 'ada', 'benaran', 'walailupun', 'saya', 'tidak', 'tahu', 'apa', 'fungsinya']","['wau', 'senang', 'aplikasi', 'cari', 'benaran', 'walailupun', 'tidak', 'fungsinya']",19,8,11,wau senang aplikasi cari benar walailupun tidak fungsi,8,8
Mau edit photo profil kok gak bisa .... Selalu setiap klik save gagal terus..,negatif,2020-03-02,2020,mau edit photo profil kok gak bisa selalu setiap klik save gagal terus,14,13,mau edit photo profil kok tidak bisa selalu setiap klik save gagal terus,13,13,"['mau', 'edit', 'photo', 'profil', 'kok', 'tidak', 'bisa', 'selalu', 'setiap', 'klik', 'save', 'gagal', 'terus']","['edit', 'photo', 'profil', 'tidak', 'klik', 'save', 'gagal']",13,7,6,edit photo profil tidak klik save gagal,7,7
"Jaringan koneksi terhadap user,Bos dan relasi sangat terbuka dan terbantu,linkedin aplikasi digital pemersatu manusia modern saat ini",positif,2022-08-25,2022,jaringan koneksi terhadap user bos dan relasi sangat terbuka dan terbantu linkedin aplikasi digital pemersatu manusia modern saat ini,17,19,jaringan koneksi terhadap user box dan relasi sangat terbuka dan membantu linkedin aplikasi digital pemersatu manusia modern saat ini,19,19,"['jaringan', 'koneksi', 'terhadap', 'user', 'box', 'dan', 'relasi', 'sangat', 'terbuka', 'dan', 'membantu', 'linkedin', 'aplikasi', 'digital', 'pemersatu', 'manusia', 'modern', 'saat', 'ini']","['jaringan', 'koneksi', 'user', 'box', 'relasi', 'terbuka', 'membantu', 'linkedin', 'aplikasi', 'digital', 'pemersatu', 'manusia', 'modern']",19,13,6,jaring koneksi user box relasi buka bantu linkedin aplikasi digital satu manusia modern,13,13
Sentuh gambar menghadap ke atas sangat tidak jelas. verifikasi nomor sudah benar. Itu sudah sangat cukup. Aplikasi ini sangat buruk,negatif,2022-03-03,2022,sentuh gambar menghadap ke atas sangat tidak jelas verifikasi nomor sudah benar itu sudah sangat cukup aplikasi ini sangat buruk,20,20,sentuh gambar menghadap ke atas sangat tidak jelas verifikasi nomor sudah benar itu sudah sangat cukup aplikasi ini sangat buruk,20,20,"['sentuh', 'gambar', 'menghadap', 'ke', 'atas', 'sangat', 'tidak', 'jelas', 'verifikasi', 'nomor', 'sudah', 'benar', 'itu', 'sudah', 'sangat', 'cukup', 'aplikasi', 'ini', 'sangat', 'buruk']","['sentuh', 'gambar', 'menghadap', 'tidak', 'verifikasi', 'nomor', 'aplikasi', 'buruk']",20,8,12,sentuh gambar hadap tidak verifikasi nomor aplikasi buruk,8,8
Tolong di perbaiki verifikasi CAPTCHA nya. Padahal koneksi bagus tapi selalu ada peringatan tidak valid.,negatif,2023-11-01,2023,tolong di perbaiki verifikasi captcha nya padahal koneksi bagus tapi selalu ada peringatan tidak valid,15,15,tolong di perbaikan verifikasi captcha nya padahal koneksi bagus tapi selalu ada peringatan tidak valid,15,15,"['tolong', 'di', 'perbaikan', 'verifikasi', 'captcha', 'nya', 'padahal', 'koneksi', 'bagus', 'tapi', 'selalu', 'ada', 'peringatan', 'tidak', 'valid']","['tolong', 'perbaikan', 'verifikasi', 'captcha', 'nya', 'koneksi', 'bagus', 'peringatan', 'tidak', 'valid']",15,10,5,tolong baik verifikasi captcha nya koneksi bagus ingat tidak valid,10,10
Kenapa setelah saya perbaharui jadi tidak bisa login ya? Terus klik lupa password juga tetap tidak bisa. Mohon bantuannya.,negatif,2020-12-02,2020,kenapa setelah saya perbaharui jadi tidak bisa login ya terus klik lupa password juga tetap tidak bisa mohon bantuannya,19,19,kenapa setelah saya perbaharui jadi tidak bisa login ya terus klik lupa password juga tetap tidak bisa mohon bantuannya,19,19,"['kenapa', 'setelah', 'saya', 'perbaharui', 'jadi', 'tidak', 'bisa', 'login', 'ya', 'terus', 'klik', 'lupa', 'password', 'juga', 'tetap', 'tidak', 'bisa', 'mohon', 'bantuannya']","['perbaharui', 'tidak', 'login', 'ya', 'klik', 'lupa', 'password', 'tidak', 'mohon', 'bantuannya']",19,10,9,baharu tidak login ya klik lupa password tidak mohon bantu,10,10
"Tolong diperbaiki lagi karena masih sangat banyak masalah. Mulai dari Upload foto banner tapi malah lari ke foto profile, masalah login dan lain sebagainya",negatif,2023-11-12,2023,tolong diperbaiki lagi karena masih sangat banyak masalah mulai dari upload foto banner tapi malah lari ke foto profile masalah login dan lain sebagainya,24,24,tolong di perbaiki lagi karena masih sangat banyak masalah mulai dari unggah foto banner tapi bahkan lari ke foto profile masalah login dan lain sebagainya,24,25,"['tolong', 'di', 'perbaiki', 'lagi', 'karena', 'masih', 'sangat', 'banyak', 'masalah', 'mulai', 'dari', 'unggah', 'foto', 'banner', 'tapi', 'bahkan', 'lari', 'ke', 'foto', 'profile', 'masalah', 'login', 'dan', 'lain', 'sebagainya']","['tolong', 'perbaiki', 'unggah', 'foto', 'banner', 'lari', 'foto', 'profile', 'login']",25,9,16,tolong baik unggah foto banner lari foto profile login,9,9
Sangat membantu untuk mendapatkan pekerjaan,positif,2024-04-24,2024,sangat membantu untuk mendapatkan pekerjaan,5,5,sangat membantu untuk mendapatkan pekerjaan,5,5,"['sangat', 'membantu', 'untuk', 'mendapatkan', 'pekerjaan']","['membantu', 'pekerjaan']",5,2,3,bantu kerja,2,2
Aplikasi ngerjain orang doang masa tembak gambar untuk masuk udah bener tetep aja disalahin tolonglah kalau buat aplikasi yg mudah buat masuknya.!!,negatif,2022-06-02,2022,aplikasi ngerjain orang doang masa tembak gambar untuk masuk udah bener tetep aja disalahin tolonglah kalau buat aplikasi yg mudah buat masuknya,22,22,aplikasi ngerjain orang saja masa tembak gambar untuk masuk sudah benar tetap saja disalahin tolonglah kalau buat aplikasi yang mudah buat masuknya,22,22,"['aplikasi', 'ngerjain', 'orang', 'saja', 'masa', 'tembak', 'gambar', 'untuk', 'masuk', 'sudah', 'benar', 'tetap', 'saja', 'disalahin', 'tolonglah', 'kalau', 'buat', 'aplikasi', 'yang', 'mudah', 'buat', 'masuknya']","['aplikasi', 'ngerjain', 'orang', 'tembak', 'gambar', 'masuk', 'disalahin', 'tolonglah', 'aplikasi', 'mudah', 'masuknya']",22,11,11,aplikasi ngerjain orang tembak gambar masuk disalahin tolong aplikasi mudah masuk,11,11
Ngelamar nya gimana sih klo make aplikasi ni padahal saya udh daftar aplikasi ini tidk ada bacaan melamar pekerjaan klo bisa lowongan kerja nya buat tamatan SMK yg usia nya udh engga muda lagi,negatif,2022-05-23,2022,ngelamar nya gimana sih klo make aplikasi ni padahal saya udh daftar aplikasi ini tidk ada bacaan melamar pekerjaan klo bisa lowongan kerja nya buat tamatan smk yg usia nya udh engga muda lagi,34,34,ngelamar nya bagaimana sih kalau make aplikasi ini padahal saya sudah daftar aplikasi ini tidk ada bacaan melamar pekerjaan kalau bisa lowongan kerja nya buat tamatan smk yang usia nya sudah tidak muda lagi,34,34,"['ngelamar', 'nya', 'bagaimana', 'sih', 'kalau', 'make', 'aplikasi', 'ini', 'padahal', 'saya', 'sudah', 'daftar', 'aplikasi', 'ini', 'tidk', 'ada', 'bacaan', 'melamar', 'pekerjaan', 'kalau', 'bisa', 'lowongan', 'kerja', 'nya', 'buat', 'tamatan', 'smk', 'yang', 'usia', 'nya', 'sudah', 'tidak', 'muda', 'lagi']","['ngelamar', 'nya', 'sih', 'make', 'aplikasi', 'daftar', 'aplikasi', 'tidk', 'bacaan', 'melamar', 'pekerjaan', 'lowongan', 'kerja', 'nya', 'tamatan', 'smk', 'usia', 'nya', 'tidak', 'muda']",34,20,14,ngelamar nya sih make aplikasi daftar aplikasi tidk baca lamar kerja lowong kerja nya tamat smk usia nya tidak muda,20,20
"Ga bisa di buka dan sangat ribet ,ngeri saldo ke sedot di dana.",negatif,2024-08-22,2024,ga bisa di buka dan sangat ribet ngeri saldo ke sedot di dana,13,13,tidak bisa di buka dan sangat rumit mengerikan saldo ke sedot di dana,13,13,"['tidak', 'bisa', 'di', 'buka', 'dan', 'sangat', 'rumit', 'mengerikan', 'saldo', 'ke', 'sedot', 'di', 'dana']","['tidak', 'buka', 'rumit', 'mengerikan', 'saldo', 'sedot', 'dana']",13,7,6,tidak buka rumit keri saldo sedot dana,7,7
"Belum ada panggilan masuk jg sampai saat ini,sudah bnyk melamar pekerjaan di aplikasi ini satu pun blm ada hasil ny🤦🏻‍♂️🤦🏻‍♂️. kebanyakan PT penipuan di sini",negatif,2023-12-21,2023,belum ada panggilan masuk jg sampai saat ini sudah bnyk melamar pekerjaan di aplikasi ini satu pun blm ada hasil ny‍‍ kebanyakan pt penipuan di sini,25,26,belum ada panggilan masuk juga sampai saat ini sudah banyak melamar pekerjaan di aplikasi ini satu pun belum ada hasil ny‍‍ kebanyakan perseroan terbatas penipuan di sini,26,27,"['belum', 'ada', 'panggilan', 'masuk', 'juga', 'sampai', 'saat', 'ini', 'sudah', 'banyak', 'melamar', 'pekerjaan', 'di', 'aplikasi', 'ini', 'satu', 'pun', 'belum', 'ada', 'hasil', 'ny\u200d\u200d', 'kebanyakan', 'perseroan', 'terbatas', 'penipuan', 'di', 'sini']","['panggilan', 'masuk', 'melamar', 'pekerjaan', 'aplikasi', 'hasil', 'ny\u200d\u200d', 'kebanyakan', 'perseroan', 'terbatas', 'penipuan']",27,11,16,panggil masuk lamar kerja aplikasi hasil ny banyak persero batas tipu,11,11
"Bikin akun ga bisa bisa payah, susahnya minta ampun aplikasi eror Mulu. Padahal data yang dimasukkan benar",negatif,2023-05-14,2023,bikin akun ga bisa bisa payah susahnya minta ampun aplikasi eror mulu padahal data yang dimasukkan benar,17,17,bikin akun tidak bisa bisa payah susahnya minta ampun aplikasi error mulu padahal data yang dimasukkan benar,17,17,"['bikin', 'akun', 'tidak', 'bisa', 'bisa', 'payah', 'susahnya', 'minta', 'ampun', 'aplikasi', 'error', 'mulu', 'padahal', 'data', 'yang', 'dimasukkan', 'benar']","['bikin', 'akun', 'tidak', 'payah', 'susahnya', 'ampun', 'aplikasi', 'error', 'mulu', 'data', 'dimasukkan']",17,11,6,bikin akun tidak payah susah ampun aplikasi error mulu data masuk,11,11
Aplikasi yg sangat buruk. Tiada angin tiada hujan tiba2 gak bs masuk ke akun. Kl gak bisa bikin management pelayanan yg baik mending tutup aja apk ini!!!!,negatif,2023-08-04,2023,aplikasi yg sangat buruk tiada angin tiada hujan tiba gak bs masuk ke akun kl gak bisa bikin management pelayanan yg baik mending tutup aja apk ini,27,27,aplikasi yang sangat buruk tiada angin tiada hujan tiba tidak bisa masuk ke akun kalau tidak bisa bikin management pelayanan yang baik mending tutup saja aplikasi ini,27,27,"['aplikasi', 'yang', 'sangat', 'buruk', 'tiada', 'angin', 'tiada', 'hujan', 'tiba', 'tidak', 'bisa', 'masuk', 'ke', 'akun', 'kalau', 'tidak', 'bisa', 'bikin', 'management', 'pelayanan', 'yang', 'baik', 'mending', 'tutup', 'saja', 'aplikasi', 'ini']","['aplikasi', 'buruk', 'tiada', 'angin', 'tiada', 'hujan', 'tidak', 'masuk', 'akun', 'tidak', 'bikin', 'management', 'pelayanan', 'mending', 'tutup', 'aplikasi']",27,16,11,aplikasi buruk tiada angin tiada hujan tidak masuk akun tidak bikin management layan mending tutup aplikasi,16,16
"Ini kenapa sih tiap mau login kagak bisa, udah ada bacaan verifikasi berhasil malah balik lagi ke awal.",negatif,2023-07-29,2023,ini kenapa sih tiap mau login kagak bisa udah ada bacaan verifikasi berhasil malah balik lagi ke awal,18,18,ini kenapa sih tiap mau login tidak bisa sudah ada bacaan verifikasi berhasil bahkan balik lagi ke awal,18,18,"['ini', 'kenapa', 'sih', 'tiap', 'mau', 'login', 'tidak', 'bisa', 'sudah', 'ada', 'bacaan', 'verifikasi', 'berhasil', 'bahkan', 'balik', 'lagi', 'ke', 'awal']","['sih', 'login', 'tidak', 'bacaan', 'verifikasi', 'berhasil']",18,6,12,sih login tidak baca verifikasi hasil,6,6
"Hayyyy,,saya tidak login dikarenakan captcha yang selalu error...mohon diperbaiki ini sangat mengganggu sekali",negatif,2024-02-08,2024,hayyyy saya tidak login dikarenakan captcha yang selalu error mohon diperbaiki ini sangat mengganggu sekali,13,15,hayyyy saya tidak login dikarenakan captcha yang selalu error mohon di perbaiki ini sangat mengganggu sekali,15,16,"['hayyyy', 'saya', 'tidak', 'login', 'dikarenakan', 'captcha', 'yang', 'selalu', 'error', 'mohon', 'di', 'perbaiki', 'ini', 'sangat', 'mengganggu', 'sekali']","['hayyyy', 'tidak', 'login', 'captcha', 'error', 'mohon', 'perbaiki', 'mengganggu']",16,8,8,hayyyy tidak login captcha error mohon baik ganggu,8,8
"Kacau ! Sekarang kirim personalisasi undangan terbatas hanya 10 kali per bulan. Hanya untuk mengirim personalisasi undangan saja harus berlangganan, padahal dulu bisa kirim berapa kali pun",negatif,2023-11-25,2023,kacau sekarang kirim personalisasi undangan terbatas hanya kali per bulan hanya untuk mengirim personalisasi undangan saja harus berlangganan padahal dulu bisa kirim berapa kali pun,27,25,kacau sekarang kirim personalisasi undangan terbatas hanya kali per bulan hanya untuk mengirim personalisasi undangan saja harus berlangganan padahal dahulu bisa kirim berapa kali pun,25,25,"['kacau', 'sekarang', 'kirim', 'personalisasi', 'undangan', 'terbatas', 'hanya', 'kali', 'per', 'bulan', 'hanya', 'untuk', 'mengirim', 'personalisasi', 'undangan', 'saja', 'harus', 'berlangganan', 'padahal', 'dahulu', 'bisa', 'kirim', 'berapa', 'kali', 'pun']","['kacau', 'kirim', 'personalisasi', 'undangan', 'terbatas', 'kali', 'mengirim', 'personalisasi', 'undangan', 'berlangganan', 'kirim', 'kali']",25,12,13,kacau kirim personal undang batas kali kirim personal undang langgan kirim kali,12,12
Sangat membantu utk smua orang baik utk pemula maupun yg berpengalaman untuk mencari dukungan maupun support atw pekerjan. Terima kasih LinkedIn.,positif,2021-01-28,2021,sangat membantu utk smua orang baik utk pemula maupun yg berpengalaman untuk mencari dukungan maupun support atw pekerjan terima kasih linkedin,21,21,sangat membantu untuk semua orang baik untuk pemula maupun yang berpengalaman untuk mencari dukungan maupun support atau pekerjan terima kasih linkedin,21,21,"['sangat', 'membantu', 'untuk', 'semua', 'orang', 'baik', 'untuk', 'pemula', 'maupun', 'yang', 'berpengalaman', 'untuk', 'mencari', 'dukungan', 'maupun', 'support', 'atau', 'pekerjan', 'terima', 'kasih', 'linkedin']","['membantu', 'orang', 'pemula', 'berpengalaman', 'mencari', 'dukungan', 'support', 'pekerjan', 'terima', 'kasih', 'linkedin']",21,11,10,bantu orang mula alam cari dukung support pekerjan terima kasih linkedin,11,11
"Hilang dengan cuma² uang 650k gara² kaga ada pemberitahuan tentang update premium berkelanjutan, tiba² saldo lenyap begitu saja tanpa ada konfirmasi",negatif,2022-12-16,2022,hilang dengan cuma² uang k gara² kaga ada pemberitahuan tentang update premium berkelanjutan tiba² saldo lenyap begitu saja tanpa ada konfirmasi,21,21,hilang dengan cuma² uang ke gara² tidak ada pemberitahuan tentang diperbarui premium berkelanjutan tiba² saldo lenyap begitu saja tanpa ada konfirmasi,21,21,"['hilang', 'dengan', 'cuma²', 'uang', 'ke', 'gara²', 'tidak', 'ada', 'pemberitahuan', 'tentang', 'diperbarui', 'premium', 'berkelanjutan', 'tiba²', 'saldo', 'lenyap', 'begitu', 'saja', 'tanpa', 'ada', 'konfirmasi']","['hilang', 'cuma²', 'uang', 'gara²', 'tidak', 'pemberitahuan', 'diperbarui', 'premium', 'berkelanjutan', 'tiba²', 'saldo', 'lenyap', 'konfirmasi']",21,13,8,hilang cuma uang gara tidak pemberitahuan baru premium lanjut tiba saldo lenyap konfirmasi,13,13
"Saya mau duit saya di balikin 1,1 jt di potong auto debit sedangkan saya tidak berlangganan",negatif,2024-04-12,2024,saya mau duit saya di balikin jt di potong auto debit sedangkan saya tidak berlangganan,16,15,saya mau uang saya di balikin jt di potong otomatis debit sedangkan saya tidak berlangganan,15,15,"['saya', 'mau', 'uang', 'saya', 'di', 'balikin', 'jt', 'di', 'potong', 'otomatis', 'debit', 'sedangkan', 'saya', 'tidak', 'berlangganan']","['uang', 'balikin', 'jt', 'potong', 'otomatis', 'debit', 'tidak', 'berlangganan']",15,8,7,uang balikin jt potong otomatis debit tidak langgan,8,8
"Aplikasi hape sedang error ya,saya hanya bisa buka via web komputer. Web dari hape juga sering error",negatif,2022-02-18,2022,aplikasi hape sedang error ya saya hanya bisa buka via web komputer web dari hape juga sering error,17,18,aplikasi hape sedang error ya saya hanya bisa buka melalui web komputer web dari hape juga sering error,18,18,"['aplikasi', 'hape', 'sedang', 'error', 'ya', 'saya', 'hanya', 'bisa', 'buka', 'melalui', 'web', 'komputer', 'web', 'dari', 'hape', 'juga', 'sering', 'error']","['aplikasi', 'hape', 'error', 'ya', 'buka', 'web', 'komputer', 'web', 'hape', 'error']",18,10,8,aplikasi hape error ya buka web komputer web hape error,10,10
"Aplikasi dan kontennya cukup terawat dari ""penyakit online"" iklan yg tidak terkontrol.",positif,2020-11-18,2020,aplikasi dan kontennya cukup terawat dari penyakit online iklan yg tidak terkontrol,12,12,aplikasi dan kontennya cukup terawat dari penyakit daring iklan yang tidak terkontrol,12,12,"['aplikasi', 'dan', 'kontennya', 'cukup', 'terawat', 'dari', 'penyakit', 'daring', 'iklan', 'yang', 'tidak', 'terkontrol']","['aplikasi', 'kontennya', 'terawat', 'penyakit', 'daring', 'iklan', 'tidak', 'terkontrol']",12,8,4,aplikasi konten awat sakit daring iklan tidak kontrol,8,8
"mampu mencari relasi,berbagi informasi dan saling berkomunikasi",positif,2024-07-25,2024,mampu mencari relasi berbagi informasi dan saling berkomunikasi,7,8,mampu mencari relasi berbagi informasi dan saling berkomunikasi,8,8,"['mampu', 'mencari', 'relasi', 'berbagi', 'informasi', 'dan', 'saling', 'berkomunikasi']","['mencari', 'relasi', 'berbagi', 'informasi', 'berkomunikasi']",8,5,3,cari relasi bagi informasi komunikasi,5,5
"Sangat bermanfaat untuk segala Bisnis dan Pertemanan dengan Top Leader dari berbagai Negara, saya sangat menyukai LinkendIn",positif,2021-06-25,2021,sangat bermanfaat untuk segala bisnis dan pertemanan dengan top leader dari berbagai negara saya sangat menyukai linkendin,17,17,sangat bermanfaat untuk segala bisnis dan pertemanan dengan top leader dari berbagai negara saya sangat menyukai linkendin,17,17,"['sangat', 'bermanfaat', 'untuk', 'segala', 'bisnis', 'dan', 'pertemanan', 'dengan', 'top', 'leader', 'dari', 'berbagai', 'negara', 'saya', 'sangat', 'menyukai', 'linkendin']","['bermanfaat', 'bisnis', 'pertemanan', 'top', 'leader', 'negara', 'menyukai', 'linkendin']",17,8,9,manfaat bisnis teman top leader negara suka linkendin,8,8
"Sangat buruk , di batasi akun saya dan saya coba masuk bbrp kali namun tidak berhasil , g ada alasan apapun bahkan jarang di gunakan , respon dari pusat bantuan g jelas ... Tidak d sarankan",negatif,2023-04-04,2023,sangat buruk di batasi akun saya dan saya coba masuk bbrp kali namun tidak berhasil g ada alasan apapun bahkan jarang di gunakan respon dari pusat bantuan g jelas tidak d sarankan,36,32,sangat buruk di batasi akun saya dan saya coba masuk beberapa kali namun tidak berhasil tidak ada alasan apapun bahkan jarang di gunakan respons dari pusat bantuan tidak jelas tidak di sarankan,32,32,"['sangat', 'buruk', 'di', 'batasi', 'akun', 'saya', 'dan', 'saya', 'coba', 'masuk', 'beberapa', 'kali', 'namun', 'tidak', 'berhasil', 'tidak', 'ada', 'alasan', 'apapun', 'bahkan', 'jarang', 'di', 'gunakan', 'respons', 'dari', 'pusat', 'bantuan', 'tidak', 'jelas', 'tidak', 'di', 'sarankan']","['buruk', 'batasi', 'akun', 'coba', 'masuk', 'kali', 'tidak', 'berhasil', 'tidak', 'alasan', 'apapun', 'jarang', 'respons', 'pusat', 'bantuan', 'tidak', 'tidak', 'sarankan']",32,18,14,buruk batas akun coba masuk kali tidak hasil tidak alas apa jarang respons pusat bantu tidak tidak saran,18,18
dih masa ga login bbrpa hari akun gw lgsg kena suspend. pdhl gw ga ada kesalahan atau apa krna baru bikin akun juga blm lama bbrpa minggu. dah lah males pake linkedin ribet,negatif,2022-01-16,2022,dih masa ga login bbrpa hari akun gw lgsg kena suspend pdhl gw ga ada kesalahan atau apa krna baru bikin akun juga blm lama bbrpa minggu dah lah males pake linkedin ribet,33,33,dih masa tidak login beberapa hari akun saya langsung kena suspend padahal saya tidak ada kesalahan atau apa karena baru bikin akun juga belum lama beberapa minggu sudah lah malas pakai linkedin rumit,33,33,"['dih', 'masa', 'tidak', 'login', 'beberapa', 'hari', 'akun', 'saya', 'langsung', 'kena', 'suspend', 'padahal', 'saya', 'tidak', 'ada', 'kesalahan', 'atau', 'apa', 'karena', 'baru', 'bikin', 'akun', 'juga', 'belum', 'lama', 'beberapa', 'minggu', 'sudah', 'lah', 'malas', 'pakai', 'linkedin', 'rumit']","['dih', 'tidak', 'login', 'akun', 'langsung', 'kena', 'suspend', 'tidak', 'kesalahan', 'bikin', 'akun', 'minggu', 'malas', 'pakai', 'linkedin', 'rumit']",33,16,17,dih tidak login akun langsung kena suspend tidak salah bikin akun minggu malas pakai linkedin rumit,16,16
Garagara verifikasi yang gamasuk akal jadi gabisa login. Ini sistem verifikasi nya tolong diperbaiki dan diberi kemudahan.,negatif,2024-02-12,2024,garagara verifikasi yang gamasuk akal jadi gabisa login ini sistem verifikasi nya tolong diperbaiki dan diberi kemudahan,17,17,garagara verifikasi yang gamasuk akal jadi tidak bisa login ini sistem verifikasi nya tolong di perbaiki dan diberi kemudahan,17,19,"['garagara', 'verifikasi', 'yang', 'gamasuk', 'akal', 'jadi', 'tidak', 'bisa', 'login', 'ini', 'sistem', 'verifikasi', 'nya', 'tolong', 'di', 'perbaiki', 'dan', 'diberi', 'kemudahan']","['garagara', 'verifikasi', 'gamasuk', 'akal', 'tidak', 'login', 'sistem', 'verifikasi', 'nya', 'tolong', 'perbaiki', 'kemudahan']",19,12,7,garagara verifikasi gamasuk akal tidak login sistem verifikasi nya tolong baik mudah,12,12
Terdapat informasi pekerjaan dan terhubung dengan rekan kerja maupun calon rekan kerja maupun sebatas mengenal. Aplikasinya sangat membantu.,positif,2022-08-10,2022,terdapat informasi pekerjaan dan terhubung dengan rekan kerja maupun calon rekan kerja maupun sebatas mengenal aplikasinya sangat membantu,18,18,terdapat informasi pekerjaan dan terhubung dengan rekan kerja maupun calon rekan kerja maupun sebatas mengenal aplikasi nya sangat membantu,18,19,"['terdapat', 'informasi', 'pekerjaan', 'dan', 'terhubung', 'dengan', 'rekan', 'kerja', 'maupun', 'calon', 'rekan', 'kerja', 'maupun', 'sebatas', 'mengenal', 'aplikasi', 'nya', 'sangat', 'membantu']","['informasi', 'pekerjaan', 'terhubung', 'rekan', 'kerja', 'calon', 'rekan', 'kerja', 'sebatas', 'mengenal', 'aplikasi', 'nya', 'membantu']",19,13,6,informasi kerja hubung rekan kerja calon rekan kerja batas kenal aplikasi nya bantu,13,13
"Verifikasi login nya apa gak bisa diganti sama yg lain? Mau login susahnya setengah mampus, gk berhasil2",negatif,2022-11-04,2022,verifikasi login nya apa gak bisa diganti sama yg lain mau login susahnya setengah mampus gk berhasil,17,17,verifikasi login nya apa tidak bisa diganti sama yang lain mau login susahnya setengah mampus tidak berhasil,17,17,"['verifikasi', 'login', 'nya', 'apa', 'tidak', 'bisa', 'diganti', 'sama', 'yang', 'lain', 'mau', 'login', 'susahnya', 'setengah', 'mampus', 'tidak', 'berhasil']","['verifikasi', 'login', 'nya', 'tidak', 'diganti', 'login', 'susahnya', 'mampus', 'tidak', 'berhasil']",17,10,7,verifikasi login nya tidak ganti login susah mampus tidak hasil,10,10
"Aplikasi babi, udah aku masukin semua ya buat kamar kerja, setiap udah kelar semua tinggal klik lamar selalu ga bisa, ada notif nya maaf terjadi kesalahan, taik",negatif,2021-05-01,2021,aplikasi babi udah aku masukin semua ya buat kamar kerja setiap udah kelar semua tinggal klik lamar selalu ga bisa ada notif nya maaf terjadi kesalahan taik,27,27,aplikasi babi sudah aku masukkan semua ya buat kamar kerja setiap sudah kelar semua tinggal klik lamar selalu tidak bisa ada notif nya maaf terjadi kesalahan taik,27,27,"['aplikasi', 'babi', 'sudah', 'aku', 'masukkan', 'semua', 'ya', 'buat', 'kamar', 'kerja', 'setiap', 'sudah', 'kelar', 'semua', 'tinggal', 'klik', 'lamar', 'selalu', 'tidak', 'bisa', 'ada', 'notif', 'nya', 'maaf', 'terjadi', 'kesalahan', 'taik']","['aplikasi', 'babi', 'masukkan', 'ya', 'kamar', 'kerja', 'kelar', 'tinggal', 'klik', 'lamar', 'tidak', 'notif', 'nya', 'maaf', 'kesalahan', 'taik']",27,16,11,aplikasi babi masuk ya kamar kerja kelar tinggal klik lamar tidak notif nya maaf salah taik,16,16
Setelah diupdate kenapa malah tdk bsa mengubah profil dan mengisi pengalaman kerja?? Semoga segera bisa diperbaiki.,negatif,2020-12-14,2020,setelah diupdate kenapa malah tdk bsa mengubah profil dan mengisi pengalaman kerja semoga segera bisa diperbaiki,16,16,setelah di perbarui kenapa bahkan tidak bisa mengubah profil dan mengisi pengalaman kerja semoga segera bisa di perbaiki,16,18,"['setelah', 'di', 'perbarui', 'kenapa', 'bahkan', 'tidak', 'bisa', 'mengubah', 'profil', 'dan', 'mengisi', 'pengalaman', 'kerja', 'semoga', 'segera', 'bisa', 'di', 'perbaiki']","['perbarui', 'tidak', 'mengubah', 'profil', 'mengisi', 'pengalaman', 'kerja', 'semoga', 'perbaiki']",18,9,9,baru tidak ubah profil isi alam kerja moga baik,9,9
"LinkedIn. Sudah sangat bagus, mohon ditingkatkan lagi untuk fitur-fitur menariknya 🤏👍.",positif,2021-08-31,2021,linkedin sudah sangat bagus mohon ditingkatkan lagi untuk fitur fitur menariknya,11,11,linkedin sudah sangat bagus mohon ditingkatkan lagi untuk fitur fitur menariknya,11,11,"['linkedin', 'sudah', 'sangat', 'bagus', 'mohon', 'ditingkatkan', 'lagi', 'untuk', 'fitur', 'fitur', 'menariknya']","['linkedin', 'bagus', 'mohon', 'ditingkatkan', 'fitur', 'fitur', 'menariknya']",11,7,4,linkedin bagus mohon tingkat fitur fitur tarik,7,7
"Abis donload disuruh verifikasi memastikan bukan robot dsruh milih gambar yg menghadap ke atas , susah bedainya!!! Bingung nyari yg menghadap ke atas gmna org palanya sama semua!!! tolong dong verifikasi cara laen!",negatif,2021-07-31,2021,abis donload disuruh verifikasi memastikan bukan robot dsruh milih gambar yg menghadap ke atas susah bedainya bingung nyari yg menghadap ke atas gmna org palanya sama semua tolong dong verifikasi cara laen,33,32,habis donload disuruh verifikasi memastikan bukan robot dsruh memilih gambar yang menghadap ke atas susah bedainya bingung mencari yang menghadap ke atas bagaimana orang palanya sama semua tolong dong verifikasi cara lain,32,32,"['habis', 'donload', 'disuruh', 'verifikasi', 'memastikan', 'bukan', 'robot', 'dsruh', 'memilih', 'gambar', 'yang', 'menghadap', 'ke', 'atas', 'susah', 'bedainya', 'bingung', 'mencari', 'yang', 'menghadap', 'ke', 'atas', 'bagaimana', 'orang', 'palanya', 'sama', 'semua', 'tolong', 'dong', 'verifikasi', 'cara', 'lain']","['habis', 'donload', 'disuruh', 'verifikasi', 'robot', 'dsruh', 'memilih', 'gambar', 'menghadap', 'susah', 'bedainya', 'bingung', 'mencari', 'menghadap', 'orang', 'palanya', 'tolong', 'verifikasi']",32,18,14,habis donload suruh verifikasi robot dsruh pilih gambar hadap susah beda bingung cari hadap orang pala tolong verifikasi,18,18
"Untuk Developer LinkedIn. LinkedIn Sangat Bermanfaat, Terus Tingkatkan Fitur Dan Kualitas Di Dalam Aplikasi.",positif,2023-06-04,2023,untuk developer linkedin linkedin sangat bermanfaat terus tingkatkan fitur dan kualitas di dalam aplikasi,14,14,untuk developer linkedin linkedin sangat bermanfaat terus tingkatkan fitur dan kualitas di dalam aplikasi,14,14,"['untuk', 'developer', 'linkedin', 'linkedin', 'sangat', 'bermanfaat', 'terus', 'tingkatkan', 'fitur', 'dan', 'kualitas', 'di', 'dalam', 'aplikasi']","['developer', 'linkedin', 'linkedin', 'bermanfaat', 'tingkatkan', 'fitur', 'kualitas', 'aplikasi']",14,8,6,developer linkedin linkedin manfaat tingkat fitur kualitas aplikasi,8,8
"Tidak niat buat aplikasi sudah download dan daftar verifikasinya tidak jelas, sudah dijawab benar tapi salah terus, kalau tidak bisa tolong jangan buat aplikasi...",negatif,2021-09-21,2021,tidak niat buat aplikasi sudah download dan daftar verifikasinya tidak jelas sudah dijawab benar tapi salah terus kalau tidak bisa tolong jangan buat aplikasi,24,24,tidak niat buat aplikasi sudah unduh dan daftar verifikasinya tidak jelas sudah dijawab benar tapi salah terus kalau tidak bisa tolong jangan buat aplikasi,24,24,"['tidak', 'niat', 'buat', 'aplikasi', 'sudah', 'unduh', 'dan', 'daftar', 'verifikasinya', 'tidak', 'jelas', 'sudah', 'dijawab', 'benar', 'tapi', 'salah', 'terus', 'kalau', 'tidak', 'bisa', 'tolong', 'jangan', 'buat', 'aplikasi']","['tidak', 'niat', 'aplikasi', 'unduh', 'daftar', 'verifikasinya', 'tidak', 'salah', 'tidak', 'tolong', 'aplikasi']",24,11,13,tidak niat aplikasi unduh daftar verifikasi tidak salah tidak tolong aplikasi,11,11
"Gak bisa dibuka, suruh verifikasi dengan menyentuh gambar yang menghadap atas dengan benar, dan gambarnya kurang jelas",negatif,2021-01-07,2021,gak bisa dibuka suruh verifikasi dengan menyentuh gambar yang menghadap atas dengan benar dan gambarnya kurang jelas,17,17,tidak bisa dibuka suruh verifikasi dengan menyentuh gambar yang menghadap atas dengan benar dan gambarnya kurang jelas,17,17,"['tidak', 'bisa', 'dibuka', 'suruh', 'verifikasi', 'dengan', 'menyentuh', 'gambar', 'yang', 'menghadap', 'atas', 'dengan', 'benar', 'dan', 'gambarnya', 'kurang', 'jelas']","['tidak', 'dibuka', 'suruh', 'verifikasi', 'menyentuh', 'gambar', 'menghadap', 'gambarnya']",17,8,9,tidak buka suruh verifikasi sentuh gambar hadap gambar,8,8
"Aplikasi paling bagus, simple, relevan dalam mencari pekerjaan, tidak bertele2 seperti aplikasi jobseeker yg lain",positif,2022-02-19,2022,aplikasi paling bagus simple relevan dalam mencari pekerjaan tidak bertele seperti aplikasi jobseeker yg lain,15,15,aplikasi paling bagus simpel relevan dalam mencari pekerjaan tidak bertele seperti aplikasi jobseeker yang lain,15,15,"['aplikasi', 'paling', 'bagus', 'simpel', 'relevan', 'dalam', 'mencari', 'pekerjaan', 'tidak', 'bertele', 'seperti', 'aplikasi', 'jobseeker', 'yang', 'lain']","['aplikasi', 'bagus', 'simpel', 'relevan', 'mencari', 'pekerjaan', 'tidak', 'bertele', 'aplikasi', 'jobseeker']",15,10,5,aplikasi bagus simpel relevan cari kerja tidak tele aplikasi jobseeker,10,10
Akun saya di nonaktivkan padahal awalnya biasa² sj. Stlah tdk buka 2 hari pas mau login lagi kok nonaktif. Ini gimana sih,negatif,2020-05-02,2020,akun saya di nonaktivkan padahal awalnya biasa² sj stlah tdk buka hari pas mau login lagi kok nonaktif ini gimana sih,22,21,akun saya di nonaktivkan padahal awalnya biasa² sj stlah tidak buka hari pas mau login lagi kok nonaktif ini bagaimana sih,21,21,"['akun', 'saya', 'di', 'nonaktivkan', 'padahal', 'awalnya', 'biasa²', 'sj', 'stlah', 'tidak', 'buka', 'hari', 'pas', 'mau', 'login', 'lagi', 'kok', 'nonaktif', 'ini', 'bagaimana', 'sih']","['akun', 'nonaktivkan', 'biasa²', 'sj', 'stlah', 'tidak', 'buka', 'pas', 'login', 'nonaktif', 'sih']",21,11,10,akun nonaktivkan biasa sj stlah tidak buka pas login nonaktif sih,11,11
"Linkedln mengembangkan,PRYEKSI dari berbagai fitur kesuksesan dalam meraih cita-dan cinta yang di idam-idamkan apllikasi bagusnya, paling bagus aku suka banget!!!!!!",positif,2022-05-04,2022,linkedln mengembangkan pryeksi dari berbagai fitur kesuksesan dalam meraih cita dan cinta yang di idam idamkan apllikasi bagusnya paling bagus aku suka banget,20,23,linkedln mengembangkan pryeksi dari berbagai fitur kesuksesan dalam meraih cita dan cinta yang di idam idamkan apllikasi bagusnya paling bagus aku suka banget,23,23,"['linkedln', 'mengembangkan', 'pryeksi', 'dari', 'berbagai', 'fitur', 'kesuksesan', 'dalam', 'meraih', 'cita', 'dan', 'cinta', 'yang', 'di', 'idam', 'idamkan', 'apllikasi', 'bagusnya', 'paling', 'bagus', 'aku', 'suka', 'banget']","['linkedln', 'mengembangkan', 'pryeksi', 'fitur', 'kesuksesan', 'meraih', 'cita', 'cinta', 'idam', 'idamkan', 'apllikasi', 'bagusnya', 'bagus', 'suka', 'banget']",23,15,8,linkedln kembang pryeksi fitur sukses raih cita cinta idam idam apllikasi bagus bagus suka banget,15,15
"Aplikasi bobr*""*k!! Verifikasi di awal aja kyk anak TK, gak pernah bisa lolos. Udah maen puzzle nya ampek ratusan kali gak lolos!! Sinting lu!!",negatif,2022-03-06,2022,aplikasi bobr k verifikasi di awal aja kyk anak tk gak pernah bisa lolos udah maen puzzle nya ampek ratusan kali gak lolos sinting lu,24,25,aplikasi bobr ke verifikasi di awal saja seperti anak tk tidak pernah bisa lolos sudah maen puzzle nya ampek ratusan kali tidak lolos sinting lu,25,25,"['aplikasi', 'bobr', 'ke', 'verifikasi', 'di', 'awal', 'saja', 'seperti', 'anak', 'tk', 'tidak', 'pernah', 'bisa', 'lolos', 'sudah', 'maen', 'puzzle', 'nya', 'ampek', 'ratusan', 'kali', 'tidak', 'lolos', 'sinting', 'lu']","['aplikasi', 'bobr', 'verifikasi', 'anak', 'tk', 'tidak', 'lolos', 'maen', 'puzzle', 'nya', 'ampek', 'ratusan', 'kali', 'tidak', 'lolos', 'sinting', 'lu']",25,17,8,aplikasi bobr verifikasi anak tk tidak lolos maen puzzle nya ampek ratus kali tidak lolos sinting lu,17,17
"Aplikasi ga jelas tiba-tiba main suspend, sudah verifikasi sudah dapat 6 hari tidak ada balasan buat buka lagi akunnya",negatif,2023-08-23,2023,aplikasi ga jelas tiba tiba main suspend sudah verifikasi sudah dapat hari tidak ada balasan buat buka lagi akunnya,19,19,aplikasi tidak jelas tiba tiba main suspend sudah verifikasi sudah dapat hari tidak ada balasan buat buka lagi akunnya,19,19,"['aplikasi', 'tidak', 'jelas', 'tiba', 'tiba', 'main', 'suspend', 'sudah', 'verifikasi', 'sudah', 'dapat', 'hari', 'tidak', 'ada', 'balasan', 'buat', 'buka', 'lagi', 'akunnya']","['aplikasi', 'tidak', 'main', 'suspend', 'verifikasi', 'tidak', 'balasan', 'buka', 'akunnya']",19,9,10,aplikasi tidak main suspend verifikasi tidak balas buka akun,9,9
Ini kenapa verifikasi gak bisa² yah. Untuk klik gambar padahal sya sudah benar 4x yg ke 5 selalu salah pdahal perintah gmbarny masih sama.,negatif,2022-12-30,2022,ini kenapa verifikasi gak bisa² yah untuk klik gambar padahal sya sudah benar x yg ke selalu salah pdahal perintah gmbarny masih sama,24,23,ini kenapa verifikasi tidak bisa² ya untuk klik gambar padahal saya sudah benar x yang ke selalu salah pdahal perintah gmbarny masih sama,23,23,"['ini', 'kenapa', 'verifikasi', 'tidak', 'bisa²', 'ya', 'untuk', 'klik', 'gambar', 'padahal', 'saya', 'sudah', 'benar', 'x', 'yang', 'ke', 'selalu', 'salah', 'pdahal', 'perintah', 'gmbarny', 'masih', 'sama']","['verifikasi', 'tidak', 'bisa²', 'ya', 'klik', 'gambar', 'x', 'salah', 'pdahal', 'perintah', 'gmbarny']",23,11,12,verifikasi tidak bisa ya klik gambar x salah pdahal perintah gmbarny,11,11
"Kenapa susah login, padahal sebelum nya baik baik saja, dan pada saat buka aplikasi dan login langsung close sendiri aplikasi nya",negatif,2024-01-31,2024,kenapa susah login padahal sebelum nya baik baik saja dan pada saat buka aplikasi dan login langsung close sendiri aplikasi nya,21,21,kenapa susah login padahal sebelum nya baik baik saja dan pada saat buka aplikasi dan login langsung close sendiri aplikasi nya,21,21,"['kenapa', 'susah', 'login', 'padahal', 'sebelum', 'nya', 'baik', 'baik', 'saja', 'dan', 'pada', 'saat', 'buka', 'aplikasi', 'dan', 'login', 'langsung', 'close', 'sendiri', 'aplikasi', 'nya']","['susah', 'login', 'nya', 'buka', 'aplikasi', 'login', 'langsung', 'close', 'aplikasi', 'nya']",21,10,11,susah login nya buka aplikasi login langsung close aplikasi nya,10,10
"Mau login aja gabisa di bilang bukan manusia, disuruh klik gambar menghadap keatas salah mulu, ini app yang buta gabisa bedain mana atas",negatif,2022-09-26,2022,mau login aja gabisa di bilang bukan manusia disuruh klik gambar menghadap keatas salah mulu ini app yang buta gabisa bedain mana atas,23,23,mau login saja tidak bisa di bilang bukan manusia disuruh klik gambar menghadap keatas salah mulu ini aplikasi yang buta tidak bisa bedain mana atas,23,25,"['mau', 'login', 'saja', 'tidak', 'bisa', 'di', 'bilang', 'bukan', 'manusia', 'disuruh', 'klik', 'gambar', 'menghadap', 'keatas', 'salah', 'mulu', 'ini', 'aplikasi', 'yang', 'buta', 'tidak', 'bisa', 'bedain', 'mana', 'atas']","['login', 'tidak', 'bilang', 'manusia', 'disuruh', 'klik', 'gambar', 'menghadap', 'keatas', 'salah', 'mulu', 'aplikasi', 'buta', 'tidak', 'bedain']",25,15,10,login tidak bilang manusia suruh klik gambar hadap atas salah mulu aplikasi buta tidak bedain,15,15
kenapa verivikasinya sudah sekali. drai gambar kodok sampai banteng gak ada yg bener. udah di pilih sesuai juga.,negatif,2021-10-16,2021,kenapa verivikasinya sudah sekali drai gambar kodok sampai banteng gak ada yg bener udah di pilih sesuai juga,18,18,kenapa verivikasinya sudah sekali drai gambar kodok sampai banteng tidak ada yang benar sudah di pilih sesuai juga,18,18,"['kenapa', 'verivikasinya', 'sudah', 'sekali', 'drai', 'gambar', 'kodok', 'sampai', 'banteng', 'tidak', 'ada', 'yang', 'benar', 'sudah', 'di', 'pilih', 'sesuai', 'juga']","['verivikasinya', 'drai', 'gambar', 'kodok', 'banteng', 'tidak', 'pilih', 'sesuai']",18,8,10,verivikasinya drai gambar kodok banteng tidak pilih sesuai,8,8
"Aplikasi aneh, gabisa login padahal verifikasi udah bener tp masih tetep gabisa login dan verifikasi terus",negatif,2023-08-01,2023,aplikasi aneh gabisa login padahal verifikasi udah bener tp masih tetep gabisa login dan verifikasi terus,16,16,aplikasi aneh tidak bisa login padahal verifikasi sudah benar tapi masih tetap tidak bisa login dan verifikasi terus,16,18,"['aplikasi', 'aneh', 'tidak', 'bisa', 'login', 'padahal', 'verifikasi', 'sudah', 'benar', 'tapi', 'masih', 'tetap', 'tidak', 'bisa', 'login', 'dan', 'verifikasi', 'terus']","['aplikasi', 'aneh', 'tidak', 'login', 'verifikasi', 'tidak', 'login', 'verifikasi']",18,8,10,aplikasi aneh tidak login verifikasi tidak login verifikasi,8,8
Membantu buat yang pengen punya koneksi juga bidang pekerjaan. Tapi saat ini belom terlalu ngerti cara pakainya. Semoga suatu saat aplikasi ini berguna yaaa😊,positif,2020-11-03,2020,membantu buat yang pengen punya koneksi juga bidang pekerjaan tapi saat ini belom terlalu ngerti cara pakainya semoga suatu saat aplikasi ini berguna yaaa,24,24,membantu buat yang pengen punya koneksi juga bidang pekerjaan tapi saat ini belum terlalu mengerti cara pakainya semoga suatu saat aplikasi ini berguna yaaa,24,24,"['membantu', 'buat', 'yang', 'pengen', 'punya', 'koneksi', 'juga', 'bidang', 'pekerjaan', 'tapi', 'saat', 'ini', 'belum', 'terlalu', 'mengerti', 'cara', 'pakainya', 'semoga', 'suatu', 'saat', 'aplikasi', 'ini', 'berguna', 'yaaa']","['membantu', 'pengen', 'koneksi', 'bidang', 'pekerjaan', 'mengerti', 'pakainya', 'semoga', 'aplikasi', 'berguna', 'yaaa']",24,11,13,bantu ken koneksi bidang kerja erti pakai moga aplikasi guna yaaa,11,11
"Hallo team dev, untuk bagian verifikasi nya mungkin bisa dirubah menggunakan reCAPTCHA. Karena langkah verifikasi yang saat ini digunakan kurang bisa dipahami manusia normal, Hatur nuhun.",negatif,2022-02-11,2022,hallo team dev untuk bagian verifikasi nya mungkin bisa dirubah menggunakan recaptcha karena langkah verifikasi yang saat ini digunakan kurang bisa dipahami manusia normal hatur nuhun,26,26,halo team dev untuk bagian verifikasi nya mungkin bisa dirubah menggunakan recaptcha karena langkah verifikasi yang saat ini digunakan kurang bisa dipahami manusia normal hatur nuhun,26,26,"['halo', 'team', 'dev', 'untuk', 'bagian', 'verifikasi', 'nya', 'mungkin', 'bisa', 'dirubah', 'menggunakan', 'recaptcha', 'karena', 'langkah', 'verifikasi', 'yang', 'saat', 'ini', 'digunakan', 'kurang', 'bisa', 'dipahami', 'manusia', 'normal', 'hatur', 'nuhun']","['halo', 'team', 'dev', 'verifikasi', 'nya', 'dirubah', 'recaptcha', 'langkah', 'verifikasi', 'dipahami', 'manusia', 'normal', 'hatur', 'nuhun']",26,14,12,halo team dev verifikasi nya rubah recaptcha langkah verifikasi paham manusia normal hatur nuhun,14,14
Aplikasi rusaakk. Ketika login harus verify. Padahal sudah verif dengan benar. Tp tetap tidak bisa.,negatif,2023-08-03,2023,aplikasi rusaakk ketika login harus verify padahal sudah verif dengan benar tp tetap tidak bisa,15,15,aplikasi rusaakk ketika login harus verify padahal sudah verif dengan benar tapi tetap tidak bisa,15,15,"['aplikasi', 'rusaakk', 'ketika', 'login', 'harus', 'verify', 'padahal', 'sudah', 'verif', 'dengan', 'benar', 'tapi', 'tetap', 'tidak', 'bisa']","['aplikasi', 'rusaakk', 'login', 'verify', 'verif', 'tidak']",15,6,9,aplikasi rusaakk login verify verif tidak,6,6
Cukup baik dan membantu untuk menemukan informasih terhadap pencari kerja tetapi mohon jangan terlalu banyak persoalan untuk menyulitkan,negatif,2022-06-08,2022,cukup baik dan membantu untuk menemukan informasih terhadap pencari kerja tetapi mohon jangan terlalu banyak persoalan untuk menyulitkan,18,18,cukup baik dan membantu untuk menemukan informasih terhadap pencari kerja tetapi mohon jangan terlalu banyak persoalan untuk menyulitkan,18,18,"['cukup', 'baik', 'dan', 'membantu', 'untuk', 'menemukan', 'informasih', 'terhadap', 'pencari', 'kerja', 'tetapi', 'mohon', 'jangan', 'terlalu', 'banyak', 'persoalan', 'untuk', 'menyulitkan']","['membantu', 'menemukan', 'informasih', 'pencari', 'kerja', 'mohon', 'menyulitkan']",18,7,11,bantu temu informasih cari kerja mohon sulit,7,7
"Upload postingan gagal terus, cari koneksi / komunikasi dg pengguna linkedin agar terhubung, gagal total, perbaiki spy cepat respon",negatif,2020-09-09,2020,upload postingan gagal terus cari koneksi komunikasi dg pengguna linkedin agar terhubung gagal total perbaiki spy cepat respon,19,18,unggah postingan gagal terus cari koneksi komunikasi dengan pengguna linkedin agar terhubung gagal total perbaikan supaya cepat respons,18,18,"['unggah', 'postingan', 'gagal', 'terus', 'cari', 'koneksi', 'komunikasi', 'dengan', 'pengguna', 'linkedin', 'agar', 'terhubung', 'gagal', 'total', 'perbaikan', 'supaya', 'cepat', 'respons']","['unggah', 'postingan', 'gagal', 'cari', 'koneksi', 'komunikasi', 'pengguna', 'linkedin', 'terhubung', 'gagal', 'total', 'perbaikan', 'cepat', 'respons']",18,14,4,unggah postingan gagal cari koneksi komunikasi guna linkedin hubung gagal total baik cepat respons,14,14
"Aplikasinya sangat bermanfaat, memperbanyak koneksi dan mempermudah pencarian kerja. 😊",positif,2022-04-01,2022,aplikasinya sangat bermanfaat memperbanyak koneksi dan mempermudah pencarian kerja,10,9,aplikasi nya sangat bermanfaat memperbanyak koneksi dan mempermudah pencarian kerja,9,10,"['aplikasi', 'nya', 'sangat', 'bermanfaat', 'memperbanyak', 'koneksi', 'dan', 'mempermudah', 'pencarian', 'kerja']","['aplikasi', 'nya', 'bermanfaat', 'memperbanyak', 'koneksi', 'mempermudah', 'pencarian', 'kerja']",10,8,2,aplikasi nya manfaat banyak koneksi mudah cari kerja,8,8
"Parah ini aplikasi nya Sudah berkali-kali coba untuk nebak verifikasi gambar, salah mulu di akhir. Baru kali ini ketemu aplikasi macam gini. Auto unfollow aja.",negatif,2022-05-04,2022,parah ini aplikasi nya sudah berkali kali coba untuk nebak verifikasi gambar salah mulu di akhir baru kali ini ketemu aplikasi macam gini auto unfollow aja,25,26,parah ini aplikasi nya sudah berkali kali coba untuk nebak verifikasi gambar salah mulu di akhir baru kali ini ketemu aplikasi macam begini otomatis unfollow saja,26,26,"['parah', 'ini', 'aplikasi', 'nya', 'sudah', 'berkali', 'kali', 'coba', 'untuk', 'nebak', 'verifikasi', 'gambar', 'salah', 'mulu', 'di', 'akhir', 'baru', 'kali', 'ini', 'ketemu', 'aplikasi', 'macam', 'begini', 'otomatis', 'unfollow', 'saja']","['parah', 'aplikasi', 'nya', 'berkali', 'kali', 'coba', 'nebak', 'verifikasi', 'gambar', 'salah', 'mulu', 'kali', 'ketemu', 'aplikasi', 'otomatis', 'unfollow']",26,16,10,parah aplikasi nya kali kali coba nebak verifikasi gambar salah mulu kali ketemu aplikasi otomatis unfollow,16,16
"aplikasinya jelek , uda masuk email tapi berkali kali suruh masuk lagi dan pake email yang sama ternyata gak bisa 😑",negatif,2020-06-02,2020,aplikasinya jelek uda masuk email tapi berkali kali suruh masuk lagi dan pake email yang sama ternyata gak bisa,21,19,aplikasi nya jelek sudah masuk email tapi berkali kali suruh masuk lagi dan pakai email yang sama ternyata tidak bisa,19,20,"['aplikasi', 'nya', 'jelek', 'sudah', 'masuk', 'email', 'tapi', 'berkali', 'kali', 'suruh', 'masuk', 'lagi', 'dan', 'pakai', 'email', 'yang', 'sama', 'ternyata', 'tidak', 'bisa']","['aplikasi', 'nya', 'jelek', 'masuk', 'email', 'berkali', 'kali', 'suruh', 'masuk', 'pakai', 'email', 'tidak']",20,12,8,aplikasi nya jelek masuk email kali kali suruh masuk pakai email tidak,12,12
"Tolong perbaiki, kadang cape update data doang, berkali kali di coba tetep gak ada perubahan gt gt aja",negatif,2023-11-09,2023,tolong perbaiki kadang cape update data doang berkali kali di coba tetep gak ada perubahan gt gt aja,18,18,tolong perbaikan kadang capek diperbarui data saja berkali kali di coba tetap tidak ada perubahan begitu begitu saja,18,18,"['tolong', 'perbaikan', 'kadang', 'capek', 'diperbarui', 'data', 'saja', 'berkali', 'kali', 'di', 'coba', 'tetap', 'tidak', 'ada', 'perubahan', 'begitu', 'begitu', 'saja']","['tolong', 'perbaikan', 'kadang', 'capek', 'diperbarui', 'data', 'berkali', 'kali', 'coba', 'tidak', 'perubahan']",18,11,7,tolong baik kadang capek baru data kali kali coba tidak ubah,11,11
Gak ngotak ngatik apa apa...tiba tiba suruh login lagi...pas sudah dimasukkan password nya dibilang salah....padahal sudah betul password nya,negatif,2023-08-16,2023,gak ngotak ngatik apa apa tiba tiba suruh login lagi pas sudah dimasukkan password nya dibilang salah padahal sudah betul password nya,19,22,tidak ngotak ngatik apa apa tiba tiba suruh login lagi pas sudah dimasukkan password nya dibilang salah padahal sudah betul password nya,22,22,"['tidak', 'ngotak', 'ngatik', 'apa', 'apa', 'tiba', 'tiba', 'suruh', 'login', 'lagi', 'pas', 'sudah', 'dimasukkan', 'password', 'nya', 'dibilang', 'salah', 'padahal', 'sudah', 'betul', 'password', 'nya']","['tidak', 'ngotak', 'ngatik', 'suruh', 'login', 'pas', 'dimasukkan', 'password', 'nya', 'dibilang', 'salah', 'password', 'nya']",22,13,9,tidak ngotak ngatik suruh login pas masuk password nya bilang salah password nya,13,13
"Tolong diperbaiki pada bagian verifikasi. Sudah 2 hari verifikasi menggunakan ""gambar kodok"", selalu salah. Padahal saya sudah memilih kodok yang menghadap atas dengan benar. Terima kasih.",negatif,2021-03-17,2021,tolong diperbaiki pada bagian verifikasi sudah hari verifikasi menggunakan gambar kodok selalu salah padahal saya sudah memilih kodok yang menghadap atas dengan benar terima kasih,26,25,tolong di perbaiki pada bagian verifikasi sudah hari verifikasi menggunakan gambar kodok selalu salah padahal saya sudah memilih kodok yang menghadap atas dengan benar terima kasih,25,26,"['tolong', 'di', 'perbaiki', 'pada', 'bagian', 'verifikasi', 'sudah', 'hari', 'verifikasi', 'menggunakan', 'gambar', 'kodok', 'selalu', 'salah', 'padahal', 'saya', 'sudah', 'memilih', 'kodok', 'yang', 'menghadap', 'atas', 'dengan', 'benar', 'terima', 'kasih']","['tolong', 'perbaiki', 'verifikasi', 'verifikasi', 'gambar', 'kodok', 'salah', 'memilih', 'kodok', 'menghadap', 'terima', 'kasih']",26,12,14,tolong baik verifikasi verifikasi gambar kodok salah pilih kodok hadap terima kasih,12,12
Alhamdulilah.. instal linked semua bisa di lihat dari berbagai penjuru dunia.. thanks linked sangat membantu my bisnis.. 👌👍❤,positif,2020-10-13,2020,alhamdulilah instal linked semua bisa di lihat dari berbagai penjuru dunia thanks linked sangat membantu my bisnis,18,17,alhamdulillah memasang linked semua bisa di lihat dari berbagai penjuru dunia terima kasih linked sangat membantu my bisnis,17,18,"['alhamdulillah', 'memasang', 'linked', 'semua', 'bisa', 'di', 'lihat', 'dari', 'berbagai', 'penjuru', 'dunia', 'terima', 'kasih', 'linked', 'sangat', 'membantu', 'my', 'bisnis']","['alhamdulillah', 'memasang', 'linked', 'lihat', 'penjuru', 'dunia', 'terima', 'kasih', 'linked', 'membantu', 'my', 'bisnis']",18,12,6,alhamdulillah pasang linked lihat penjuru dunia terima kasih linked bantu my bisnis,12,12
Ko gak bisa bisa masuk yaa bingung juga nih aplikasinya. Uninstall aja lagi dah. Gak bisa gunain nya 😭 daftar Mulu gak masuk2 heran dah.,negatif,2022-06-29,2022,ko gak bisa bisa masuk yaa bingung juga nih aplikasinya uninstall aja lagi dah gak bisa gunain nya daftar mulu gak masuk heran dah,25,24,kok tidak bisa bisa masuk ya bingung juga nih aplikasi nya uninstall saja lagi sudah tidak bisa guna in nya daftar mulu tidak masuk heran sudah,24,26,"['kok', 'tidak', 'bisa', 'bisa', 'masuk', 'ya', 'bingung', 'juga', 'nih', 'aplikasi', 'nya', 'uninstall', 'saja', 'lagi', 'sudah', 'tidak', 'bisa', 'guna', 'in', 'nya', 'daftar', 'mulu', 'tidak', 'masuk', 'heran', 'sudah']","['tidak', 'masuk', 'ya', 'bingung', 'nih', 'aplikasi', 'nya', 'uninstall', 'tidak', 'in', 'nya', 'daftar', 'mulu', 'tidak', 'masuk', 'heran']",26,16,10,tidak masuk ya bingung nih aplikasi nya uninstall tidak in nya daftar mulu tidak masuk heran,16,16
"Sangat membantu dalam mencari pekerjaan walaupun saya blm dapat pekerjaan da banyak inspirasi dari orang 2 yg luar biasa'dan sukses, banyak mengenal orang 2 yg luar biasa dan sukses.",positif,2020-08-09,2020,sangat membantu dalam mencari pekerjaan walaupun saya blm dapat pekerjaan da banyak inspirasi dari orang yg luar biasa dan sukses banyak mengenal orang yg luar biasa dan sukses,29,28,sangat membantu dalam mencari pekerjaan walaupun saya belum dapat pekerjaan ada banyak inspirasi dari orang yang luar biasa dan sukses banyak mengenal orang yang luar biasa dan sukses,28,28,"['sangat', 'membantu', 'dalam', 'mencari', 'pekerjaan', 'walaupun', 'saya', 'belum', 'dapat', 'pekerjaan', 'ada', 'banyak', 'inspirasi', 'dari', 'orang', 'yang', 'luar', 'biasa', 'dan', 'sukses', 'banyak', 'mengenal', 'orang', 'yang', 'luar', 'biasa', 'dan', 'sukses']","['membantu', 'mencari', 'pekerjaan', 'pekerjaan', 'inspirasi', 'orang', 'sukses', 'mengenal', 'orang', 'sukses']",28,10,18,bantu cari kerja kerja inspirasi orang sukses kenal orang sukses,10,10
Emang bener ya kalau pakai aplikasi ini nomor telfon kita bisa tersebar luaskan? Banyak pesan wa yang ngaku² dapat nomor saya dari aplikasi ini :( risih sih.,negatif,2024-01-23,2024,emang bener ya kalau pakai aplikasi ini nomor telfon kita bisa tersebar luaskan banyak pesan wa yang ngaku² dapat nomor saya dari aplikasi ini risih sih,27,26,memang benar ya kalau pakai aplikasi ini nomor telpon kita bisa tersebar luaskan banyak pesan whatsapp yang ngaku² dapat nomor saya dari aplikasi ini risih sih,26,26,"['memang', 'benar', 'ya', 'kalau', 'pakai', 'aplikasi', 'ini', 'nomor', 'telpon', 'kita', 'bisa', 'tersebar', 'luaskan', 'banyak', 'pesan', 'whatsapp', 'yang', 'ngaku²', 'dapat', 'nomor', 'saya', 'dari', 'aplikasi', 'ini', 'risih', 'sih']","['ya', 'pakai', 'aplikasi', 'nomor', 'telpon', 'tersebar', 'luaskan', 'pesan', 'whatsapp', 'ngaku²', 'nomor', 'aplikasi', 'risih', 'sih']",26,14,12,ya pakai aplikasi nomor telpon sebar luas pesan whatsapp ngaku nomor aplikasi risih sih,14,14
"Tolong dong aku saya kena hack padahal jarang banget login terus ga pernah mencet link gimana nih data"" saya takut disalah gunakan, mau contact us malah kebanyakan tulisan doang",negatif,2023-08-25,2023,tolong dong aku saya kena hack padahal jarang banget login terus ga pernah mencet link gimana nih data saya takut disalah gunakan mau contact us malah kebanyakan tulisan doang,29,29,tolong dong aku saya kena hack padahal jarang banget login terus tidak pernah mencet link bagaimana nih data saya takut disalah gunakan mau contact us bahkan kebanyakan tulisan saja,29,29,"['tolong', 'dong', 'aku', 'saya', 'kena', 'hack', 'padahal', 'jarang', 'banget', 'login', 'terus', 'tidak', 'pernah', 'mencet', 'link', 'bagaimana', 'nih', 'data', 'saya', 'takut', 'disalah', 'gunakan', 'mau', 'contact', 'us', 'bahkan', 'kebanyakan', 'tulisan', 'saja']","['tolong', 'kena', 'hack', 'jarang', 'banget', 'login', 'tidak', 'mencet', 'link', 'nih', 'data', 'takut', 'disalah', 'contact', 'us', 'kebanyakan', 'tulisan']",29,17,12,tolong kena hack jarang banget login tidak mencet link nih data takut salah contact us banyak tulis,17,17
Bukan tentang aplikasi ini tapi aplikasi play store terlalu lama pembaruan semua aplikasi putar putar terus dan tidak seleaai dan lama sekali 😡😡😡😡😡,negatif,2023-06-16,2023,bukan tentang aplikasi ini tapi aplikasi play store terlalu lama pembaruan semua aplikasi putar putar terus dan tidak seleaai dan lama sekali,23,22,bukan tentang aplikasi ini tapi aplikasi play store terlalu lama pembaruan semua aplikasi putar putar terus dan tidak seleaai dan lama sekali,22,22,"['bukan', 'tentang', 'aplikasi', 'ini', 'tapi', 'aplikasi', 'play', 'store', 'terlalu', 'lama', 'pembaruan', 'semua', 'aplikasi', 'putar', 'putar', 'terus', 'dan', 'tidak', 'seleaai', 'dan', 'lama', 'sekali']","['aplikasi', 'aplikasi', 'play', 'store', 'pembaruan', 'aplikasi', 'putar', 'putar', 'tidak', 'seleaai']",22,10,12,aplikasi aplikasi play store baru aplikasi putar putar tidak seleaai,10,10
Woi ini kenapa akun gue ga bisa login2. Bisa ga kalau login itu dibuat simple aja. Ini dibuat verivikasi udah bener gue isi ga bisa login2. Stress lama lama.,negatif,2023-05-12,2023,woi ini kenapa akun gue ga bisa login bisa ga kalau login itu dibuat simple aja ini dibuat verivikasi udah bener gue isi ga bisa login stress lama lama,29,29,woi ini kenapa akun saya tidak bisa login bisa tidak kalau login itu dibuat simpel saja ini dibuat verivikasi sudah benar saya isi tidak bisa login stress lama lama,29,29,"['woi', 'ini', 'kenapa', 'akun', 'saya', 'tidak', 'bisa', 'login', 'bisa', 'tidak', 'kalau', 'login', 'itu', 'dibuat', 'simpel', 'saja', 'ini', 'dibuat', 'verivikasi', 'sudah', 'benar', 'saya', 'isi', 'tidak', 'bisa', 'login', 'stress', 'lama', 'lama']","['woi', 'akun', 'tidak', 'login', 'tidak', 'login', 'simpel', 'verivikasi', 'isi', 'tidak', 'login', 'stress']",29,12,17,woi akun tidak login tidak login simpel verivikasi isi tidak login stress,12,12
Selalu salah masukin capcha. Walo sudah benar. Aplikasinya yg error ato saya yg bodoh? Diulang sampe 50x tetap error walo benar. No linkin. No stupid. Terlalu ribet.,negatif,2023-12-26,2023,selalu salah masukin capcha walo sudah benar aplikasinya yg error ato saya yg bodoh diulang sampe x tetap error walo benar no linkin no stupid terlalu ribet,27,27,selalu salah masukkan capcha walo sudah benar aplikasi nya yang error atau saya yang bodoh diulang sampai x tetap error walo benar nomor linkin nomor bodoh terlalu rumit,27,28,"['selalu', 'salah', 'masukkan', 'capcha', 'walo', 'sudah', 'benar', 'aplikasi', 'nya', 'yang', 'error', 'atau', 'saya', 'yang', 'bodoh', 'diulang', 'sampai', 'x', 'tetap', 'error', 'walo', 'benar', 'nomor', 'linkin', 'nomor', 'bodoh', 'terlalu', 'rumit']","['salah', 'masukkan', 'capcha', 'walo', 'aplikasi', 'nya', 'error', 'bodoh', 'diulang', 'x', 'error', 'walo', 'nomor', 'linkin', 'nomor', 'bodoh', 'rumit']",28,17,11,salah masuk capcha walo aplikasi nya error bodoh ulang x error walo nomor linkin nomor bodoh rumit,17,17
"Banyak sekali bug! tolong dibenahkan ini sangat menganggu sekali, karena bug terlalu sering!",negatif,2023-06-26,2023,banyak sekali bug tolong dibenahkan ini sangat menganggu sekali karena bug terlalu sering,13,13,banyak sekali bug tolong dibenahkan ini sangat menganggu sekali karena bug terlalu sering,13,13,"['banyak', 'sekali', 'bug', 'tolong', 'dibenahkan', 'ini', 'sangat', 'menganggu', 'sekali', 'karena', 'bug', 'terlalu', 'sering']","['bug', 'tolong', 'dibenahkan', 'menganggu', 'bug']",13,5,8,bug tolong benah menganggu bug,5,5
Linkedin bermasalah dan terlalu banyak menampilkan postingan tidak relevan di menu search sejak update terakhir pada 31 Nov 2023. Mohon diperbaiki!,negatif,2023-12-02,2023,linkedin bermasalah dan terlalu banyak menampilkan postingan tidak relevan di menu search sejak update terakhir pada nov mohon diperbaiki,21,19,linkedin bermasalah dan terlalu banyak menampilkan postingan tidak relevan di menu search sejak diperbarui terakhir pada nov mohon di perbaiki,19,20,"['linkedin', 'bermasalah', 'dan', 'terlalu', 'banyak', 'menampilkan', 'postingan', 'tidak', 'relevan', 'di', 'menu', 'search', 'sejak', 'diperbarui', 'terakhir', 'pada', 'nov', 'mohon', 'di', 'perbaiki']","['linkedin', 'bermasalah', 'menampilkan', 'postingan', 'tidak', 'relevan', 'menu', 'search', 'diperbarui', 'nov', 'mohon', 'perbaiki']",20,12,8,linkedin masalah tampil postingan tidak relevan menu search baru nov mohon baik,12,12
Maaf sebelumnya untuk pihak LinkedIn kenapa sekarang kalo tambahkan lampiran sering nggak bisa. Apakah ini bug dari LinkedIn mohon untuk di perbaiki. Terimakasih,negatif,2023-09-03,2023,maaf sebelumnya untuk pihak linkedin kenapa sekarang kalo tambahkan lampiran sering nggak bisa apakah ini bug dari linkedin mohon untuk di perbaiki terimakasih,23,23,maaf sebelumnya untuk pihak linkedin kenapa sekarang kalau tambahkan lampiran sering tidak bisa apakah ini bug dari linkedin mohon untuk di perbaikan terima kasih,23,24,"['maaf', 'sebelumnya', 'untuk', 'pihak', 'linkedin', 'kenapa', 'sekarang', 'kalau', 'tambahkan', 'lampiran', 'sering', 'tidak', 'bisa', 'apakah', 'ini', 'bug', 'dari', 'linkedin', 'mohon', 'untuk', 'di', 'perbaikan', 'terima', 'kasih']","['maaf', 'linkedin', 'tambahkan', 'lampiran', 'tidak', 'bug', 'linkedin', 'mohon', 'perbaikan', 'terima', 'kasih']",24,11,13,maaf linkedin tambah lampir tidak bug linkedin mohon baik terima kasih,11,11
"Banyak info pekerjaan yank nggak jelas Tiba² ada pesan masuk disuruh interview ke PT ini PT itu, padahal nggak masuk lamaran ke PT tersebut Banyak penipuan di apk ini",negatif,2022-06-29,2022,banyak info pekerjaan yank nggak jelas tiba² ada pesan masuk disuruh interview ke pt ini pt itu padahal nggak masuk lamaran ke pt tersebut banyak penipuan di apk ini,29,29,banyak informasi pekerjaan yank tidak jelas tiba² ada pesan masuk disuruh interview ke perseroan terbatas ini perseroan terbatas itu padahal tidak masuk lamaran ke perseroan terbatas tersebut banyak penipuan di aplikasi ini,29,32,"['banyak', 'informasi', 'pekerjaan', 'yank', 'tidak', 'jelas', 'tiba²', 'ada', 'pesan', 'masuk', 'disuruh', 'interview', 'ke', 'perseroan', 'terbatas', 'ini', 'perseroan', 'terbatas', 'itu', 'padahal', 'tidak', 'masuk', 'lamaran', 'ke', 'perseroan', 'terbatas', 'tersebut', 'banyak', 'penipuan', 'di', 'aplikasi', 'ini']","['informasi', 'pekerjaan', 'yank', 'tidak', 'tiba²', 'pesan', 'masuk', 'disuruh', 'interview', 'perseroan', 'terbatas', 'perseroan', 'terbatas', 'tidak', 'masuk', 'lamaran', 'perseroan', 'terbatas', 'penipuan', 'aplikasi']",32,20,12,informasi kerja yank tidak tiba pesan masuk suruh interview persero batas persero batas tidak masuk lamar persero batas tipu aplikasi,20,20
Info loker untuk lulusan SMA yang tidak memandang fisik karena yang dipandang itu kinerjanya... Pengalaman terakhir saya : kerja kelompok,negatif,2023-09-04,2023,info loker untuk lulusan sma yang tidak memandang fisik karena yang dipandang itu kinerjanya pengalaman terakhir saya kerja kelompok,20,19,informasi loker untuk lulusan sama yang tidak memandang fisik karena yang dipandang itu kinerjanya pengalaman terakhir saya kerja kelompok,19,19,"['informasi', 'loker', 'untuk', 'lulusan', 'sama', 'yang', 'tidak', 'memandang', 'fisik', 'karena', 'yang', 'dipandang', 'itu', 'kinerjanya', 'pengalaman', 'terakhir', 'saya', 'kerja', 'kelompok']","['informasi', 'loker', 'lulusan', 'tidak', 'memandang', 'fisik', 'dipandang', 'kinerjanya', 'pengalaman', 'kerja', 'kelompok']",19,11,8,informasi loker lulus tidak pandang fisik pandang kerja alam kerja kelompok,11,11
"Gk pernah instal, ataupun login, tapi iklannya mengganggu! SANGAT MENGGANGGU! SEBELUMNYA ITU UDAH KE INSTAL SENDIRI DARI AWAL PAKAI HP INI.",negatif,2023-02-09,2023,gk pernah instal ataupun login tapi iklannya mengganggu sangat mengganggu sebelumnya itu udah ke instal sendiri dari awal pakai hp ini,21,21,tidak pernah memasang ataupun login tapi iklannya mengganggu sangat mengganggu sebelumnya itu sudah ke memasang sendiri dari awal pakai handphone ini,21,21,"['tidak', 'pernah', 'memasang', 'ataupun', 'login', 'tapi', 'iklannya', 'mengganggu', 'sangat', 'mengganggu', 'sebelumnya', 'itu', 'sudah', 'ke', 'memasang', 'sendiri', 'dari', 'awal', 'pakai', 'handphone', 'ini']","['tidak', 'memasang', 'login', 'iklannya', 'mengganggu', 'mengganggu', 'memasang', 'pakai', 'handphone']",21,9,12,tidak pasang login iklan ganggu ganggu pasang pakai handphone,9,9
"Akun di hack. Udah balik lagi - udah verif 2 langkah. Malah di batasin. Gabisa di akses. Smpe harus kirim data pribadi. Gadi beres2in masalah, akun gua.",negatif,2023-09-07,2023,akun di hack udah balik lagi udah verif langkah malah di batasin gabisa di akses smpe harus kirim data pribadi gadi beres in masalah akun gua,27,26,akun di hack sudah balik lagi sudah verif langkah bahkan di batasin tidak bisa di akses sampai harus kirim data pribadi gadi beres in masalah akun saya,26,27,"['akun', 'di', 'hack', 'sudah', 'balik', 'lagi', 'sudah', 'verif', 'langkah', 'bahkan', 'di', 'batasin', 'tidak', 'bisa', 'di', 'akses', 'sampai', 'harus', 'kirim', 'data', 'pribadi', 'gadi', 'beres', 'in', 'masalah', 'akun', 'saya']","['akun', 'hack', 'verif', 'langkah', 'batasin', 'tidak', 'akses', 'kirim', 'data', 'pribadi', 'gadi', 'beres', 'in', 'akun']",27,14,13,akun hack verif langkah batasin tidak akses kirim data pribadi gadi beres in akun,14,14
"Verikasi sudah menggunakan identitas asli,,,email yang terhubung juga sudah kirim PIN,,,tetap gak bisaaaa,,,,gimana ini",negatif,2023-05-27,2023,verikasi sudah menggunakan identitas asli email yang terhubung juga sudah kirim pin tetap gak bisaaaa gimana ini,14,17,verikasi sudah menggunakan identitas asli email yang terhubung juga sudah kirim pin tetap tidak bisaaaa bagaimana ini,17,17,"['verikasi', 'sudah', 'menggunakan', 'identitas', 'asli', 'email', 'yang', 'terhubung', 'juga', 'sudah', 'kirim', 'pin', 'tetap', 'tidak', 'bisaaaa', 'bagaimana', 'ini']","['verikasi', 'identitas', 'asli', 'email', 'terhubung', 'kirim', 'pin', 'tidak', 'bisaaaa']",17,9,8,verikasi identitas asli email hubung kirim pin tidak bisaaaa,9,9
"Aplikasi mencari kerja & koneksi pekerjaan yg sangat bagus, mudah digunakan & efektif",positif,2021-12-16,2021,aplikasi mencari kerja koneksi pekerjaan yg sangat bagus mudah digunakan efektif,13,11,aplikasi mencari kerja koneksi pekerjaan yang sangat bagus mudah digunakan efektif,11,11,"['aplikasi', 'mencari', 'kerja', 'koneksi', 'pekerjaan', 'yang', 'sangat', 'bagus', 'mudah', 'digunakan', 'efektif']","['aplikasi', 'mencari', 'kerja', 'koneksi', 'pekerjaan', 'bagus', 'mudah', 'efektif']",11,8,3,aplikasi cari kerja koneksi kerja bagus mudah efektif,8,8
"Tiba² keluar dari akun dan disiruh verifikasi data diri disuruh upload ini itu tidak jelas sama sekali, ngga bisa login lagi",negatif,2022-11-03,2022,tiba² keluar dari akun dan disiruh verifikasi data diri disuruh upload ini itu tidak jelas sama sekali ngga bisa login lagi,21,21,tiba² keluar dari akun dan disiruh verifikasi data diri disuruh unggah ini itu tidak jelas sama sekali tidak bisa login lagi,21,21,"['tiba²', 'keluar', 'dari', 'akun', 'dan', 'disiruh', 'verifikasi', 'data', 'diri', 'disuruh', 'unggah', 'ini', 'itu', 'tidak', 'jelas', 'sama', 'sekali', 'tidak', 'bisa', 'login', 'lagi']","['tiba²', 'akun', 'disiruh', 'verifikasi', 'data', 'disuruh', 'unggah', 'tidak', 'tidak', 'login']",21,10,11,tiba akun disiruh verifikasi data suruh unggah tidak tidak login,10,10
"Login, verifikasi, login, verifikasi, udah gitu aja terus. Pikir berkali deh buat yg mau install, sayang paket, mending lanjut di web bukanya",negatif,2023-07-26,2023,login verifikasi login verifikasi udah gitu aja terus pikir berkali deh buat yg mau install sayang paket mending lanjut di web bukanya,22,22,login verifikasi login verifikasi sudah begitu saja terus pikir berkali deh buat yang mau install sayang paket mending lanjut di web bukanya,22,22,"['login', 'verifikasi', 'login', 'verifikasi', 'sudah', 'begitu', 'saja', 'terus', 'pikir', 'berkali', 'deh', 'buat', 'yang', 'mau', 'install', 'sayang', 'paket', 'mending', 'lanjut', 'di', 'web', 'bukanya']","['login', 'verifikasi', 'login', 'verifikasi', 'pikir', 'berkali', 'deh', 'install', 'sayang', 'paket', 'mending', 'web', 'bukanya']",22,13,9,login verifikasi login verifikasi pikir kali deh install sayang paket mending web buka,13,13
"Aplikasi gak jelas, akun dibatasi padahal gak ngapa ngapain, udah gitu verifikasi nya ditolak padahal tanda identitas nya udah jelas",negatif,2023-08-17,2023,aplikasi gak jelas akun dibatasi padahal gak ngapa ngapain udah gitu verifikasi nya ditolak padahal tanda identitas nya udah jelas,20,20,aplikasi tidak jelas akun dibatasi padahal tidak ngapa buat apa sudah begitu verifikasi nya ditolak padahal tanda identitas nya sudah jelas,20,21,"['aplikasi', 'tidak', 'jelas', 'akun', 'dibatasi', 'padahal', 'tidak', 'ngapa', 'buat', 'apa', 'sudah', 'begitu', 'verifikasi', 'nya', 'ditolak', 'padahal', 'tanda', 'identitas', 'nya', 'sudah', 'jelas']","['aplikasi', 'tidak', 'akun', 'dibatasi', 'tidak', 'ngapa', 'verifikasi', 'nya', 'ditolak', 'tanda', 'identitas', 'nya']",21,12,9,aplikasi tidak akun batas tidak ngapa verifikasi nya tolak tanda identitas nya,12,12
"Saya kurang paham, linkedIn ini hanya menampilkan iklan loker saja kah, tidak bisa langsung Apply kah..? Stiap mau Apply selalu masuk ke situs lain..",negatif,2022-04-12,2022,saya kurang paham linkedin ini hanya menampilkan iklan loker saja kah tidak bisa langsung apply kah stiap mau apply selalu masuk ke situs lain,24,24,saya kurang paham linkedin ini hanya menampilkan iklan loker saja kah tidak bisa langsung apply kah setiap mau apply selalu masuk ke situs lain,24,24,"['saya', 'kurang', 'paham', 'linkedin', 'ini', 'hanya', 'menampilkan', 'iklan', 'loker', 'saja', 'kah', 'tidak', 'bisa', 'langsung', 'apply', 'kah', 'setiap', 'mau', 'apply', 'selalu', 'masuk', 'ke', 'situs', 'lain']","['paham', 'linkedin', 'menampilkan', 'iklan', 'loker', 'kah', 'tidak', 'langsung', 'apply', 'kah', 'apply', 'masuk', 'situs']",24,13,11,paham linkedin tampil iklan loker kah tidak langsung apply kah apply masuk situs,13,13
"Kok update nya makin nggak bagus, sering error. Upload foto lama dan error saat di akhir loading.",negatif,2023-03-26,2023,kok update nya makin nggak bagus sering error upload foto lama dan error saat di akhir loading,17,17,kok diperbarui nya makin tidak bagus sering error unggah foto lama dan error saat di akhir loading,17,17,"['kok', 'diperbarui', 'nya', 'makin', 'tidak', 'bagus', 'sering', 'error', 'unggah', 'foto', 'lama', 'dan', 'error', 'saat', 'di', 'akhir', 'loading']","['diperbarui', 'nya', 'tidak', 'bagus', 'error', 'unggah', 'foto', 'error', 'loading']",17,9,8,baru nya tidak bagus error unggah foto error loading,9,9
"Aplikasi bangke, dari awal instal gak bisa login. Sudah kirim verifikasi tapi gak nongol - nongol nomor verifikasinya",negatif,2023-09-20,2023,aplikasi bangke dari awal instal gak bisa login sudah kirim verifikasi tapi gak nongol nongol nomor verifikasinya,18,17,aplikasi bangke dari awal memasang tidak bisa login sudah kirim verifikasi tapi tidak nongol nongol nomor verifikasinya,17,17,"['aplikasi', 'bangke', 'dari', 'awal', 'memasang', 'tidak', 'bisa', 'login', 'sudah', 'kirim', 'verifikasi', 'tapi', 'tidak', 'nongol', 'nongol', 'nomor', 'verifikasinya']","['aplikasi', 'bangke', 'memasang', 'tidak', 'login', 'kirim', 'verifikasi', 'tidak', 'nongol', 'nongol', 'nomor', 'verifikasinya']",17,12,5,aplikasi bangke pasang tidak login kirim verifikasi tidak nongol nongol nomor verifikasi,12,12
"stupid security check, pilih hewan yang menghadap ke atas tetapi tidak ada pilihan yang menghadap ke atas sama sekali, mengulang sampai 20x lebih karena dianggap salah",negatif,2023-10-07,2023,stupid security check pilih hewan yang menghadap ke atas tetapi tidak ada pilihan yang menghadap ke atas sama sekali mengulang sampai x lebih karena dianggap salah,26,26,bodoh security cek pilih hewan yang menghadap ke atas tetapi tidak ada pilihan yang menghadap ke atas sama sekali mengulang sampai x lebih karena dianggap salah,26,26,"['bodoh', 'security', 'cek', 'pilih', 'hewan', 'yang', 'menghadap', 'ke', 'atas', 'tetapi', 'tidak', 'ada', 'pilihan', 'yang', 'menghadap', 'ke', 'atas', 'sama', 'sekali', 'mengulang', 'sampai', 'x', 'lebih', 'karena', 'dianggap', 'salah']","['bodoh', 'security', 'cek', 'pilih', 'hewan', 'menghadap', 'tidak', 'pilihan', 'menghadap', 'mengulang', 'x', 'dianggap', 'salah']",26,13,13,bodoh security cek pilih hewan hadap tidak pilih hadap ulang x anggap salah,13,13
5 tahun melamar pake aplikasi ini. Satupun gak pernah ada panggilan. Not rekoment buat pen arian kerja. Cuman bikin rame aja disini gak pala berfungsi bagus,negatif,2021-03-25,2021,tahun melamar pake aplikasi ini satupun gak pernah ada panggilan not rekoment buat pen arian kerja cuman bikin rame aja disini gak pala berfungsi bagus,26,25,tahun melamar pakai aplikasi ini satupun tidak pernah ada panggilan not rekoment buat pen arian kerja cuman bikin ramai saja disini tidak pala berfungsi bagus,25,25,"['tahun', 'melamar', 'pakai', 'aplikasi', 'ini', 'satupun', 'tidak', 'pernah', 'ada', 'panggilan', 'not', 'rekoment', 'buat', 'pen', 'arian', 'kerja', 'cuman', 'bikin', 'ramai', 'saja', 'disini', 'tidak', 'pala', 'berfungsi', 'bagus']","['melamar', 'pakai', 'aplikasi', 'satupun', 'tidak', 'panggilan', 'not', 'rekoment', 'pen', 'arian', 'kerja', 'cuman', 'bikin', 'ramai', 'tidak', 'pala', 'berfungsi', 'bagus']",25,18,7,lamar pakai aplikasi satu tidak panggil not rekoment pen ari kerja cuman bikin ramai tidak pala fungsi bagus,18,18
"aplikasi bagus banget buat nyari loker, membantu banget. khususnya buat fresh graduate dan anak muda Indonesia.",positif,2023-12-24,2023,aplikasi bagus banget buat nyari loker membantu banget khususnya buat fresh graduate dan anak muda indonesia,16,16,aplikasi bagus banget buat mencari loker membantu banget khususnya buat segar graduate dan anak muda indonesia,16,16,"['aplikasi', 'bagus', 'banget', 'buat', 'mencari', 'loker', 'membantu', 'banget', 'khususnya', 'buat', 'segar', 'graduate', 'dan', 'anak', 'muda', 'indonesia']","['aplikasi', 'bagus', 'banget', 'mencari', 'loker', 'membantu', 'banget', 'segar', 'graduate', 'anak', 'muda', 'indonesia']",16,12,4,aplikasi bagus banget cari loker bantu banget segar graduate anak muda indonesia,12,12
"Kenapa untuk memperifikasi aja ribet bgt yah, gambar menghadap keatas udah diklik bener masih aja salah diulang beberapa kali salah terus, ribet bgt si nyet..bkin kesel aja.",negatif,2021-11-12,2021,kenapa untuk memperifikasi aja ribet bgt yah gambar menghadap keatas udah diklik bener masih aja salah diulang beberapa kali salah terus ribet bgt si nyet bkin kesel aja,27,28,kenapa untuk memperifikasi saja rumit banget ya gambar menghadap keatas sudah diklik benar masih saja salah diulang beberapa kali salah terus rumit banget sih nyet bkin kesel saja,28,28,"['kenapa', 'untuk', 'memperifikasi', 'saja', 'rumit', 'banget', 'ya', 'gambar', 'menghadap', 'keatas', 'sudah', 'diklik', 'benar', 'masih', 'saja', 'salah', 'diulang', 'beberapa', 'kali', 'salah', 'terus', 'rumit', 'banget', 'sih', 'nyet', 'bkin', 'kesel', 'saja']","['memperifikasi', 'rumit', 'banget', 'ya', 'gambar', 'menghadap', 'keatas', 'diklik', 'salah', 'diulang', 'kali', 'salah', 'rumit', 'banget', 'sih', 'nyet', 'bkin', 'kesel']",28,18,10,memperifikasi rumit banget ya gambar hadap atas klik salah ulang kali salah rumit banget sih nyet bkin kesel,18,18
"Gak rekomen cari kerja di sini. Udah ribet, ga efektif, ga ada hasil pula. 11-12 sama jobstreet. Tiap ngelamar pun pasti ujung2 nya bikin akun di platform lain lagi. Benar benar payah platform nya.",negatif,2023-01-09,2023,gak rekomen cari kerja di sini udah ribet ga efektif ga ada hasil pula sama jobstreet tiap ngelamar pun pasti ujung nya bikin akun di platform lain lagi benar benar payah platform nya,34,33,tidak rekomendasi cari kerja di sini sudah rumit tidak efektif tidak ada hasil pula sama jobstreet tiap ngelamar pun pasti ujung nya bikin akun di platform lain lagi benar benar payah platform nya,33,33,"['tidak', 'rekomendasi', 'cari', 'kerja', 'di', 'sini', 'sudah', 'rumit', 'tidak', 'efektif', 'tidak', 'ada', 'hasil', 'pula', 'sama', 'jobstreet', 'tiap', 'ngelamar', 'pun', 'pasti', 'ujung', 'nya', 'bikin', 'akun', 'di', 'platform', 'lain', 'lagi', 'benar', 'benar', 'payah', 'platform', 'nya']","['tidak', 'rekomendasi', 'cari', 'kerja', 'rumit', 'tidak', 'efektif', 'tidak', 'hasil', 'jobstreet', 'ngelamar', 'ujung', 'nya', 'bikin', 'akun', 'platform', 'payah', 'platform', 'nya']",33,19,14,tidak rekomendasi cari kerja rumit tidak efektif tidak hasil jobstreet ngelamar ujung nya bikin akun platform payah platform nya,19,19
Sangat membantu dalam pencarian kerja.. Walaupun sampai sekarang belum dapat.. Tapi aplikasi ini sangat membantu sekali. 🙏,positif,2020-07-03,2020,sangat membantu dalam pencarian kerja walaupun sampai sekarang belum dapat tapi aplikasi ini sangat membantu sekali,17,16,sangat membantu dalam pencarian kerja walaupun sampai sekarang belum dapat tapi aplikasi ini sangat membantu sekali,16,16,"['sangat', 'membantu', 'dalam', 'pencarian', 'kerja', 'walaupun', 'sampai', 'sekarang', 'belum', 'dapat', 'tapi', 'aplikasi', 'ini', 'sangat', 'membantu', 'sekali']","['membantu', 'pencarian', 'kerja', 'aplikasi', 'membantu']",16,5,11,bantu cari kerja aplikasi bantu,5,5
"Apa an ini aplikasi tidak lengkap buat pencarian kerja untuk wilayah kota pekan baru, dan juga utk kota-kota yg lain nya banyak yg tidak ada!!!",negatif,2020-09-03,2020,apa an ini aplikasi tidak lengkap buat pencarian kerja untuk wilayah kota pekan baru dan juga utk kota kota yg lain nya banyak yg tidak ada,25,26,apa an ini aplikasi tidak lengkap buat pencarian kerja untuk wilayah kota pekan baru dan juga untuk kota kota yang lain nya banyak yang tidak ada,26,26,"['apa', 'an', 'ini', 'aplikasi', 'tidak', 'lengkap', 'buat', 'pencarian', 'kerja', 'untuk', 'wilayah', 'kota', 'pekan', 'baru', 'dan', 'juga', 'untuk', 'kota', 'kota', 'yang', 'lain', 'nya', 'banyak', 'yang', 'tidak', 'ada']","['an', 'aplikasi', 'tidak', 'lengkap', 'pencarian', 'kerja', 'wilayah', 'kota', 'pekan', 'kota', 'kota', 'nya', 'tidak']",26,13,13,an aplikasi tidak lengkap cari kerja wilayah kota pekan kota kota nya tidak,13,13
Kesulitan untuk login dengan proses yang berulang-ulang. Setelah uninstall dan install kembali tetap tidak bisa login. Mohon diperbaiki.,negatif,2024-01-05,2024,kesulitan untuk login dengan proses yang berulang ulang setelah uninstall dan install kembali tetap tidak bisa login mohon diperbaiki,18,19,kesulitan untuk login dengan proses yang berulang ulang setelah uninstall dan install kembali tetap tidak bisa login mohon di perbaiki,19,20,"['kesulitan', 'untuk', 'login', 'dengan', 'proses', 'yang', 'berulang', 'ulang', 'setelah', 'uninstall', 'dan', 'install', 'kembali', 'tetap', 'tidak', 'bisa', 'login', 'mohon', 'di', 'perbaiki']","['kesulitan', 'login', 'proses', 'berulang', 'ulang', 'uninstall', 'install', 'tidak', 'login', 'mohon', 'perbaiki']",20,11,9,sulit login proses ulang ulang uninstall install tidak login mohon baik,11,11
"Keren banget aplikasinya. Sejauh ini, aplikasi lowongan pekerjaan yang paling saya sukai hanya ini. Semoga lowongan kerja di aplikasi ini dapat dipercaya.",positif,2020-11-14,2020,keren banget aplikasinya sejauh ini aplikasi lowongan pekerjaan yang paling saya sukai hanya ini semoga lowongan kerja di aplikasi ini dapat dipercaya,22,22,keren banget aplikasi nya sejauh ini aplikasi lowongan pekerjaan yang paling saya suka hanya ini semoga lowongan kerja di aplikasi ini dapat dipercaya,22,23,"['keren', 'banget', 'aplikasi', 'nya', 'sejauh', 'ini', 'aplikasi', 'lowongan', 'pekerjaan', 'yang', 'paling', 'saya', 'suka', 'hanya', 'ini', 'semoga', 'lowongan', 'kerja', 'di', 'aplikasi', 'ini', 'dapat', 'dipercaya']","['keren', 'banget', 'aplikasi', 'nya', 'aplikasi', 'lowongan', 'pekerjaan', 'suka', 'semoga', 'lowongan', 'kerja', 'aplikasi', 'dipercaya']",23,13,10,keren banget aplikasi nya aplikasi lowong kerja suka moga lowong kerja aplikasi percaya,13,13
"captcha error berkali-kali, minimal diberesin dulu min baru update². Makin kesini update apk makin error, nyesel gw update linkedIn ke versi terbaru",negatif,2023-09-16,2023,captcha error berkali kali minimal diberesin dulu min baru update² makin kesini update apk makin error nyesel gw update linkedin ke versi terbaru,22,23,captcha error berkali kali minimal diberesin dahulu minimal baru update² makin kesini diperbarui aplikasi makin error menyesal saya diperbarui linkedin ke versi terbaru,23,23,"['captcha', 'error', 'berkali', 'kali', 'minimal', 'diberesin', 'dahulu', 'minimal', 'baru', 'update²', 'makin', 'kesini', 'diperbarui', 'aplikasi', 'makin', 'error', 'menyesal', 'saya', 'diperbarui', 'linkedin', 'ke', 'versi', 'terbaru']","['captcha', 'error', 'berkali', 'kali', 'minimal', 'diberesin', 'minimal', 'update²', 'kesini', 'diperbarui', 'aplikasi', 'error', 'menyesal', 'diperbarui', 'linkedin', 'versi', 'terbaru']",23,17,6,captcha error kali kali minimal resin minimal update kesini baru aplikasi error sesal baru linkedin versi baru,17,17
Aplikasi yang selalu Updating fitur-fitur media dan Konten yang Syarat akan teknologi Platform IT canggih..,positif,2021-02-08,2021,aplikasi yang selalu updating fitur fitur media dan konten yang syarat akan teknologi platform it canggih,15,16,aplikasi yang selalu updating fitur fitur media dan konten yang syarat akan teknologi platform it canggih,16,16,"['aplikasi', 'yang', 'selalu', 'updating', 'fitur', 'fitur', 'media', 'dan', 'konten', 'yang', 'syarat', 'akan', 'teknologi', 'platform', 'it', 'canggih']","['aplikasi', 'updating', 'fitur', 'fitur', 'media', 'konten', 'syarat', 'teknologi', 'platform', 'it', 'canggih']",16,11,5,aplikasi updating fitur fitur media konten syarat teknologi platform it canggih,11,11
Saya bergabung di aplikasi ini tapi menurut saya aplikasi ini sangat bagus dan mudah digunakan untuk mencari relasi dan peluang usaha serta untuk promosi iklan juga,positif,2024-01-07,2024,saya bergabung di aplikasi ini tapi menurut saya aplikasi ini sangat bagus dan mudah digunakan untuk mencari relasi dan peluang usaha serta untuk promosi iklan juga,26,26,saya bergabung di aplikasi ini tapi menurut saya aplikasi ini sangat bagus dan mudah digunakan untuk mencari relasi dan peluang usaha serta untuk promosi iklan juga,26,26,"['saya', 'bergabung', 'di', 'aplikasi', 'ini', 'tapi', 'menurut', 'saya', 'aplikasi', 'ini', 'sangat', 'bagus', 'dan', 'mudah', 'digunakan', 'untuk', 'mencari', 'relasi', 'dan', 'peluang', 'usaha', 'serta', 'untuk', 'promosi', 'iklan', 'juga']","['bergabung', 'aplikasi', 'aplikasi', 'bagus', 'mudah', 'mencari', 'relasi', 'peluang', 'usaha', 'promosi', 'iklan']",26,11,15,gabung aplikasi aplikasi bagus mudah cari relasi peluang usaha promosi iklan,11,11
Aplikasi gak jelas...baru login dikasi pertanyaan keamanan dijawab benar jdi salah! Dijawab salah malah benar. Ini aplikasi mau cari kerjaan apa mau nebak kata. Kalau bikin aplikasi yg bermanfaat lh g*blk!!,negatif,2022-02-07,2022,aplikasi gak jelas baru login dikasi pertanyaan keamanan dijawab benar jdi salah dijawab salah malah benar ini aplikasi mau cari kerjaan apa mau nebak kata kalau bikin aplikasi yg bermanfaat lh g blk,31,33,aplikasi tidak jelas baru login dikasih pertanyaan keamanan dijawab benar jadi salah dijawab salah bahkan benar ini aplikasi mau cari kerjaan apa mau nebak kata kalau bikin aplikasi yang bermanfaat lh tidak blk,33,33,"['aplikasi', 'tidak', 'jelas', 'baru', 'login', 'dikasih', 'pertanyaan', 'keamanan', 'dijawab', 'benar', 'jadi', 'salah', 'dijawab', 'salah', 'bahkan', 'benar', 'ini', 'aplikasi', 'mau', 'cari', 'kerjaan', 'apa', 'mau', 'nebak', 'kata', 'kalau', 'bikin', 'aplikasi', 'yang', 'bermanfaat', 'lh', 'tidak', 'blk']","['aplikasi', 'tidak', 'login', 'dikasih', 'keamanan', 'salah', 'salah', 'aplikasi', 'cari', 'kerjaan', 'nebak', 'bikin', 'aplikasi', 'bermanfaat', 'lh', 'tidak', 'blk']",33,17,16,aplikasi tidak login kasih aman salah salah aplikasi cari kerja nebak bikin aplikasi manfaat lh tidak blk,17,17
"Sudah jawab verifikasi gambar dengan benar, tapi selalu diminta terus, dan ada tulisan kode respon kode NOCAPTCHA tidak valid / belum di isi.",negatif,2023-01-24,2023,sudah jawab verifikasi gambar dengan benar tapi selalu diminta terus dan ada tulisan kode respon kode nocaptcha tidak valid belum di isi,23,22,sudah jawab verifikasi gambar dengan benar tapi selalu diminta terus dan ada tulisan kode respons kode nocaptcha tidak valid belum di isi,22,22,"['sudah', 'jawab', 'verifikasi', 'gambar', 'dengan', 'benar', 'tapi', 'selalu', 'diminta', 'terus', 'dan', 'ada', 'tulisan', 'kode', 'respons', 'kode', 'nocaptcha', 'tidak', 'valid', 'belum', 'di', 'isi']","['verifikasi', 'gambar', 'tulisan', 'kode', 'respons', 'kode', 'nocaptcha', 'tidak', 'valid', 'isi']",22,10,12,verifikasi gambar tulis kode respons kode nocaptcha tidak valid isi,10,10
"Aplikasi k0***L, downloadnya gampang tapi gk bisa di hapus. Aplikasi gk guna, mau lamar malah ke aplikasi lowker lainnya. Jancoook..",negatif,2020-10-18,2020,aplikasi k l downloadnya gampang tapi gk bisa di hapus aplikasi gk guna mau lamar malah ke aplikasi lowker lainnya jancoook,20,21,aplikasi ke l downloadnya gampang tapi tidak bisa di hapus aplikasi tidak guna mau lamar bahkan ke aplikasi lowker lainnya jancoook,21,21,"['aplikasi', 'ke', 'l', 'downloadnya', 'gampang', 'tapi', 'tidak', 'bisa', 'di', 'hapus', 'aplikasi', 'tidak', 'guna', 'mau', 'lamar', 'bahkan', 'ke', 'aplikasi', 'lowker', 'lainnya', 'jancoook']","['aplikasi', 'l', 'downloadnya', 'gampang', 'tidak', 'hapus', 'aplikasi', 'tidak', 'lamar', 'aplikasi', 'lowker', 'jancoook']",21,12,9,aplikasi l downloadnya gampang tidak hapus aplikasi tidak lamar aplikasi lowker jancoook,12,12
"Saya tidak bisa log in lagi, berawal dari tidak bisa refresh feed, kemudian saya uninstall dan install ulang. Setelah install ulang, tidak bisa log in.",negatif,2020-12-30,2020,saya tidak bisa log in lagi berawal dari tidak bisa refresh feed kemudian saya uninstall dan install ulang setelah install ulang tidak bisa log in,25,25,saya tidak bisa log in lagi berawal dari tidak bisa refresh feed kemudian saya uninstall dan install ulang setelah install ulang tidak bisa log in,25,25,"['saya', 'tidak', 'bisa', 'log', 'in', 'lagi', 'berawal', 'dari', 'tidak', 'bisa', 'refresh', 'feed', 'kemudian', 'saya', 'uninstall', 'dan', 'install', 'ulang', 'setelah', 'install', 'ulang', 'tidak', 'bisa', 'log', 'in']","['tidak', 'log', 'in', 'tidak', 'refresh', 'feed', 'uninstall', 'install', 'ulang', 'install', 'ulang', 'tidak', 'log', 'in']",25,14,11,tidak log in tidak refresh feed uninstall install ulang install ulang tidak log in,14,14
"Sy kasih bintang 5 smoga sy cepat mendapatkan pekerjaan yg sesuai dengan pengalaman kerja sy,sebagai groun staf/porter trimakasih was,salam.",positif,2022-01-15,2022,sy kasih bintang smoga sy cepat mendapatkan pekerjaan yg sesuai dengan pengalaman kerja sy sebagai groun staf porter trimakasih was salam,19,21,saya kasih bintang semoga saya cepat mendapatkan pekerjaan yang sesuai dengan pengalaman kerja saya sebagai groun staf porter terima kasih ragu ragu salam,21,23,"['saya', 'kasih', 'bintang', 'semoga', 'saya', 'cepat', 'mendapatkan', 'pekerjaan', 'yang', 'sesuai', 'dengan', 'pengalaman', 'kerja', 'saya', 'sebagai', 'groun', 'staf', 'porter', 'terima', 'kasih', 'ragu', 'ragu', 'salam']","['kasih', 'bintang', 'semoga', 'cepat', 'pekerjaan', 'sesuai', 'pengalaman', 'kerja', 'groun', 'staf', 'porter', 'terima', 'kasih', 'ragu', 'ragu', 'salam']",23,16,7,kasih bintang moga cepat kerja sesuai alam kerja groun staf porter terima kasih ragu ragu salam,16,16
Aplikasi paling positive... Buat yg mau apply job bisa download aplikasi ini. Bisa juga untuk mengembangkan ilmu pengetahuan dan yg ingin tau seputar dunia kerja. I love this so much.. 💕👌,positif,2021-02-18,2021,aplikasi paling positive buat yg mau apply job bisa download aplikasi ini bisa juga untuk mengembangkan ilmu pengetahuan dan yg ingin tau seputar dunia kerja i love this so much,31,30,aplikasi paling positive buat yang mau apply kerja bisa unduh aplikasi ini bisa juga untuk mengembangkan ilmu pengetahuan dan yang ingin tahu seputar dunia kerja i love ini so much,30,30,"['aplikasi', 'paling', 'positive', 'buat', 'yang', 'mau', 'apply', 'kerja', 'bisa', 'unduh', 'aplikasi', 'ini', 'bisa', 'juga', 'untuk', 'mengembangkan', 'ilmu', 'pengetahuan', 'dan', 'yang', 'ingin', 'tahu', 'seputar', 'dunia', 'kerja', 'i', 'love', 'ini', 'so', 'much']","['aplikasi', 'positive', 'apply', 'kerja', 'unduh', 'aplikasi', 'mengembangkan', 'ilmu', 'pengetahuan', 'seputar', 'dunia', 'kerja', 'i', 'love', 'so', 'much']",30,16,14,aplikasi positive apply kerja unduh aplikasi kembang ilmu tahu putar dunia kerja i love so much,16,16
"sangattt membantu..... tapi bagus nya yg benar untuk pencari kerja, karna banyak yang selalu bukan info loker yang benar.",positif,2020-09-01,2020,sangattt membantu tapi bagus nya yg benar untuk pencari kerja karna banyak yang selalu bukan info loker yang benar,19,19,sangattt membantu tapi bagus nya yang benar untuk pencari kerja karena banyak yang selalu bukan informasi loker yang benar,19,19,"['sangattt', 'membantu', 'tapi', 'bagus', 'nya', 'yang', 'benar', 'untuk', 'pencari', 'kerja', 'karena', 'banyak', 'yang', 'selalu', 'bukan', 'informasi', 'loker', 'yang', 'benar']","['sangattt', 'membantu', 'bagus', 'nya', 'pencari', 'kerja', 'informasi', 'loker']",19,8,11,sangattt bantu bagus nya cari kerja informasi loker,8,8
"kenapa deh gak bisa login mulu padahal ada keperluan buat tugas, gimana solusinya buat secepatnya nihhhh udah buat akun ke 2 malah dibatasin lagi",negatif,2023-08-17,2023,kenapa deh gak bisa login mulu padahal ada keperluan buat tugas gimana solusinya buat secepatnya nihhhh udah buat akun ke malah dibatasin lagi,24,23,kenapa deh tidak bisa login mulu padahal ada keperluan buat tugas bagaimana solusinya buat secepatnya nihhhh sudah buat akun ke bahkan dibatasin lagi,23,23,"['kenapa', 'deh', 'tidak', 'bisa', 'login', 'mulu', 'padahal', 'ada', 'keperluan', 'buat', 'tugas', 'bagaimana', 'solusinya', 'buat', 'secepatnya', 'nihhhh', 'sudah', 'buat', 'akun', 'ke', 'bahkan', 'dibatasin', 'lagi']","['deh', 'tidak', 'login', 'mulu', 'keperluan', 'tugas', 'solusinya', 'secepatnya', 'nihhhh', 'akun', 'dibatasin']",23,11,12,deh tidak login mulu perlu tugas solusi cepat nihhhh akun dibatasin,11,11
"Dua kali bikin akun, dua kali akun di nonaktifkan, padahal gak pernah bukan apps juga tiba2 log out sendiri. The best lah",negatif,2021-08-17,2021,dua kali bikin akun dua kali akun di nonaktifkan padahal gak pernah bukan apps juga tiba log out sendiri the best lah,22,22,dua kali bikin akun dua kali akun di nonaktifkan padahal tidak pernah bukan aplikasi juga tiba log out sendiri the terbaik lah,22,22,"['dua', 'kali', 'bikin', 'akun', 'dua', 'kali', 'akun', 'di', 'nonaktifkan', 'padahal', 'tidak', 'pernah', 'bukan', 'aplikasi', 'juga', 'tiba', 'log', 'out', 'sendiri', 'the', 'terbaik', 'lah']","['kali', 'bikin', 'akun', 'kali', 'akun', 'nonaktifkan', 'tidak', 'aplikasi', 'log', 'out', 'the', 'terbaik']",22,12,10,kali bikin akun kali akun nonaktif tidak aplikasi log out the baik,12,12
"susah verifikasi, tidak bisa digunakan diluar indonesia, susah sign in ,dan buffering aplikasinya gerak lambat",negatif,2022-05-13,2022,susah verifikasi tidak bisa digunakan diluar indonesia susah sign in dan buffering aplikasinya gerak lambat,15,15,susah verifikasi tidak bisa digunakan diluar indonesia susah sign in dan buffering aplikasi nya gerak lambat,15,16,"['susah', 'verifikasi', 'tidak', 'bisa', 'digunakan', 'diluar', 'indonesia', 'susah', 'sign', 'in', 'dan', 'buffering', 'aplikasi', 'nya', 'gerak', 'lambat']","['susah', 'verifikasi', 'tidak', 'diluar', 'indonesia', 'susah', 'sign', 'in', 'buffering', 'aplikasi', 'nya', 'gerak', 'lambat']",16,13,3,susah verifikasi tidak luar indonesia susah sign in buffering aplikasi nya gerak lambat,13,13
Susah mau login udah verivikasi selalu gagal gmn se aplikasi ini awlnya enak gk tau tiba tiba eror dan susah untuk login. Perbaiki lah min,negatif,2023-06-03,2023,susah mau login udah verivikasi selalu gagal gmn se aplikasi ini awlnya enak gk tau tiba tiba eror dan susah untuk login perbaiki lah min,25,25,susah mau login sudah verivikasi selalu gagal bagaimana se aplikasi ini awlnya enak tidak tahu tiba tiba error dan susah untuk login perbaikan lah minimal,25,25,"['susah', 'mau', 'login', 'sudah', 'verivikasi', 'selalu', 'gagal', 'bagaimana', 'se', 'aplikasi', 'ini', 'awlnya', 'enak', 'tidak', 'tahu', 'tiba', 'tiba', 'error', 'dan', 'susah', 'untuk', 'login', 'perbaikan', 'lah', 'minimal']","['susah', 'login', 'verivikasi', 'gagal', 'aplikasi', 'awlnya', 'enak', 'tidak', 'error', 'susah', 'login', 'perbaikan', 'minimal']",25,13,12,susah login verivikasi gagal aplikasi awlnya enak tidak error susah login baik minimal,13,13
"Tiba tiba dibatasi, padahal tidak melakukan pelanggaran dan ini akun baru juga, g ngerti sama sekali!!! Terima kasih LinkedIn sudah membuat saya terhambat",negatif,2023-10-13,2023,tiba tiba dibatasi padahal tidak melakukan pelanggaran dan ini akun baru juga g ngerti sama sekali terima kasih linkedin sudah membuat saya terhambat,23,23,tiba tiba dibatasi padahal tidak melakukan pelanggaran dan ini akun baru juga tidak mengerti sama sekali terima kasih linkedin sudah membuat saya terhambat,23,23,"['tiba', 'tiba', 'dibatasi', 'padahal', 'tidak', 'melakukan', 'pelanggaran', 'dan', 'ini', 'akun', 'baru', 'juga', 'tidak', 'mengerti', 'sama', 'sekali', 'terima', 'kasih', 'linkedin', 'sudah', 'membuat', 'saya', 'terhambat']","['dibatasi', 'tidak', 'pelanggaran', 'akun', 'tidak', 'mengerti', 'terima', 'kasih', 'linkedin', 'terhambat']",23,10,13,batas tidak langgar akun tidak erti terima kasih linkedin hambat,10,10
"Buka aplikasi disuruh verifikasi captcha terus, udah dijawab benar tapi katanya tidak valid terus. Aplikasi rusak",negatif,2023-07-25,2023,buka aplikasi disuruh verifikasi captcha terus udah dijawab benar tapi katanya tidak valid terus aplikasi rusak,16,16,buka aplikasi disuruh verifikasi captcha terus sudah dijawab benar tapi katanya tidak valid terus aplikasi rusak,16,16,"['buka', 'aplikasi', 'disuruh', 'verifikasi', 'captcha', 'terus', 'sudah', 'dijawab', 'benar', 'tapi', 'katanya', 'tidak', 'valid', 'terus', 'aplikasi', 'rusak']","['buka', 'aplikasi', 'disuruh', 'verifikasi', 'captcha', 'tidak', 'valid', 'aplikasi', 'rusak']",16,9,7,buka aplikasi suruh verifikasi captcha tidak valid aplikasi rusak,9,9
Situs khusus untuk pencari kerja dan pencari pekerja. Yang berkomunikasi dan berinteraksi langsung. Bagus dan perlu.,positif,2021-11-06,2021,situs khusus untuk pencari kerja dan pencari pekerja yang berkomunikasi dan berinteraksi langsung bagus dan perlu,16,16,situs khusus untuk pencari kerja dan pencari yang kerja yang berkomunikasi dan berinteraksi langsung bagus dan perlu,16,17,"['situs', 'khusus', 'untuk', 'pencari', 'kerja', 'dan', 'pencari', 'yang', 'kerja', 'yang', 'berkomunikasi', 'dan', 'berinteraksi', 'langsung', 'bagus', 'dan', 'perlu']","['situs', 'khusus', 'pencari', 'kerja', 'pencari', 'kerja', 'berkomunikasi', 'berinteraksi', 'langsung', 'bagus']",17,10,7,situs khusus cari kerja cari kerja komunikasi interaksi langsung bagus,10,10
"Woo satu satu nya yang membantu dalam pertemanan di seluruh dunia .. menambah wawasan yang penuh dengan dunia dunia baru baik sejara,film,music, lagu, pendidikan dll.",positif,2021-11-06,2021,woo satu satu nya yang membantu dalam pertemanan di seluruh dunia menambah wawasan yang penuh dengan dunia dunia baru baik sejara film music lagu pendidikan dll,25,26,woo satu satu nya yang membantu dalam pertemanan di seluruh dunia menambah wawasan yang penuh dengan dunia dunia baru baik sejara film music lagu pendidikan dan lain lain,26,28,"['woo', 'satu', 'satu', 'nya', 'yang', 'membantu', 'dalam', 'pertemanan', 'di', 'seluruh', 'dunia', 'menambah', 'wawasan', 'yang', 'penuh', 'dengan', 'dunia', 'dunia', 'baru', 'baik', 'sejara', 'film', 'music', 'lagu', 'pendidikan', 'dan', 'lain', 'lain']","['woo', 'nya', 'membantu', 'pertemanan', 'dunia', 'menambah', 'wawasan', 'penuh', 'dunia', 'dunia', 'sejara', 'film', 'music', 'lagu', 'pendidikan']",28,15,13,woo nya bantu teman dunia tambah wawas penuh dunia dunia jara film music lagu didik,15,15
Inii kenapa sihh. Aplikasi ny close sendiri muluuu. Mau up foto susah kali. Berkali-kali close sendiri,negatif,2023-06-19,2023,inii kenapa sihh aplikasi ny close sendiri muluuu mau up foto susah kali berkali kali close sendiri,16,17,inii kenapa sih aplikasi nya close sendiri muluuu mau up foto susah kali berkali kali close sendiri,17,17,"['inii', 'kenapa', 'sih', 'aplikasi', 'nya', 'close', 'sendiri', 'muluuu', 'mau', 'up', 'foto', 'susah', 'kali', 'berkali', 'kali', 'close', 'sendiri']","['inii', 'sih', 'aplikasi', 'nya', 'close', 'muluuu', 'up', 'foto', 'susah', 'kali', 'berkali', 'kali', 'close']",17,13,4,ini sih aplikasi nya close muluuu up foto susah kali kali kali close,13,13
"Susah daftarnya, udah masukin no hp disuruh ngulang pas udah dimasukin lagi jadi gak bisa di gunakan, dicoba login akunnya gak ada...",negatif,2021-09-17,2021,susah daftarnya udah masukin no hp disuruh ngulang pas udah dimasukin lagi jadi gak bisa di gunakan dicoba login akunnya gak ada,22,22,susah daftarnya sudah masukkan nomor handphone disuruh mengulang pas sudah di masuk in lagi jadi tidak bisa di gunakan dicoba login akunnya tidak ada,22,24,"['susah', 'daftarnya', 'sudah', 'masukkan', 'nomor', 'handphone', 'disuruh', 'mengulang', 'pas', 'sudah', 'di', 'masuk', 'in', 'lagi', 'jadi', 'tidak', 'bisa', 'di', 'gunakan', 'dicoba', 'login', 'akunnya', 'tidak', 'ada']","['susah', 'daftarnya', 'masukkan', 'nomor', 'handphone', 'disuruh', 'mengulang', 'pas', 'masuk', 'in', 'tidak', 'dicoba', 'login', 'akunnya', 'tidak']",24,15,9,susah daftar masuk nomor handphone suruh ulang pas masuk in tidak coba login akun tidak,15,15
"Verifikasi apa coba gak jelas login ya tinggal login apa susahnya ribet amat1 jam gak masuk masuk , verifikasi terus tebak gambar",negatif,2023-05-15,2023,verifikasi apa coba gak jelas login ya tinggal login apa susahnya ribet amat jam gak masuk masuk verifikasi terus tebak gambar,22,21,verifikasi apa coba tidak jelas login ya tinggal login apa susahnya rumit amat jam tidak masuk masuk verifikasi terus tebak gambar,21,21,"['verifikasi', 'apa', 'coba', 'tidak', 'jelas', 'login', 'ya', 'tinggal', 'login', 'apa', 'susahnya', 'rumit', 'amat', 'jam', 'tidak', 'masuk', 'masuk', 'verifikasi', 'terus', 'tebak', 'gambar']","['verifikasi', 'coba', 'tidak', 'login', 'ya', 'tinggal', 'login', 'susahnya', 'rumit', 'jam', 'tidak', 'masuk', 'masuk', 'verifikasi', 'tebak', 'gambar']",21,16,5,verifikasi coba tidak login ya tinggal login susah rumit jam tidak masuk masuk verifikasi tebak gambar,16,16
"verifikasi terlalu susah, cukup verif email saja nggak perlu gambar gambar aneh seperti itu, tesnya lebih sulit daripada sbmptn",negatif,2022-03-06,2022,verifikasi terlalu susah cukup verif email saja nggak perlu gambar gambar aneh seperti itu tesnya lebih sulit daripada sbmptn,19,19,verifikasi terlalu susah cukup verif email saja tidak perlu gambar gambar aneh seperti itu tesnya lebih sulit daripada sbmptn,19,19,"['verifikasi', 'terlalu', 'susah', 'cukup', 'verif', 'email', 'saja', 'tidak', 'perlu', 'gambar', 'gambar', 'aneh', 'seperti', 'itu', 'tesnya', 'lebih', 'sulit', 'daripada', 'sbmptn']","['verifikasi', 'susah', 'verif', 'email', 'tidak', 'gambar', 'gambar', 'aneh', 'tesnya', 'sulit', 'sbmptn']",19,11,8,verifikasi susah verif email tidak gambar gambar aneh tes sulit sbmptn,11,11
Aplikasi yg sangat membantu untuk mencari pekerjaan..membangun Relasi & informasi yg sangat Luas.,positif,2021-04-28,2021,aplikasi yg sangat membantu untuk mencari pekerjaan membangun relasi informasi yg sangat luas,13,13,aplikasi yang sangat membantu untuk mencari pekerjaan membangun relasi informasi yang sangat luas,13,13,"['aplikasi', 'yang', 'sangat', 'membantu', 'untuk', 'mencari', 'pekerjaan', 'membangun', 'relasi', 'informasi', 'yang', 'sangat', 'luas']","['aplikasi', 'membantu', 'mencari', 'pekerjaan', 'membangun', 'relasi', 'informasi', 'luas']",13,8,5,aplikasi bantu cari kerja bangun relasi informasi luas,8,8
Tolong. Saya mau login pakai gmail nggak bisa bisa. Udah saya update uninstal turus coba instal dan mau login nggak bisa bisa.,negatif,2022-01-25,2022,tolong saya mau login pakai gmail nggak bisa bisa udah saya update uninstal turus coba instal dan mau login nggak bisa bisa,22,22,tolong saya mau login pakai gmail tidak bisa bisa sudah saya diperbarui hapus instalan turus coba memasang dan mau login tidak bisa bisa,22,23,"['tolong', 'saya', 'mau', 'login', 'pakai', 'gmail', 'tidak', 'bisa', 'bisa', 'sudah', 'saya', 'diperbarui', 'hapus', 'instalan', 'turus', 'coba', 'memasang', 'dan', 'mau', 'login', 'tidak', 'bisa', 'bisa']","['tolong', 'login', 'pakai', 'gmail', 'tidak', 'diperbarui', 'hapus', 'instalan', 'turus', 'coba', 'memasang', 'login', 'tidak']",23,13,10,tolong login pakai gmail tidak baru hapus instalan turus coba pasang login tidak,13,13
Aplikasi yg Mantap .kita bisa beselancar keman kita mau bisa bertemu teman- teman..pokoknya mantap keren.👍👍,positif,2020-10-21,2020,aplikasi yg mantap kita bisa beselancar keman kita mau bisa bertemu teman teman pokoknya mantap keren,15,16,aplikasi yang mantap kita bisa beselancar ke mana kita mau bisa bertemu teman teman pokoknya mantap keren,16,17,"['aplikasi', 'yang', 'mantap', 'kita', 'bisa', 'beselancar', 'ke', 'mana', 'kita', 'mau', 'bisa', 'bertemu', 'teman', 'teman', 'pokoknya', 'mantap', 'keren']","['aplikasi', 'mantap', 'beselancar', 'bertemu', 'teman', 'teman', 'pokoknya', 'mantap', 'keren']",17,9,8,aplikasi mantap beselancar temu teman teman pokok mantap keren,9,9
Linkedln Aplikasi yg baik...membantu banget buat para pencari kerja maupun buat para pekerja untuk membangun komunikasi dengan baik,positif,2020-09-23,2020,linkedln aplikasi yg baik membantu banget buat para pencari kerja maupun buat para pekerja untuk membangun komunikasi dengan baik,18,19,linkedln aplikasi yang baik membantu banget buat para pencari kerja maupun buat para yang kerja untuk membangun komunikasi dengan baik,19,20,"['linkedln', 'aplikasi', 'yang', 'baik', 'membantu', 'banget', 'buat', 'para', 'pencari', 'kerja', 'maupun', 'buat', 'para', 'yang', 'kerja', 'untuk', 'membangun', 'komunikasi', 'dengan', 'baik']","['linkedln', 'aplikasi', 'membantu', 'banget', 'pencari', 'kerja', 'kerja', 'membangun', 'komunikasi']",20,9,11,linkedln aplikasi bantu banget cari kerja kerja bangun komunikasi,9,9
"Aplikasi yang bagus dan kerrenn. Terimakasih LinkedIn, sangat membantu sekali dalam komunikasi dengan orang orang hebat.",positif,2023-01-01,2023,aplikasi yang bagus dan kerrenn terimakasih linkedin sangat membantu sekali dalam komunikasi dengan orang orang hebat,16,16,aplikasi yang bagus dan kerrenn terima kasih linkedin sangat membantu sekali dalam komunikasi dengan orang orang hebat,16,17,"['aplikasi', 'yang', 'bagus', 'dan', 'kerrenn', 'terima', 'kasih', 'linkedin', 'sangat', 'membantu', 'sekali', 'dalam', 'komunikasi', 'dengan', 'orang', 'orang', 'hebat']","['aplikasi', 'bagus', 'kerrenn', 'terima', 'kasih', 'linkedin', 'membantu', 'komunikasi', 'orang', 'orang', 'hebat']",17,11,6,aplikasi bagus kerrenn terima kasih linkedin bantu komunikasi orang orang hebat,11,11
Kok saya ga bisa masuk lewat app ini ya? Katanya alamat email saya ga terdaftar. Padahal kalau lwt web bisa masuk. Mohon arahannya. (Bintang akan berubah apabila direspon),negatif,2021-02-01,2021,kok saya ga bisa masuk lewat app ini ya katanya alamat email saya ga terdaftar padahal kalau lwt web bisa masuk mohon arahannya bintang akan berubah apabila direspon,28,28,kok saya tidak bisa masuk lewat aplikasi ini ya katanya alamat email saya tidak terdaftar padahal kalau lwt web bisa masuk mohon arahannya bintang akan berubah apabila direspons,28,28,"['kok', 'saya', 'tidak', 'bisa', 'masuk', 'lewat', 'aplikasi', 'ini', 'ya', 'katanya', 'alamat', 'email', 'saya', 'tidak', 'terdaftar', 'padahal', 'kalau', 'lwt', 'web', 'bisa', 'masuk', 'mohon', 'arahannya', 'bintang', 'akan', 'berubah', 'apabila', 'direspons']","['tidak', 'masuk', 'aplikasi', 'ya', 'alamat', 'email', 'tidak', 'terdaftar', 'lwt', 'web', 'masuk', 'mohon', 'arahannya', 'bintang', 'berubah', 'direspons']",28,16,12,tidak masuk aplikasi ya alamat email tidak daftar lwt web masuk mohon arah bintang ubah respons,16,16
"LinkedIn sangat bermanfaat untuk banyak kalangan, bukan hanya untuk praktisi HR dan pencari kerja.. namun juga menjangkau yang lain.",positif,2024-01-02,2024,linkedin sangat bermanfaat untuk banyak kalangan bukan hanya untuk praktisi hr dan pencari kerja namun juga menjangkau yang lain,19,19,linkedin sangat bermanfaat untuk banyak kalangan bukan hanya untuk praktisi hari dan pencari kerja namun juga menjangkau yang lain,19,19,"['linkedin', 'sangat', 'bermanfaat', 'untuk', 'banyak', 'kalangan', 'bukan', 'hanya', 'untuk', 'praktisi', 'hari', 'dan', 'pencari', 'kerja', 'namun', 'juga', 'menjangkau', 'yang', 'lain']","['linkedin', 'bermanfaat', 'kalangan', 'praktisi', 'pencari', 'kerja', 'menjangkau']",19,7,12,linkedin manfaat kalang praktisi cari kerja jangkau,7,7
"Apaan coba mau daftar aja susah, pilih gambar padahal sudah benar tapi masih dibilang salah.",negatif,2021-09-28,2021,apaan coba mau daftar aja susah pilih gambar padahal sudah benar tapi masih dibilang salah,15,15,apa coba mau daftar saja susah pilih gambar padahal sudah benar tapi masih dibilang salah,15,15,"['apa', 'coba', 'mau', 'daftar', 'saja', 'susah', 'pilih', 'gambar', 'padahal', 'sudah', 'benar', 'tapi', 'masih', 'dibilang', 'salah']","['coba', 'daftar', 'susah', 'pilih', 'gambar', 'dibilang', 'salah']",15,7,8,coba daftar susah pilih gambar bilang salah,7,7
"Luar biasa , aplikasi yang mengupgrade, memperkaya wawasan kita di dunia kerja. Sekaligus aplikasi ini menambah networking kita 👍🏻. Terbaik pokoknya",positif,2020-06-22,2020,luar biasa aplikasi yang mengupgrade memperkaya wawasan kita di dunia kerja sekaligus aplikasi ini menambah networking kita terbaik pokoknya,21,19,luar biasa aplikasi yang mengupgrade memperkaya wawasan kita di dunia kerja sekaligus aplikasi ini menambah networking kita terbaik pokoknya,19,19,"['luar', 'biasa', 'aplikasi', 'yang', 'mengupgrade', 'memperkaya', 'wawasan', 'kita', 'di', 'dunia', 'kerja', 'sekaligus', 'aplikasi', 'ini', 'menambah', 'networking', 'kita', 'terbaik', 'pokoknya']","['aplikasi', 'mengupgrade', 'memperkaya', 'wawasan', 'dunia', 'kerja', 'aplikasi', 'menambah', 'networking', 'terbaik', 'pokoknya']",19,11,8,aplikasi mengupgrade kaya wawas dunia kerja aplikasi tambah networking baik pokok,11,11
"Verifikasinya gak jelas, sudah berkali kali tetep aja gagal, mempersulit untuk login",negatif,2023-05-09,2023,verifikasinya gak jelas sudah berkali kali tetep aja gagal mempersulit untuk login,12,12,verifikasinya tidak jelas sudah berkali kali tetap saja gagal mempersulit untuk login,12,12,"['verifikasinya', 'tidak', 'jelas', 'sudah', 'berkali', 'kali', 'tetap', 'saja', 'gagal', 'mempersulit', 'untuk', 'login']","['verifikasinya', 'tidak', 'berkali', 'kali', 'gagal', 'mempersulit', 'login']",12,7,5,verifikasi tidak kali kali gagal sulit login,7,7
"aplikasi yang sangat bagus, banyak pembelajaran dan motivasi karena terkoneksi dengan para profesional di bidang pekerjaan masing2",positif,2020-07-23,2020,aplikasi yang sangat bagus banyak pembelajaran dan motivasi karena terkoneksi dengan para profesional di bidang pekerjaan masing,17,17,aplikasi yang sangat bagus banyak pembelajaran dan motivasi karena terkoneksi dengan para profesional di bidang pekerjaan masing,17,17,"['aplikasi', 'yang', 'sangat', 'bagus', 'banyak', 'pembelajaran', 'dan', 'motivasi', 'karena', 'terkoneksi', 'dengan', 'para', 'profesional', 'di', 'bidang', 'pekerjaan', 'masing']","['aplikasi', 'bagus', 'pembelajaran', 'motivasi', 'terkoneksi', 'profesional', 'bidang', 'pekerjaan']",17,8,9,aplikasi bagus ajar motivasi koneksi profesional bidang kerja,8,8
"Banyak motivasi dan hal yg luar biasa yg dapat diambil dari beberapa pengalaman..yg sudah berbagi baik suka duka, pengorbanan maupun kesuksesan..bisa dijadikan semangat yg lain ..",positif,2021-10-22,2021,banyak motivasi dan hal yg luar biasa yg dapat diambil dari beberapa pengalaman yg sudah berbagi baik suka duka pengorbanan maupun kesuksesan bisa dijadikan semangat yg lain,26,27,banyak motivasi dan hal yang luar biasa yang dapat diambil dari beberapa pengalaman yang sudah berbagi baik suka duka pengorbanan maupun kesuksesan bisa dijadikan semangat yang lain,27,27,"['banyak', 'motivasi', 'dan', 'hal', 'yang', 'luar', 'biasa', 'yang', 'dapat', 'diambil', 'dari', 'beberapa', 'pengalaman', 'yang', 'sudah', 'berbagi', 'baik', 'suka', 'duka', 'pengorbanan', 'maupun', 'kesuksesan', 'bisa', 'dijadikan', 'semangat', 'yang', 'lain']","['motivasi', 'diambil', 'pengalaman', 'berbagi', 'suka', 'duka', 'pengorbanan', 'kesuksesan', 'dijadikan', 'semangat']",27,10,17,motivasi ambil alam bagi suka duka korban sukses jadi semangat,10,10
Bingung banget mau login ulang gimana.. Selalu nama atau pass salah.. Padahal udah diulang berkali2 dengan pass yang betul,negatif,2022-06-26,2022,bingung banget mau login ulang gimana selalu nama atau pass salah padahal udah diulang berkali dengan pass yang betul,19,19,bingung banget mau login ulang bagaimana selalu nama atau pass salah padahal sudah diulang berkali dengan pass yang betul,19,19,"['bingung', 'banget', 'mau', 'login', 'ulang', 'bagaimana', 'selalu', 'nama', 'atau', 'pass', 'salah', 'padahal', 'sudah', 'diulang', 'berkali', 'dengan', 'pass', 'yang', 'betul']","['bingung', 'banget', 'login', 'ulang', 'nama', 'pass', 'salah', 'diulang', 'berkali', 'pass']",19,10,9,bingung banget login ulang nama pass salah ulang kali pass,10,10
"Akun tiba-tiba tidak bisa di akses. Udah 2 kali buat akun, selalu kena banned permanen. Mau buat akun lagi, login harus selalu verifikasi.",negatif,2023-08-04,2023,akun tiba tiba tidak bisa di akses udah kali buat akun selalu kena banned permanen mau buat akun lagi login harus selalu verifikasi,23,23,akun tiba tiba tidak bisa di akses sudah kali buat akun selalu kena banned permanen mau buat akun lagi login harus selalu verifikasi,23,23,"['akun', 'tiba', 'tiba', 'tidak', 'bisa', 'di', 'akses', 'sudah', 'kali', 'buat', 'akun', 'selalu', 'kena', 'banned', 'permanen', 'mau', 'buat', 'akun', 'lagi', 'login', 'harus', 'selalu', 'verifikasi']","['akun', 'tidak', 'akses', 'kali', 'akun', 'kena', 'banned', 'permanen', 'akun', 'login', 'verifikasi']",23,11,12,akun tidak akses kali akun kena banned permanen akun login verifikasi,11,11
"Saya tidak bisa daftar, sangat aneh, padahal saya sudah memasukkan kode yang dikirim oleh pihak linked in bintang 1 untuk aplikasi ini",negatif,2022-08-16,2022,saya tidak bisa daftar sangat aneh padahal saya sudah memasukkan kode yang dikirim oleh pihak linked in bintang untuk aplikasi ini,22,21,saya tidak bisa daftar sangat aneh padahal saya sudah memasukkan kode yang dikirim oleh pihak linked in bintang untuk aplikasi ini,21,21,"['saya', 'tidak', 'bisa', 'daftar', 'sangat', 'aneh', 'padahal', 'saya', 'sudah', 'memasukkan', 'kode', 'yang', 'dikirim', 'oleh', 'pihak', 'linked', 'in', 'bintang', 'untuk', 'aplikasi', 'ini']","['tidak', 'daftar', 'aneh', 'memasukkan', 'kode', 'dikirim', 'linked', 'in', 'bintang', 'aplikasi']",21,10,11,tidak daftar aneh masuk kode kirim linked in bintang aplikasi,10,10
Foto profil user lain tidak muncul padahal sudah diupdate terus aplikasinya. Lowongan pekerjaan di LinkedIn tidak sebanyak pilihannya seperti di Jobstreet. Payah,negatif,2023-03-23,2023,foto profil user lain tidak muncul padahal sudah diupdate terus aplikasinya lowongan pekerjaan di linkedin tidak sebanyak pilihannya seperti di jobstreet payah,22,22,foto profil user lain tidak muncul padahal sudah di perbarui terus aplikasi nya lowongan pekerjaan di linkedin tidak sebanyak pilihannya seperti di jobstreet payah,22,24,"['foto', 'profil', 'user', 'lain', 'tidak', 'muncul', 'padahal', 'sudah', 'di', 'perbarui', 'terus', 'aplikasi', 'nya', 'lowongan', 'pekerjaan', 'di', 'linkedin', 'tidak', 'sebanyak', 'pilihannya', 'seperti', 'di', 'jobstreet', 'payah']","['foto', 'profil', 'user', 'tidak', 'muncul', 'perbarui', 'aplikasi', 'nya', 'lowongan', 'pekerjaan', 'linkedin', 'tidak', 'pilihannya', 'jobstreet', 'payah']",24,15,9,foto profil user tidak muncul baru aplikasi nya lowong kerja linkedin tidak pilih jobstreet payah,15,15
"Aneh ni apk banyak error, mempersulit gw pengen verifikasi aja susah nya minta ampun hadehhhhh!!!!",negatif,2024-03-02,2024,aneh ni apk banyak error mempersulit gw pengen verifikasi aja susah nya minta ampun hadehhhhh,15,15,aneh ini aplikasi banyak error mempersulit saya pengen verifikasi saja susah nya minta ampun hadehhhhh,15,15,"['aneh', 'ini', 'aplikasi', 'banyak', 'error', 'mempersulit', 'saya', 'pengen', 'verifikasi', 'saja', 'susah', 'nya', 'minta', 'ampun', 'hadehhhhh']","['aneh', 'aplikasi', 'error', 'mempersulit', 'pengen', 'verifikasi', 'susah', 'nya', 'ampun', 'hadehhhhh']",15,10,5,aneh aplikasi error sulit ken verifikasi susah nya ampun hadehhhhh,10,10
Aplikasi yang bagus bila ingin berkenalan dam membangun relasi dengan para profesional dan mencari pekerjaan.,positif,2024-02-26,2024,aplikasi yang bagus bila ingin berkenalan dam membangun relasi dengan para profesional dan mencari pekerjaan,15,15,aplikasi yang bagus bila ingin berkenalan dam membangun relasi dengan para profesional dan mencari pekerjaan,15,15,"['aplikasi', 'yang', 'bagus', 'bila', 'ingin', 'berkenalan', 'dam', 'membangun', 'relasi', 'dengan', 'para', 'profesional', 'dan', 'mencari', 'pekerjaan']","['aplikasi', 'bagus', 'berkenalan', 'dam', 'membangun', 'relasi', 'profesional', 'mencari', 'pekerjaan']",15,9,6,aplikasi bagus nal dam bangun relasi profesional cari kerja,9,9
"Pilih gambar yg Menghadap atas. Padahal sdh sesuai contoh, katanya masih kosong. Dan ngulang lagi dan lagi, akhirnya. Capek.",negatif,2023-11-07,2023,pilih gambar yg menghadap atas padahal sdh sesuai contoh katanya masih kosong dan ngulang lagi dan lagi akhirnya capek,19,19,pilih gambar yang menghadap atas padahal sudah sesuai contoh katanya masih kosong dan mengulang lagi dan lagi akhirnya capek,19,19,"['pilih', 'gambar', 'yang', 'menghadap', 'atas', 'padahal', 'sudah', 'sesuai', 'contoh', 'katanya', 'masih', 'kosong', 'dan', 'mengulang', 'lagi', 'dan', 'lagi', 'akhirnya', 'capek']","['pilih', 'gambar', 'menghadap', 'sesuai', 'contoh', 'kosong', 'mengulang', 'capek']",19,8,11,pilih gambar hadap sesuai contoh kosong ulang capek,8,8
"Untuk filter lokasi lowongan pekerjaan, tolong tambahkan untuk area Makassar. Terimakasih",negatif,2021-05-29,2021,untuk filter lokasi lowongan pekerjaan tolong tambahkan untuk area makassar terimakasih,11,11,untuk filter lokasi lowongan pekerjaan tolong tambahkan untuk area makassar terima kasih,11,12,"['untuk', 'filter', 'lokasi', 'lowongan', 'pekerjaan', 'tolong', 'tambahkan', 'untuk', 'area', 'makassar', 'terima', 'kasih']","['filter', 'lokasi', 'lowongan', 'pekerjaan', 'tolong', 'tambahkan', 'area', 'makassar', 'terima', 'kasih']",12,10,2,filter lokasi lowong kerja tolong tambah area makassar terima kasih,10,10
Ini gimana sih. Masa mau verfikasi salah terus. Padahal udah mencet gambar yg menghadap keatas🖕🖕🖕,negatif,2022-02-19,2022,ini gimana sih masa mau verfikasi salah terus padahal udah mencet gambar yg menghadap keatas,15,15,ini bagaimana sih masa mau verfikasi salah terus padahal sudah mencet gambar yang menghadap keatas,15,15,"['ini', 'bagaimana', 'sih', 'masa', 'mau', 'verfikasi', 'salah', 'terus', 'padahal', 'sudah', 'mencet', 'gambar', 'yang', 'menghadap', 'keatas']","['sih', 'verfikasi', 'salah', 'mencet', 'gambar', 'menghadap', 'keatas']",15,7,8,sih verfikasi salah mencet gambar hadap atas,7,7
Mohon diperbaiki masalah postingan LinkedIn. Saya seharian mau post foto tidak bisa. Padahal kemarin tidak ada masalah.,negatif,2022-04-29,2022,mohon diperbaiki masalah postingan linkedin saya seharian mau post foto tidak bisa padahal kemarin tidak ada masalah,17,17,mohon di perbaiki masalah postingan linkedin saya seharian mau post foto tidak bisa padahal kemarin tidak ada masalah,17,18,"['mohon', 'di', 'perbaiki', 'masalah', 'postingan', 'linkedin', 'saya', 'seharian', 'mau', 'post', 'foto', 'tidak', 'bisa', 'padahal', 'kemarin', 'tidak', 'ada', 'masalah']","['mohon', 'perbaiki', 'postingan', 'linkedin', 'seharian', 'post', 'foto', 'tidak', 'kemarin', 'tidak']",18,10,8,mohon baik postingan linkedin hari post foto tidak kemarin tidak,10,10
"Andaikan tidak wajib mempunyai pengalaman pekerjaan, berhubung saya mahasiswa yang pintar saya hanya beri 2 bintang saja. Tq 4 ur apk :)",negatif,2022-02-14,2022,andaikan tidak wajib mempunyai pengalaman pekerjaan berhubung saya mahasiswa yang pintar saya hanya beri bintang saja tq ur apk,22,19,andaikan tidak wajib mempunyai pengalaman pekerjaan berhubung saya mahasiswa yang pintar saya hanya beri bintang saja terima kasih ur aplikasi,19,20,"['andaikan', 'tidak', 'wajib', 'mempunyai', 'pengalaman', 'pekerjaan', 'berhubung', 'saya', 'mahasiswa', 'yang', 'pintar', 'saya', 'hanya', 'beri', 'bintang', 'saja', 'terima', 'kasih', 'ur', 'aplikasi']","['andaikan', 'tidak', 'wajib', 'pengalaman', 'pekerjaan', 'berhubung', 'mahasiswa', 'pintar', 'bintang', 'terima', 'kasih', 'ur', 'aplikasi']",20,13,7,andai tidak wajib alam kerja hubung mahasiswa pintar bintang terima kasih ur aplikasi,13,13
Aplikasi yang terbaik dibidang ya serta sangat bermanfaat dengan berbagai aneka bidang ilmu dan lapangan kerja,positif,2022-10-08,2022,aplikasi yang terbaik dibidang ya serta sangat bermanfaat dengan berbagai aneka bidang ilmu dan lapangan kerja,16,16,aplikasi yang terbaik dibidang ya serta sangat bermanfaat dengan berbagai aneka bidang ilmu dan lapangan kerja,16,16,"['aplikasi', 'yang', 'terbaik', 'dibidang', 'ya', 'serta', 'sangat', 'bermanfaat', 'dengan', 'berbagai', 'aneka', 'bidang', 'ilmu', 'dan', 'lapangan', 'kerja']","['aplikasi', 'terbaik', 'dibidang', 'ya', 'bermanfaat', 'aneka', 'bidang', 'ilmu', 'lapangan', 'kerja']",16,10,6,aplikasi baik bidang ya manfaat aneka bidang ilmu lapang kerja,10,10
"Perbaiki sytem dan bug, buat shortcut untuk mempermudah akses, aplikasi terkenal tapi kurang memuaskan,",negatif,2020-04-27,2020,perbaiki sytem dan bug buat shortcut untuk mempermudah akses aplikasi terkenal tapi kurang memuaskan,14,14,perbaikan sytem dan bug buat shortcut untuk mempermudah akses aplikasi terkenal tapi kurang memuaskan,14,14,"['perbaikan', 'sytem', 'dan', 'bug', 'buat', 'shortcut', 'untuk', 'mempermudah', 'akses', 'aplikasi', 'terkenal', 'tapi', 'kurang', 'memuaskan']","['perbaikan', 'sytem', 'bug', 'shortcut', 'mempermudah', 'akses', 'aplikasi', 'terkenal', 'memuaskan']",14,9,5,baik sytem bug shortcut mudah akses aplikasi kenal muas,9,9
Kenapa sih linkedin suka lama loadingnya. Kadang tiba-tiba tidak bisa loading. Sangat menganggu aktifitas sceoll 😑,negatif,2021-07-23,2021,kenapa sih linkedin suka lama loadingnya kadang tiba tiba tidak bisa loading sangat menganggu aktifitas sceoll,16,16,kenapa sih linkedin suka lama loading nya kadang tiba tiba tidak bisa loading sangat menganggu aktifitas sceoll,16,17,"['kenapa', 'sih', 'linkedin', 'suka', 'lama', 'loading', 'nya', 'kadang', 'tiba', 'tiba', 'tidak', 'bisa', 'loading', 'sangat', 'menganggu', 'aktifitas', 'sceoll']","['sih', 'linkedin', 'suka', 'loading', 'nya', 'kadang', 'tidak', 'loading', 'menganggu', 'aktifitas', 'sceoll']",17,11,6,sih linkedin suka loading nya kadang tidak loading menganggu aktifitas sceoll,11,11
"Aplikasi nya bagus, tapi sy akhir akhir ini ada kendala utk update. Mungkin Admin bisa bantu. Terimakasih",positif,2022-09-14,2022,aplikasi nya bagus tapi sy akhir akhir ini ada kendala utk update mungkin admin bisa bantu terimakasih,17,17,aplikasi nya bagus tapi saya akhir akhir ini ada kendala untuk diperbarui mungkin admin bisa bantu terima kasih,17,18,"['aplikasi', 'nya', 'bagus', 'tapi', 'saya', 'akhir', 'akhir', 'ini', 'ada', 'kendala', 'untuk', 'diperbarui', 'mungkin', 'admin', 'bisa', 'bantu', 'terima', 'kasih']","['aplikasi', 'nya', 'bagus', 'kendala', 'diperbarui', 'admin', 'bantu', 'terima', 'kasih']",18,9,9,aplikasi nya bagus kendala baru admin bantu terima kasih,9,9
Login gagal terus itu kenapa ya selalu masalah di verifikasi ganbar dan suara padahal saya ngisinya benar.,negatif,2023-07-18,2023,login gagal terus itu kenapa ya selalu masalah di verifikasi ganbar dan suara padahal saya ngisinya benar,17,17,login gagal terus itu kenapa ya selalu masalah di verifikasi ganbar dan suara padahal saya ngisinya benar,17,17,"['login', 'gagal', 'terus', 'itu', 'kenapa', 'ya', 'selalu', 'masalah', 'di', 'verifikasi', 'ganbar', 'dan', 'suara', 'padahal', 'saya', 'ngisinya', 'benar']","['login', 'gagal', 'ya', 'verifikasi', 'ganbar', 'suara', 'ngisinya']",17,7,10,login gagal ya verifikasi ganbar suara ngisinya,7,7
Saya kasih bintang ** karena ada masalah tidak bisa upload foto dan video. mohon untuk account saya di perbaiki. terimakasih sebelumnya.,negatif,2020-03-15,2020,saya kasih bintang karena ada masalah tidak bisa upload foto dan video mohon untuk account saya di perbaiki terimakasih sebelumnya,21,20,saya kasih bintang karena ada masalah tidak bisa unggah foto dan video mohon untuk akun saya di perbaikan terima kasih sebelumnya,20,21,"['saya', 'kasih', 'bintang', 'karena', 'ada', 'masalah', 'tidak', 'bisa', 'unggah', 'foto', 'dan', 'video', 'mohon', 'untuk', 'akun', 'saya', 'di', 'perbaikan', 'terima', 'kasih', 'sebelumnya']","['kasih', 'bintang', 'tidak', 'unggah', 'foto', 'video', 'mohon', 'akun', 'perbaikan', 'terima', 'kasih']",21,11,10,kasih bintang tidak unggah foto video mohon akun baik terima kasih,11,11
"Sangat membantu sekali untuk mengetahui perkembangan dunia n bisa punya teman di seluruh negara,,,",positif,2022-07-31,2022,sangat membantu sekali untuk mengetahui perkembangan dunia n bisa punya teman di seluruh negara,14,14,sangat membantu sekali untuk mengetahui perkembangan dunia dan bisa punya teman di seluruh negara,14,14,"['sangat', 'membantu', 'sekali', 'untuk', 'mengetahui', 'perkembangan', 'dunia', 'dan', 'bisa', 'punya', 'teman', 'di', 'seluruh', 'negara']","['membantu', 'perkembangan', 'dunia', 'teman', 'negara']",14,5,9,bantu kembang dunia teman negara,5,5
"Aplikasi payah mudah di banned,sering me non aktifkan account seseorang tanpa sebab dan tanpa peringatan termasuk saya salah satunya yang kena",negatif,2020-06-18,2020,aplikasi payah mudah di banned sering me non aktifkan account seseorang tanpa sebab dan tanpa peringatan termasuk saya salah satunya yang kena,21,22,aplikasi payah mudah di banned sering me non aktifkan akun seseorang tanpa sebab dan tanpa peringatan termasuk saya salah satunya yang kena,22,22,"['aplikasi', 'payah', 'mudah', 'di', 'banned', 'sering', 'me', 'non', 'aktifkan', 'akun', 'seseorang', 'tanpa', 'sebab', 'dan', 'tanpa', 'peringatan', 'termasuk', 'saya', 'salah', 'satunya', 'yang', 'kena']","['aplikasi', 'payah', 'mudah', 'banned', 'me', 'non', 'aktifkan', 'akun', 'peringatan', 'salah', 'satunya', 'kena']",22,12,10,aplikasi payah mudah banned me non aktif akun ingat salah satu kena,12,12
"Aplikasi keluar sendiri, ada bugs di samsung s20+ setelah update, tolong dibantu",negatif,2022-02-11,2022,aplikasi keluar sendiri ada bugs di samsung s setelah update tolong dibantu,12,12,aplikasi keluar sendiri ada bugs di samsung s setelah diperbarui tolong dibantu,12,12,"['aplikasi', 'keluar', 'sendiri', 'ada', 'bugs', 'di', 'samsung', 's', 'setelah', 'diperbarui', 'tolong', 'dibantu']","['aplikasi', 'bugs', 'samsung', 's', 'diperbarui', 'tolong', 'dibantu']",12,7,5,aplikasi bugs samsung s baru tolong bantu,7,7
Aplikasi google yang sangat potensial untuk pengembangan diri saya khususnya dalam bidang komunikasi. Ok thanks,positif,2020-09-22,2020,aplikasi google yang sangat potensial untuk pengembangan diri saya khususnya dalam bidang komunikasi ok thanks,15,15,aplikasi google yang sangat potensial untuk pengembangan diri saya khususnya dalam bidang komunikasi oke terima kasih,15,16,"['aplikasi', 'google', 'yang', 'sangat', 'potensial', 'untuk', 'pengembangan', 'diri', 'saya', 'khususnya', 'dalam', 'bidang', 'komunikasi', 'oke', 'terima', 'kasih']","['aplikasi', 'google', 'potensial', 'pengembangan', 'bidang', 'komunikasi', 'oke', 'terima', 'kasih']",16,9,7,aplikasi google potensial kembang bidang komunikasi oke terima kasih,9,9
Terima kasih yang sebesar besarny buat apk Linkedln dan team yang membantu semua orang yang ingin menggapai suksesnya. Thanks ya...,positif,2021-05-14,2021,terima kasih yang sebesar besarny buat apk linkedln dan team yang membantu semua orang yang ingin menggapai suksesnya thanks ya,20,20,terima kasih yang sebesar besarny buat aplikasi linkedln dan team yang membantu semua orang yang ingin menggapai suksesnya terima kasih ya,20,21,"['terima', 'kasih', 'yang', 'sebesar', 'besarny', 'buat', 'aplikasi', 'linkedln', 'dan', 'team', 'yang', 'membantu', 'semua', 'orang', 'yang', 'ingin', 'menggapai', 'suksesnya', 'terima', 'kasih', 'ya']","['terima', 'kasih', 'besarny', 'aplikasi', 'linkedln', 'team', 'membantu', 'orang', 'menggapai', 'suksesnya', 'terima', 'kasih', 'ya']",21,13,8,terima kasih besarny aplikasi linkedln team bantu orang gapai sukses terima kasih ya,13,13
"Aplikasi yang bagus, bisa punya banyak teman-teman profesional dan tentunya bisa nambah wawasan juga",positif,2020-07-02,2020,aplikasi yang bagus bisa punya banyak teman teman profesional dan tentunya bisa nambah wawasan juga,14,15,aplikasi yang bagus bisa punya banyak teman teman profesional dan tentunya bisa nambah wawasan juga,15,15,"['aplikasi', 'yang', 'bagus', 'bisa', 'punya', 'banyak', 'teman', 'teman', 'profesional', 'dan', 'tentunya', 'bisa', 'nambah', 'wawasan', 'juga']","['aplikasi', 'bagus', 'teman', 'teman', 'profesional', 'nambah', 'wawasan']",15,7,8,aplikasi bagus teman teman profesional nambah wawas,7,7
Tolong update berdasarkan lokasi diperbaiki. Sudah filter untuk cari berdasarkanokasi yang keluar malah kemana²,negatif,2022-08-31,2022,tolong update berdasarkan lokasi diperbaiki sudah filter untuk cari berdasarkanokasi yang keluar malah kemana²,14,14,tolong diperbarui berdasarkan lokasi di perbaiki sudah filter untuk cari berdasarkanokasi yang keluar bahkan kemana²,14,15,"['tolong', 'diperbarui', 'berdasarkan', 'lokasi', 'di', 'perbaiki', 'sudah', 'filter', 'untuk', 'cari', 'berdasarkanokasi', 'yang', 'keluar', 'bahkan', 'kemana²']","['tolong', 'diperbarui', 'berdasarkan', 'lokasi', 'perbaiki', 'filter', 'cari', 'berdasarkanokasi', 'kemana²']",15,9,6,tolong baru dasar lokasi baik filter cari berdasarkanokasi mana,9,9
"Di sini saya ingin belajar cara menghasilkan uang, dan saya butuh bimbingan dari admin, soal nya saya bodoh di bidang ini, ( teknolgi), Terima kasih, mohon bantuannya.",negatif,2020-04-29,2020,di sini saya ingin belajar cara menghasilkan uang dan saya butuh bimbingan dari admin soal nya saya bodoh di bidang ini teknolgi terima kasih mohon bantuannya,27,26,di sini saya ingin belajar cara menghasilkan uang dan saya butuh bimbingan dari admin soal nya saya bodoh di bidang ini teknolgi terima kasih mohon bantuannya,26,26,"['di', 'sini', 'saya', 'ingin', 'belajar', 'cara', 'menghasilkan', 'uang', 'dan', 'saya', 'butuh', 'bimbingan', 'dari', 'admin', 'soal', 'nya', 'saya', 'bodoh', 'di', 'bidang', 'ini', 'teknolgi', 'terima', 'kasih', 'mohon', 'bantuannya']","['belajar', 'menghasilkan', 'uang', 'butuh', 'bimbingan', 'admin', 'nya', 'bodoh', 'bidang', 'teknolgi', 'terima', 'kasih', 'mohon', 'bantuannya']",26,14,12,ajar hasil uang butuh bimbing admin nya bodoh bidang teknolgi terima kasih mohon bantu,14,14
Aplikasi yang sangat bagus Sangat membantu untuk para profesional Aplikasi yang memudahkan untuk pencari kerja juga yang mencari pekerja,positif,2023-02-23,2023,aplikasi yang sangat bagus sangat membantu untuk para profesional aplikasi yang memudahkan untuk pencari kerja juga yang mencari pekerja,19,19,aplikasi yang sangat bagus sangat membantu untuk para profesional aplikasi yang memudahkan untuk pencari kerja juga yang mencari yang kerja,19,20,"['aplikasi', 'yang', 'sangat', 'bagus', 'sangat', 'membantu', 'untuk', 'para', 'profesional', 'aplikasi', 'yang', 'memudahkan', 'untuk', 'pencari', 'kerja', 'juga', 'yang', 'mencari', 'yang', 'kerja']","['aplikasi', 'bagus', 'membantu', 'profesional', 'aplikasi', 'memudahkan', 'pencari', 'kerja', 'mencari', 'kerja']",20,10,10,aplikasi bagus bantu profesional aplikasi mudah cari kerja cari kerja,10,10
Verifikasi udah benar-benar dan ngulang terus. Ini sistem maintenance atau gimana ya ??? Mau login aja susah banget.,negatif,2023-04-25,2023,verifikasi udah benar benar dan ngulang terus ini sistem maintenance atau gimana ya mau login aja susah banget,18,18,verifikasi sudah benar benar dan mengulang terus ini sistem maintenance atau bagaimana ya mau login saja susah banget,18,18,"['verifikasi', 'sudah', 'benar', 'benar', 'dan', 'mengulang', 'terus', 'ini', 'sistem', 'maintenance', 'atau', 'bagaimana', 'ya', 'mau', 'login', 'saja', 'susah', 'banget']","['verifikasi', 'mengulang', 'sistem', 'maintenance', 'ya', 'login', 'susah', 'banget']",18,8,10,verifikasi ulang sistem maintenance ya login susah banget,8,8
"Saya mau masuk selalu ada verifikasi yang sulit, salah terus sehingga tidak bisa log in... Mohon solusinya kak",negatif,2022-10-21,2022,saya mau masuk selalu ada verifikasi yang sulit salah terus sehingga tidak bisa log in mohon solusinya kak,18,18,saya mau masuk selalu ada verifikasi yang sulit salah terus sehingga tidak bisa log in mohon solusinya kak,18,18,"['saya', 'mau', 'masuk', 'selalu', 'ada', 'verifikasi', 'yang', 'sulit', 'salah', 'terus', 'sehingga', 'tidak', 'bisa', 'log', 'in', 'mohon', 'solusinya', 'kak']","['masuk', 'verifikasi', 'sulit', 'salah', 'tidak', 'log', 'in', 'mohon', 'solusinya', 'kak']",18,10,8,masuk verifikasi sulit salah tidak log in mohon solusi kak,10,10
"Login nya bikin pusing kepala, kode keamanan cepat yg ga masuk akal. Mau login aja susah!",negatif,2022-11-26,2022,login nya bikin pusing kepala kode keamanan cepat yg ga masuk akal mau login aja susah,16,16,login nya bikin pusing kepala kode keamanan cepat yang tidak masuk akal mau login saja susah,16,16,"['login', 'nya', 'bikin', 'pusing', 'kepala', 'kode', 'keamanan', 'cepat', 'yang', 'tidak', 'masuk', 'akal', 'mau', 'login', 'saja', 'susah']","['login', 'nya', 'bikin', 'pusing', 'kepala', 'kode', 'keamanan', 'cepat', 'tidak', 'masuk', 'akal', 'login', 'susah']",16,13,3,login nya bikin pusing kepala kode aman cepat tidak masuk akal login susah,13,13
Gatau kenapa tiap buka aplikasi ini selalu terhenti dan keluar sendiri. Meskipun sudah di muat ulang. Hmmmm,negatif,2021-10-05,2021,gatau kenapa tiap buka aplikasi ini selalu terhenti dan keluar sendiri meskipun sudah di muat ulang hmmmm,17,17,tidak tahu kenapa tiap buka aplikasi ini selalu terhenti dan keluar sendiri meskipun sudah di muat ulang hmmmm,17,18,"['tidak', 'tahu', 'kenapa', 'tiap', 'buka', 'aplikasi', 'ini', 'selalu', 'terhenti', 'dan', 'keluar', 'sendiri', 'meskipun', 'sudah', 'di', 'muat', 'ulang', 'hmmmm']","['tidak', 'buka', 'aplikasi', 'terhenti', 'muat', 'ulang', 'hmmmm']",18,7,11,tidak buka aplikasi henti muat ulang hmmmm,7,7
"kenapa sya kasih Bintang 1?? KARENA SAYA BELUM DAPAT PANGGILAN DARI APLIKASI INI 😊 Trimakasih tipu"" nya. Nanti saya kasih B5 kalo ada panggilan (skali saja, entah gagal atau berhasil) buat menandakan aplikasi ini real buat membantu mencari kerja 🙏🏻",negatif,2022-02-01,2022,kenapa sya kasih bintang karena saya belum dapat panggilan dari aplikasi ini trimakasih tipu nya nanti saya kasih b kalo ada panggilan skali saja entah gagal atau berhasil buat menandakan aplikasi ini real buat membantu mencari kerja,40,37,kenapa saya kasih bintang karena saya belum dapat panggilan dari aplikasi ini terima kasih tipu nya nanti saya kasih biasa kalau ada panggilan sekali saja entah gagal atau berhasil buat menandakan aplikasi ini real buat membantu mencari kerja,37,38,"['kenapa', 'saya', 'kasih', 'bintang', 'karena', 'saya', 'belum', 'dapat', 'panggilan', 'dari', 'aplikasi', 'ini', 'terima', 'kasih', 'tipu', 'nya', 'nanti', 'saya', 'kasih', 'biasa', 'kalau', 'ada', 'panggilan', 'sekali', 'saja', 'entah', 'gagal', 'atau', 'berhasil', 'buat', 'menandakan', 'aplikasi', 'ini', 'real', 'buat', 'membantu', 'mencari', 'kerja']","['kasih', 'bintang', 'panggilan', 'aplikasi', 'terima', 'kasih', 'tipu', 'nya', 'kasih', 'panggilan', 'gagal', 'berhasil', 'menandakan', 'aplikasi', 'real', 'membantu', 'mencari', 'kerja']",38,18,20,kasih bintang panggil aplikasi terima kasih tipu nya kasih panggil gagal hasil tanda aplikasi real bantu cari kerja,18,18
Ini kenapa upload foto atau postingan ga berhasil-berhasil? Padahal jaringannya lancar,negatif,2023-06-01,2023,ini kenapa upload foto atau postingan ga berhasil berhasil padahal jaringannya lancar,11,12,ini kenapa unggah foto atau postingan tidak berhasil berhasil padahal jaringannya lancar,12,12,"['ini', 'kenapa', 'unggah', 'foto', 'atau', 'postingan', 'tidak', 'berhasil', 'berhasil', 'padahal', 'jaringannya', 'lancar']","['unggah', 'foto', 'postingan', 'tidak', 'berhasil', 'berhasil', 'jaringannya', 'lancar']",12,8,4,unggah foto postingan tidak hasil hasil jaring lancar,8,8
"Mantap, terhubung dengan HR semua. Perusahaan, hanya saja info lulus atau tidak seleksi CV tidak pernah di kabari",positif,2021-01-11,2021,mantap terhubung dengan hr semua perusahaan hanya saja info lulus atau tidak seleksi cv tidak pernah di kabari,18,18,mantap terhubung dengan hari semua perusahaan hanya saja informasi lulus atau tidak seleksi cv tidak pernah di kabari,18,18,"['mantap', 'terhubung', 'dengan', 'hari', 'semua', 'perusahaan', 'hanya', 'saja', 'informasi', 'lulus', 'atau', 'tidak', 'seleksi', 'cv', 'tidak', 'pernah', 'di', 'kabari']","['mantap', 'terhubung', 'perusahaan', 'informasi', 'lulus', 'tidak', 'seleksi', 'cv', 'tidak', 'kabari']",18,10,8,mantap hubung usaha informasi lulus tidak seleksi cv tidak kabar,10,10
Kenapa tidak bisa login. Padahal sudah melakukan sesuai perintah dengan verifikasi tapi berujung tidak bisa login.,negatif,2022-10-25,2022,kenapa tidak bisa login padahal sudah melakukan sesuai perintah dengan verifikasi tapi berujung tidak bisa login,16,16,kenapa tidak bisa login padahal sudah melakukan sesuai perintah dengan verifikasi tapi berujung tidak bisa login,16,16,"['kenapa', 'tidak', 'bisa', 'login', 'padahal', 'sudah', 'melakukan', 'sesuai', 'perintah', 'dengan', 'verifikasi', 'tapi', 'berujung', 'tidak', 'bisa', 'login']","['tidak', 'login', 'sesuai', 'perintah', 'verifikasi', 'berujung', 'tidak', 'login']",16,8,8,tidak login sesuai perintah verifikasi ujung tidak login,8,8
Semakin luas dan tetap beruntung terhubung terlindungi privasi saya dengan lebih baik lebih aman lebih memuaskan,positif,2022-05-24,2022,semakin luas dan tetap beruntung terhubung terlindungi privasi saya dengan lebih baik lebih aman lebih memuaskan,16,16,semakin luas dan tetap beruntung terhubung terlindungi privasi saya dengan lebih baik lebih aman lebih memuaskan,16,16,"['semakin', 'luas', 'dan', 'tetap', 'beruntung', 'terhubung', 'terlindungi', 'privasi', 'saya', 'dengan', 'lebih', 'baik', 'lebih', 'aman', 'lebih', 'memuaskan']","['luas', 'beruntung', 'terhubung', 'terlindungi', 'privasi', 'aman', 'memuaskan']",16,7,9,luas untung hubung lindung privasi aman muas,7,7
"Aplikasi yang teramat sangat bagus utk Para Owner, Karyawan dan juga Calon Karyawan.",positif,2020-12-01,2020,aplikasi yang teramat sangat bagus utk para owner karyawan dan juga calon karyawan,13,13,aplikasi yang amat sangat bagus untuk para owner karyawan dan juga calon karyawan,13,13,"['aplikasi', 'yang', 'amat', 'sangat', 'bagus', 'untuk', 'para', 'owner', 'karyawan', 'dan', 'juga', 'calon', 'karyawan']","['aplikasi', 'bagus', 'owner', 'karyawan', 'calon', 'karyawan']",13,6,7,aplikasi bagus owner karyawan calon karyawan,6,6
"Tolong di bantu,, kenapa pas melamar pekerjaan malah di alihkan ke link2 lain yah? Sebelum di update nggak seperti itu,, tolong solusinya",negatif,2020-10-28,2020,tolong di bantu kenapa pas melamar pekerjaan malah di alihkan ke link lain yah sebelum di update nggak seperti itu tolong solusinya,22,22,tolong di bantu kenapa pas melamar pekerjaan bahkan di alihkan ke link lain ya sebelum di diperbarui tidak seperti itu tolong solusinya,22,22,"['tolong', 'di', 'bantu', 'kenapa', 'pas', 'melamar', 'pekerjaan', 'bahkan', 'di', 'alihkan', 'ke', 'link', 'lain', 'ya', 'sebelum', 'di', 'diperbarui', 'tidak', 'seperti', 'itu', 'tolong', 'solusinya']","['tolong', 'bantu', 'pas', 'melamar', 'pekerjaan', 'alihkan', 'link', 'ya', 'diperbarui', 'tidak', 'tolong', 'solusinya']",22,12,10,tolong bantu pas lamar kerja alih link ya baru tidak tolong solusi,12,12
LinkedIn sangat berguna untuk menambah jaringan pengetahuan dan informasi dalam suatu pekerjaan atau komunikasi.,positif,2021-05-02,2021,linkedin sangat berguna untuk menambah jaringan pengetahuan dan informasi dalam suatu pekerjaan atau komunikasi,14,14,linkedin sangat berguna untuk menambah jaringan pengetahuan dan informasi dalam suatu pekerjaan atau komunikasi,14,14,"['linkedin', 'sangat', 'berguna', 'untuk', 'menambah', 'jaringan', 'pengetahuan', 'dan', 'informasi', 'dalam', 'suatu', 'pekerjaan', 'atau', 'komunikasi']","['linkedin', 'berguna', 'menambah', 'jaringan', 'pengetahuan', 'informasi', 'pekerjaan', 'komunikasi']",14,8,6,linkedin guna tambah jaring tahu informasi kerja komunikasi,8,8
Diklik daftar lewat fb ga bisa bisa...macet di depan terus di tempat login ga bisa masuk,negatif,2023-04-11,2023,diklik daftar lewat fb ga bisa bisa macet di depan terus di tempat login ga bisa masuk,16,17,diklik daftar lewat fb tidak bisa bisa macet di depan terus di tempat login tidak bisa masuk,17,17,"['diklik', 'daftar', 'lewat', 'fb', 'tidak', 'bisa', 'bisa', 'macet', 'di', 'depan', 'terus', 'di', 'tempat', 'login', 'tidak', 'bisa', 'masuk']","['diklik', 'daftar', 'fb', 'tidak', 'macet', 'login', 'tidak', 'masuk']",17,8,9,klik daftar fb tidak macet login tidak masuk,8,8
"stuck diverivikasi doang, padahal udah bener tp ada tulisan, ""Respons kode noCAPTCHA Anda tidak valid atau belum diisi."" gimana nihhh",negatif,2023-07-20,2023,stuck diverivikasi doang padahal udah bener tp ada tulisan respons kode nocaptcha anda tidak valid atau belum diisi gimana nihhh,20,20,stuck diverivikasi saja padahal sudah benar tapi ada tulisan respons kode nocaptcha anda tidak valid atau belum diisi bagaimana nihhh,20,20,"['stuck', 'diverivikasi', 'saja', 'padahal', 'sudah', 'benar', 'tapi', 'ada', 'tulisan', 'respons', 'kode', 'nocaptcha', 'anda', 'tidak', 'valid', 'atau', 'belum', 'diisi', 'bagaimana', 'nihhh']","['stuck', 'diverivikasi', 'tulisan', 'respons', 'kode', 'nocaptcha', 'tidak', 'valid', 'diisi', 'nihhh']",20,10,10,stuck diverivikasi tulis respons kode nocaptcha tidak valid isi nihhh,10,10
"Aplikasinya bikin ketagihan bagi kami pencari kerja, semoga cepat dapat panggilan kerja bagi kami yang sering buka aplikasi ini 🙏",positif,2022-06-23,2022,aplikasinya bikin ketagihan bagi kami pencari kerja semoga cepat dapat panggilan kerja bagi kami yang sering buka aplikasi ini,20,19,aplikasi nya bikin ketagihan bagi kami pencari kerja semoga cepat dapat panggilan kerja bagi kami yang sering buka aplikasi ini,19,20,"['aplikasi', 'nya', 'bikin', 'ketagihan', 'bagi', 'kami', 'pencari', 'kerja', 'semoga', 'cepat', 'dapat', 'panggilan', 'kerja', 'bagi', 'kami', 'yang', 'sering', 'buka', 'aplikasi', 'ini']","['aplikasi', 'nya', 'bikin', 'ketagihan', 'pencari', 'kerja', 'semoga', 'cepat', 'panggilan', 'kerja', 'buka', 'aplikasi']",20,12,8,aplikasi nya bikin tagih cari kerja moga cepat panggil kerja buka aplikasi,12,12
"Aplikasi sampah, kalo emang niat buat aplikasi untuk para pencari kerja knp harus register di platfom lain, TOLOL !!",negatif,2023-02-07,2023,aplikasi sampah kalo emang niat buat aplikasi untuk para pencari kerja knp harus register di platfom lain tolol,19,18,aplikasi sampah kalau memang niat buat aplikasi untuk para pencari kerja kenapa harus register di platfom lain tolol,18,18,"['aplikasi', 'sampah', 'kalau', 'memang', 'niat', 'buat', 'aplikasi', 'untuk', 'para', 'pencari', 'kerja', 'kenapa', 'harus', 'register', 'di', 'platfom', 'lain', 'tolol']","['aplikasi', 'sampah', 'niat', 'aplikasi', 'pencari', 'kerja', 'register', 'platfom', 'tolol']",18,9,9,aplikasi sampah niat aplikasi cari kerja register platfom tolol,9,9
"tolong diperbaiki jaringannya,lelet banget memainkan video aja tak bisa termasuk elearning",negatif,2020-06-12,2020,tolong diperbaiki jaringannya lelet banget memainkan video aja tak bisa termasuk elearning,11,12,tolong di perbaiki jaringannya lelet banget memainkan video saja tidak bisa termasuk elearning,12,13,"['tolong', 'di', 'perbaiki', 'jaringannya', 'lelet', 'banget', 'memainkan', 'video', 'saja', 'tidak', 'bisa', 'termasuk', 'elearning']","['tolong', 'perbaiki', 'jaringannya', 'lelet', 'banget', 'memainkan', 'video', 'tidak', 'elearning']",13,9,4,tolong baik jaring lelet banget main video tidak elearning,9,9
Aplikasi ini sangat keren dan banyak membantu kami yang membutuhkan untuk berkomunikasi dengan teman dan kenalan.,positif,2020-12-19,2020,aplikasi ini sangat keren dan banyak membantu kami yang membutuhkan untuk berkomunikasi dengan teman dan kenalan,16,16,aplikasi ini sangat keren dan banyak membantu kami yang membutuhkan untuk berkomunikasi dengan teman dan kenalan,16,16,"['aplikasi', 'ini', 'sangat', 'keren', 'dan', 'banyak', 'membantu', 'kami', 'yang', 'membutuhkan', 'untuk', 'berkomunikasi', 'dengan', 'teman', 'dan', 'kenalan']","['aplikasi', 'keren', 'membantu', 'membutuhkan', 'berkomunikasi', 'teman', 'kenalan']",16,7,9,aplikasi keren bantu butuh komunikasi teman kenal,7,7
Aplikasi yang sangat bernanfaat untuk info dan membangun relasi ke semua orang. mohon jaga kualitas dan tingkatkan,positif,2020-04-30,2020,aplikasi yang sangat bernanfaat untuk info dan membangun relasi ke semua orang mohon jaga kualitas dan tingkatkan,17,17,aplikasi yang sangat bernanfaat untuk informasi dan membangun relasi ke semua orang mohon jaga kualitas dan tingkatkan,17,17,"['aplikasi', 'yang', 'sangat', 'bernanfaat', 'untuk', 'informasi', 'dan', 'membangun', 'relasi', 'ke', 'semua', 'orang', 'mohon', 'jaga', 'kualitas', 'dan', 'tingkatkan']","['aplikasi', 'bernanfaat', 'informasi', 'membangun', 'relasi', 'orang', 'mohon', 'jaga', 'kualitas', 'tingkatkan']",17,10,7,aplikasi bernanfaat informasi bangun relasi orang mohon jaga kualitas tingkat,10,10
Nyesel di aktifkan dan update versi. Malah ngebug. Di buka keluar sendiri. Buka lagi. Keluar lagi. Mending uninstall aja sekalian,negatif,2020-10-10,2020,nyesel di aktifkan dan update versi malah ngebug di buka keluar sendiri buka lagi keluar lagi mending uninstall aja sekalian,20,20,menyesal di aktifkan dan diperbarui versi bahkan nge bug di buka keluar sendiri buka lagi keluar lagi mending uninstall saja sekalian,20,21,"['menyesal', 'di', 'aktifkan', 'dan', 'diperbarui', 'versi', 'bahkan', 'nge', 'bug', 'di', 'buka', 'keluar', 'sendiri', 'buka', 'lagi', 'keluar', 'lagi', 'mending', 'uninstall', 'saja', 'sekalian']","['menyesal', 'aktifkan', 'diperbarui', 'versi', 'nge', 'bug', 'buka', 'buka', 'mending', 'uninstall']",21,10,11,sesal aktif baru versi nge bug buka buka mending uninstall,10,10
Harus lbh kreatif dgn fitur2 yang lebih bermanfaat dan lbh muda berkomunikasi.... terimakasih,negatif,2020-06-18,2020,harus lbh kreatif dgn fitur yang lebih bermanfaat dan lbh muda berkomunikasi terimakasih,13,13,harus lebih kreatif dengan fitur yang lebih bermanfaat dan lebih muda berkomunikasi terima kasih,13,14,"['harus', 'lebih', 'kreatif', 'dengan', 'fitur', 'yang', 'lebih', 'bermanfaat', 'dan', 'lebih', 'muda', 'berkomunikasi', 'terima', 'kasih']","['kreatif', 'fitur', 'bermanfaat', 'muda', 'berkomunikasi', 'terima', 'kasih']",14,7,7,kreatif fitur manfaat muda komunikasi terima kasih,7,7
"Sangat bermanfaat sekali aplikasi ini, untuk menjalin relasi profesional dan mencari peluang karier.",positif,2020-06-03,2020,sangat bermanfaat sekali aplikasi ini untuk menjalin relasi profesional dan mencari peluang karier,13,13,sangat bermanfaat sekali aplikasi ini untuk menjalin relasi profesional dan mencari peluang karier,13,13,"['sangat', 'bermanfaat', 'sekali', 'aplikasi', 'ini', 'untuk', 'menjalin', 'relasi', 'profesional', 'dan', 'mencari', 'peluang', 'karier']","['bermanfaat', 'aplikasi', 'menjalin', 'relasi', 'profesional', 'mencari', 'peluang', 'karier']",13,8,5,manfaat aplikasi jalin relasi profesional cari peluang karier,8,8
"Saya mau login, saya lupa sandi akun saya. Otomatis saya mengikuti prosedur. Disaat minta kode lama banget, terus ke ulang lagi dari awal. Aplikasi tidak jelas.",negatif,2023-05-07,2023,saya mau login saya lupa sandi akun saya otomatis saya mengikuti prosedur disaat minta kode lama banget terus ke ulang lagi dari awal aplikasi tidak jelas,26,26,saya mau login saya lupa sandi akun saya otomatis saya mengikuti prosedur disaat minta kode lama banget terus ke ulang lagi dari awal aplikasi tidak jelas,26,26,"['saya', 'mau', 'login', 'saya', 'lupa', 'sandi', 'akun', 'saya', 'otomatis', 'saya', 'mengikuti', 'prosedur', 'disaat', 'minta', 'kode', 'lama', 'banget', 'terus', 'ke', 'ulang', 'lagi', 'dari', 'awal', 'aplikasi', 'tidak', 'jelas']","['login', 'lupa', 'sandi', 'akun', 'otomatis', 'mengikuti', 'prosedur', 'disaat', 'kode', 'banget', 'ulang', 'aplikasi', 'tidak']",26,13,13,login lupa sandi akun otomatis ikut prosedur saat kode banget ulang aplikasi tidak,13,13
Parah. aplikasi Linkedin benar benar tidak aman. Akun saya kena Hack dan rekening saya terdebet utk trx yang tidak saya lakukan.,negatif,2023-05-17,2023,parah aplikasi linkedin benar benar tidak aman akun saya kena hack dan rekening saya terdebet utk trx yang tidak saya lakukan,21,21,parah aplikasi linkedin benar benar tidak aman akun saya kena hack dan rekening saya terdebet untuk trx yang tidak saya lakukan,21,21,"['parah', 'aplikasi', 'linkedin', 'benar', 'benar', 'tidak', 'aman', 'akun', 'saya', 'kena', 'hack', 'dan', 'rekening', 'saya', 'terdebet', 'untuk', 'trx', 'yang', 'tidak', 'saya', 'lakukan']","['parah', 'aplikasi', 'linkedin', 'tidak', 'aman', 'akun', 'kena', 'hack', 'rekening', 'terdebet', 'trx', 'tidak', 'lakukan']",21,13,8,parah aplikasi linkedin tidak aman akun kena hack rekening debet trx tidak laku,13,13
Aplikasi ini sangat simple dan mudah di gunakan. sangat membantu untuk koneksi masalah pekerjaan..,positif,2020-06-28,2020,aplikasi ini sangat simple dan mudah di gunakan sangat membantu untuk koneksi masalah pekerjaan,14,14,aplikasi ini sangat simpel dan mudah di gunakan sangat membantu untuk koneksi masalah pekerjaan,14,14,"['aplikasi', 'ini', 'sangat', 'simpel', 'dan', 'mudah', 'di', 'gunakan', 'sangat', 'membantu', 'untuk', 'koneksi', 'masalah', 'pekerjaan']","['aplikasi', 'simpel', 'mudah', 'membantu', 'koneksi', 'pekerjaan']",14,6,8,aplikasi simpel mudah bantu koneksi kerja,6,6
Aplikasi LinkedIn sangat membantu saya karena bisa berkomunikasi secara langsung mengenai kabar berita apapun,positif,2022-02-12,2022,aplikasi linkedin sangat membantu saya karena bisa berkomunikasi secara langsung mengenai kabar berita apapun,14,14,aplikasi linkedin sangat membantu saya karena bisa berkomunikasi secara langsung mengenai kabar berita apapun,14,14,"['aplikasi', 'linkedin', 'sangat', 'membantu', 'saya', 'karena', 'bisa', 'berkomunikasi', 'secara', 'langsung', 'mengenai', 'kabar', 'berita', 'apapun']","['aplikasi', 'linkedin', 'membantu', 'berkomunikasi', 'langsung', 'kabar', 'berita', 'apapun']",14,8,6,aplikasi linkedin bantu komunikasi langsung kabar berita apa,8,8
Sudah pilih metode login pakek google setelah pilih akun tidak terjadi apa-apa alias tidak masuk akun. Sudah beberapa kali coba sama saja,negatif,2023-04-08,2023,sudah pilih metode login pakek google setelah pilih akun tidak terjadi apa apa alias tidak masuk akun sudah beberapa kali coba sama saja,22,23,sudah pilih metode login pakai google setelah pilih akun tidak terjadi apa apa alias tidak masuk akun sudah beberapa kali coba sama saja,23,23,"['sudah', 'pilih', 'metode', 'login', 'pakai', 'google', 'setelah', 'pilih', 'akun', 'tidak', 'terjadi', 'apa', 'apa', 'alias', 'tidak', 'masuk', 'akun', 'sudah', 'beberapa', 'kali', 'coba', 'sama', 'saja']","['pilih', 'metode', 'login', 'pakai', 'google', 'pilih', 'akun', 'tidak', 'alias', 'tidak', 'masuk', 'akun', 'kali', 'coba']",23,14,9,pilih metode login pakai google pilih akun tidak alias tidak masuk akun kali coba,14,14
Aplikasi ini bukan semata mata untuk melihat peluang kerja .. tetapi akan menambah wawasan kita dalam dunia kerja ..,positif,2020-06-30,2020,aplikasi ini bukan semata mata untuk melihat peluang kerja tetapi akan menambah wawasan kita dalam dunia kerja,19,17,aplikasi ini bukan semata mata untuk melihat peluang kerja tetapi akan menambah wawasan kita dalam dunia kerja,17,17,"['aplikasi', 'ini', 'bukan', 'semata', 'mata', 'untuk', 'melihat', 'peluang', 'kerja', 'tetapi', 'akan', 'menambah', 'wawasan', 'kita', 'dalam', 'dunia', 'kerja']","['aplikasi', 'mata', 'peluang', 'kerja', 'menambah', 'wawasan', 'dunia', 'kerja']",17,8,9,aplikasi mata peluang kerja tambah wawas dunia kerja,8,8
"Mohon maff sebelum nya boleh saya bertanya admin, kenapa linkedIn punya saya ga bisa mencari koneksi ya ga bisa menambah teman",negatif,2020-06-02,2020,mohon maff sebelum nya boleh saya bertanya admin kenapa linkedin punya saya ga bisa mencari koneksi ya ga bisa menambah teman,21,21,mohon maff sebelum nya boleh saya bertanya admin kenapa linkedin punya saya tidak bisa mencari koneksi ya tidak bisa menambah teman,21,21,"['mohon', 'maff', 'sebelum', 'nya', 'boleh', 'saya', 'bertanya', 'admin', 'kenapa', 'linkedin', 'punya', 'saya', 'tidak', 'bisa', 'mencari', 'koneksi', 'ya', 'tidak', 'bisa', 'menambah', 'teman']","['mohon', 'maff', 'nya', 'admin', 'linkedin', 'tidak', 'mencari', 'koneksi', 'ya', 'tidak', 'menambah', 'teman']",21,12,9,mohon maff nya admin linkedin tidak cari koneksi ya tidak tambah teman,12,12
Nggak bisa login padahal email sudah benar dicoba berkali kali tetap nggak bisa,negatif,2020-09-29,2020,nggak bisa login padahal email sudah benar dicoba berkali kali tetap nggak bisa,13,13,tidak bisa login padahal email sudah benar dicoba berkali kali tetap tidak bisa,13,13,"['tidak', 'bisa', 'login', 'padahal', 'email', 'sudah', 'benar', 'dicoba', 'berkali', 'kali', 'tetap', 'tidak', 'bisa']","['tidak', 'login', 'email', 'dicoba', 'berkali', 'kali', 'tidak']",13,7,6,tidak login email coba kali kali tidak,7,7
"Sangat terbantu dengan hadirnya aplikasi ini, lebih mudah mengupgrade diri serta membranding perusahaan kecil kami.",positif,2022-01-09,2022,sangat terbantu dengan hadirnya aplikasi ini lebih mudah mengupgrade diri serta membranding perusahaan kecil kami,15,15,sangat membantu dengan hadirnya aplikasi ini lebih mudah mengupgrade diri serta membranding perusahaan kecil kami,15,15,"['sangat', 'membantu', 'dengan', 'hadirnya', 'aplikasi', 'ini', 'lebih', 'mudah', 'mengupgrade', 'diri', 'serta', 'membranding', 'perusahaan', 'kecil', 'kami']","['membantu', 'hadirnya', 'aplikasi', 'mudah', 'mengupgrade', 'membranding', 'perusahaan']",15,7,8,bantu hadir aplikasi mudah mengupgrade membranding usaha,7,7
"Aplikasi cacat, login salalu aja verifikasi diri terus, sampai kiamat, ga bisa bisa login, verifikasi terus",negatif,2023-02-12,2023,aplikasi cacat login salalu aja verifikasi diri terus sampai kiamat ga bisa bisa login verifikasi terus,16,16,aplikasi cacat login salalu saja verifikasi diri terus sampai kiamat tidak bisa bisa login verifikasi terus,16,16,"['aplikasi', 'cacat', 'login', 'salalu', 'saja', 'verifikasi', 'diri', 'terus', 'sampai', 'kiamat', 'tidak', 'bisa', 'bisa', 'login', 'verifikasi', 'terus']","['aplikasi', 'cacat', 'login', 'salalu', 'verifikasi', 'kiamat', 'tidak', 'login', 'verifikasi']",16,9,7,aplikasi cacat login salalu verifikasi kiamat tidak login verifikasi,9,9
"Panduan diawal lumayan sulit dipahami, dan untuk lulusan SLTA atau high-school gak ada fitur nya.",negatif,2022-04-25,2022,panduan diawal lumayan sulit dipahami dan untuk lulusan slta atau high school gak ada fitur nya,15,16,panduan diawal lumayan sulit dipahami dan untuk lulusan slta atau high school tidak ada fitur nya,16,16,"['panduan', 'diawal', 'lumayan', 'sulit', 'dipahami', 'dan', 'untuk', 'lulusan', 'slta', 'atau', 'high', 'school', 'tidak', 'ada', 'fitur', 'nya']","['panduan', 'diawal', 'lumayan', 'sulit', 'dipahami', 'lulusan', 'slta', 'high', 'school', 'tidak', 'fitur', 'nya']",16,12,4,pandu awal lumayan sulit paham lulus slta high school tidak fitur nya,12,12
"Bintang satu dulu,, ga bisa verifikasi, gagal terus, padahal klik gambarnya udah bener",negatif,2022-06-05,2022,bintang satu dulu ga bisa verifikasi gagal terus padahal klik gambarnya udah bener,13,13,bintang satu dahulu tidak bisa verifikasi gagal terus padahal klik gambarnya sudah benar,13,13,"['bintang', 'satu', 'dahulu', 'tidak', 'bisa', 'verifikasi', 'gagal', 'terus', 'padahal', 'klik', 'gambarnya', 'sudah', 'benar']","['bintang', 'tidak', 'verifikasi', 'gagal', 'klik', 'gambarnya']",13,6,7,bintang tidak verifikasi gagal klik gambar,6,6
"cukup baik untuk memulai suatu komunitas profesi, dibidang profesionalitas kerjaan lebih dioptimalkan lagi dan no berbayar lah ...",positif,2021-12-06,2021,cukup baik untuk memulai suatu komunitas profesi dibidang profesionalitas kerjaan lebih dioptimalkan lagi dan no berbayar lah,18,17,cukup baik untuk memulai suatu komunitas profesi dibidang profesionalitas kerjaan lebih dioptimalkan lagi dan nomor berbayar lah,17,17,"['cukup', 'baik', 'untuk', 'memulai', 'suatu', 'komunitas', 'profesi', 'dibidang', 'profesionalitas', 'kerjaan', 'lebih', 'dioptimalkan', 'lagi', 'dan', 'nomor', 'berbayar', 'lah']","['komunitas', 'profesi', 'dibidang', 'profesionalitas', 'kerjaan', 'dioptimalkan', 'nomor', 'berbayar']",17,8,9,komunitas profesi bidang profesionalitas kerja optimal nomor bayar,8,8
Akun saya tiba tiba di batasi tanpa alasan yg jelas..katanya suruh verifikasi data dan saya ikuti semua petunjuknya malah di batasi permanen..maksudnya gmn?bener bener kecewa dengan cara penyelesaian masalah,negatif,2023-02-14,2023,akun saya tiba tiba di batasi tanpa alasan yg jelas katanya suruh verifikasi data dan saya ikuti semua petunjuknya malah di batasi permanen maksudnya gmn bener bener kecewa dengan cara penyelesaian masalah,29,32,akun saya tiba tiba di batasi tanpa alasan yang jelas katanya suruh verifikasi data dan saya ikuti semua petunjuknya bahkan di batasi permanen maksudnya bagaimana benar benar kecewa dengan cara penyelesaian masalah,32,32,"['akun', 'saya', 'tiba', 'tiba', 'di', 'batasi', 'tanpa', 'alasan', 'yang', 'jelas', 'katanya', 'suruh', 'verifikasi', 'data', 'dan', 'saya', 'ikuti', 'semua', 'petunjuknya', 'bahkan', 'di', 'batasi', 'permanen', 'maksudnya', 'bagaimana', 'benar', 'benar', 'kecewa', 'dengan', 'cara', 'penyelesaian', 'masalah']","['akun', 'batasi', 'alasan', 'suruh', 'verifikasi', 'data', 'ikuti', 'petunjuknya', 'batasi', 'permanen', 'maksudnya', 'kecewa', 'penyelesaian']",32,13,19,akun batas alas suruh verifikasi data ikut tunjuk batas permanen maksud kecewa selesai,13,13
"Terlalu kaku,TDK fleksibel... informasi selalu garing...tidak asli... dari LinkedIn.",negatif,2020-08-26,2020,terlalu kaku tdk fleksibel informasi selalu garing tidak asli dari linkedin,9,11,terlalu kaku tidak fleksibel informasi selalu garing tidak asli dari linkedin,11,11,"['terlalu', 'kaku', 'tidak', 'fleksibel', 'informasi', 'selalu', 'garing', 'tidak', 'asli', 'dari', 'linkedin']","['kaku', 'tidak', 'fleksibel', 'informasi', 'garing', 'tidak', 'asli', 'linkedin']",11,8,3,kaku tidak fleksibel informasi garing tidak asli linkedin,8,8
"luar biasa,hebat,kita,saya pribadi merasakannya,kita bisa terhubung dengan banyak teman yg beragam latar belakang pekarjaan,kehidupan,ekonomi,ws pokoke top markotop",positif,2022-06-18,2022,luar biasa hebat kita saya pribadi merasakannya kita bisa terhubung dengan banyak teman yg beragam latar belakang pekarjaan kehidupan ekonomi ws pokoke top markotop,17,24,luar biasa hebat kita saya pribadi merasakannya kita bisa terhubung dengan banyak teman yang beragam latar belakang pekarjaan kehidupan ekonomi ws pokoke top sekali,24,24,"['luar', 'biasa', 'hebat', 'kita', 'saya', 'pribadi', 'merasakannya', 'kita', 'bisa', 'terhubung', 'dengan', 'banyak', 'teman', 'yang', 'beragam', 'latar', 'belakang', 'pekarjaan', 'kehidupan', 'ekonomi', 'ws', 'pokoke', 'top', 'sekali']","['hebat', 'pribadi', 'merasakannya', 'terhubung', 'teman', 'beragam', 'latar', 'pekarjaan', 'kehidupan', 'ekonomi', 'ws', 'pokoke', 'top']",24,13,11,hebat pribadi rasa hubung teman agam latar pekarjaan hidup ekonomi ws pokoke top,13,13
"aplikasi rusak , verivikasi gambar di salahkan terus , otp berhasil tapi tidak masuk",negatif,2022-03-20,2022,aplikasi rusak verivikasi gambar di salahkan terus otp berhasil tapi tidak masuk,14,12,aplikasi rusak verivikasi gambar di salahkan terus one time password berhasil tapi tidak masuk,12,14,"['aplikasi', 'rusak', 'verivikasi', 'gambar', 'di', 'salahkan', 'terus', 'one', 'time', 'password', 'berhasil', 'tapi', 'tidak', 'masuk']","['aplikasi', 'rusak', 'verivikasi', 'gambar', 'salahkan', 'one', 'time', 'password', 'berhasil', 'tidak', 'masuk']",14,11,3,aplikasi rusak verivikasi gambar salah one time password hasil tidak masuk,11,11
"Selalu gagal di teka teki yang kelima, Kalau gambar nya tiga dimensi, harus nya jawaban saya benar semua.... Apk nya sih taikkkk banget😅😅😅😅",negatif,2022-07-07,2022,selalu gagal di teka teki yang kelima kalau gambar nya tiga dimensi harus nya jawaban saya benar semua apk nya sih taikkkk banget,23,23,selalu gagal di teka teki yang kelima kalau gambar nya tiga dimensi harus nya jawaban saya benar semua aplikasi nya sih taikkkk banget,23,23,"['selalu', 'gagal', 'di', 'teka', 'teki', 'yang', 'kelima', 'kalau', 'gambar', 'nya', 'tiga', 'dimensi', 'harus', 'nya', 'jawaban', 'saya', 'benar', 'semua', 'aplikasi', 'nya', 'sih', 'taikkkk', 'banget']","['gagal', 'teka', 'teki', 'gambar', 'nya', 'dimensi', 'nya', 'aplikasi', 'nya', 'sih', 'taikkkk', 'banget']",23,12,11,gagal teka teki gambar nya dimensi nya aplikasi nya sih taikkkk banget,12,12
"Linkeidn yang dulu bukan lah yang sekarang makin banyak saingannya bukan nambah bagus malah terpuruk kualitasnya,ribet",negatif,2021-11-04,2021,linkeidn yang dulu bukan lah yang sekarang makin banyak saingannya bukan nambah bagus malah terpuruk kualitasnya ribet,16,17,linkeidn yang dahulu bukan lah yang sekarang makin banyak saingannya bukan nambah bagus bahkan terpuruk kualitasnya rumit,17,17,"['linkeidn', 'yang', 'dahulu', 'bukan', 'lah', 'yang', 'sekarang', 'makin', 'banyak', 'saingannya', 'bukan', 'nambah', 'bagus', 'bahkan', 'terpuruk', 'kualitasnya', 'rumit']","['linkeidn', 'saingannya', 'nambah', 'bagus', 'terpuruk', 'kualitasnya', 'rumit']",17,7,10,linkeidn saing nambah bagus puruk kualitas rumit,7,7
"Sering terjadi masalah. Udah dicoba berkali kali, sama aja. Padahal sudah update",negatif,2023-01-17,2023,sering terjadi masalah udah dicoba berkali kali sama aja padahal sudah update,12,12,sering terjadi masalah sudah dicoba berkali kali sama saja padahal sudah diperbarui,12,12,"['sering', 'terjadi', 'masalah', 'sudah', 'dicoba', 'berkali', 'kali', 'sama', 'saja', 'padahal', 'sudah', 'diperbarui']","['dicoba', 'berkali', 'kali', 'diperbarui']",12,4,8,coba kali kali baru,4,4
Linkedl sangat membantu utk info lowongan pekerjaan trimks atas bantuan dan perhatianya.,positif,2020-05-02,2020,linkedl sangat membantu utk info lowongan pekerjaan trimks atas bantuan dan perhatianya,12,12,linkedl sangat membantu untuk informasi lowongan pekerjaan trimks atas bantuan dan perhatianya,12,12,"['linkedl', 'sangat', 'membantu', 'untuk', 'informasi', 'lowongan', 'pekerjaan', 'trimks', 'atas', 'bantuan', 'dan', 'perhatianya']","['linkedl', 'membantu', 'informasi', 'lowongan', 'pekerjaan', 'trimks', 'bantuan', 'perhatianya']",12,8,4,linkedl bantu informasi lowong kerja trimks bantu perhatianya,8,8
"Lowongan kerja yang sudah tidak aktif/kadaluarasa tolong jangan di iklankan lg,agar dapat selalu update",negatif,2020-05-22,2020,lowongan kerja yang sudah tidak aktif kadaluarasa tolong jangan di iklankan lg agar dapat selalu update,14,16,lowongan kerja yang sudah tidak aktif kadaluarasa tolong jangan di iklankan lagi agar dapat selalu diperbarui,16,16,"['lowongan', 'kerja', 'yang', 'sudah', 'tidak', 'aktif', 'kadaluarasa', 'tolong', 'jangan', 'di', 'iklankan', 'lagi', 'agar', 'dapat', 'selalu', 'diperbarui']","['lowongan', 'kerja', 'tidak', 'aktif', 'kadaluarasa', 'tolong', 'iklankan', 'diperbarui']",16,8,8,lowong kerja tidak aktif kadaluarasa tolong iklan baru,8,8
Sistem kerja baru yang menarik karena berani jalin relasi dengan jaringan online besar lain semisal Google. Keep improving yourself !!,positif,2022-01-02,2022,sistem kerja baru yang menarik karena berani jalin relasi dengan jaringan online besar lain semisal google keep improving yourself,20,19,sistem kerja baru yang menarik karena berani jalin relasi dengan jaringan daring besar lain semisal google keep improving yourself,19,19,"['sistem', 'kerja', 'baru', 'yang', 'menarik', 'karena', 'berani', 'jalin', 'relasi', 'dengan', 'jaringan', 'daring', 'besar', 'lain', 'semisal', 'google', 'keep', 'improving', 'yourself']","['sistem', 'kerja', 'menarik', 'berani', 'jalin', 'relasi', 'jaringan', 'daring', 'google', 'keep', 'improving', 'yourself']",19,12,7,sistem kerja tarik berani jalin relasi jaring daring google keep improving yourself,12,12
"Masih awal pemakaian aplikasi, semoga bisa menemukan job yang sesuai dgn basic dsini 🙏",positif,2020-06-07,2020,masih awal pemakaian aplikasi semoga bisa menemukan job yang sesuai dgn basic dsini,14,13,masih awal pemakaian aplikasi semoga bisa menemukan kerja yang sesuai dengan basic disini,13,13,"['masih', 'awal', 'pemakaian', 'aplikasi', 'semoga', 'bisa', 'menemukan', 'kerja', 'yang', 'sesuai', 'dengan', 'basic', 'disini']","['pemakaian', 'aplikasi', 'semoga', 'menemukan', 'kerja', 'sesuai', 'basic']",13,7,6,pakai aplikasi moga temu kerja sesuai basic,7,7
"akun saya baru daftar sudah dibatasi dan tidak bisa di akses, sangat mengecewakan padahal saya tidak melanggar apa pun",negatif,2022-02-25,2022,akun saya baru daftar sudah dibatasi dan tidak bisa di akses sangat mengecewakan padahal saya tidak melanggar apa pun,19,19,akun saya baru daftar sudah dibatasi dan tidak bisa di akses sangat mengecewakan padahal saya tidak melanggar apa pun,19,19,"['akun', 'saya', 'baru', 'daftar', 'sudah', 'dibatasi', 'dan', 'tidak', 'bisa', 'di', 'akses', 'sangat', 'mengecewakan', 'padahal', 'saya', 'tidak', 'melanggar', 'apa', 'pun']","['akun', 'daftar', 'dibatasi', 'tidak', 'akses', 'mengecewakan', 'tidak', 'melanggar']",19,8,11,akun daftar batas tidak akses kecewa tidak langgar,8,8
"Aplikasi kurang bagus, untuk upload dan lain-lain susah, aplikasi sering keluar sendiri spam",negatif,2021-12-16,2021,aplikasi kurang bagus untuk upload dan lain lain susah aplikasi sering keluar sendiri spam,13,14,aplikasi kurang bagus untuk unggah dan lain lain susah aplikasi sering keluar sendiri spam,14,14,"['aplikasi', 'kurang', 'bagus', 'untuk', 'unggah', 'dan', 'lain', 'lain', 'susah', 'aplikasi', 'sering', 'keluar', 'sendiri', 'spam']","['aplikasi', 'bagus', 'unggah', 'susah', 'aplikasi', 'spam']",14,6,8,aplikasi bagus unggah susah aplikasi spam,6,6
"Baru bikin akun, 3 hari kemudian ga bisa dibuka atau hilang, aneh banget ini aplikasi mau nyuri data atau gimana?",negatif,2023-02-07,2023,baru bikin akun hari kemudian ga bisa dibuka atau hilang aneh banget ini aplikasi mau nyuri data atau gimana,20,19,baru bikin akun hari kemudian tidak bisa dibuka atau hilang aneh banget ini aplikasi mau nyuri data atau bagaimana,19,19,"['baru', 'bikin', 'akun', 'hari', 'kemudian', 'tidak', 'bisa', 'dibuka', 'atau', 'hilang', 'aneh', 'banget', 'ini', 'aplikasi', 'mau', 'nyuri', 'data', 'atau', 'bagaimana']","['bikin', 'akun', 'tidak', 'dibuka', 'hilang', 'aneh', 'banget', 'aplikasi', 'nyuri', 'data']",19,10,9,bikin akun tidak buka hilang aneh banget aplikasi nyuri data,10,10
"Aplikasi yang sangat baik, sangat membantu para pekerja maupun pencari kerja, pemilik usaha dan pengelola perusahaan.",positif,2020-06-11,2020,aplikasi yang sangat baik sangat membantu para pekerja maupun pencari kerja pemilik usaha dan pengelola perusahaan,16,16,aplikasi yang sangat baik sangat membantu para yang kerja maupun pencari kerja pemilik usaha dan pengelola perusahaan,16,17,"['aplikasi', 'yang', 'sangat', 'baik', 'sangat', 'membantu', 'para', 'yang', 'kerja', 'maupun', 'pencari', 'kerja', 'pemilik', 'usaha', 'dan', 'pengelola', 'perusahaan']","['aplikasi', 'membantu', 'kerja', 'pencari', 'kerja', 'pemilik', 'usaha', 'pengelola', 'perusahaan']",17,9,8,aplikasi bantu kerja cari kerja milik usaha kelola usaha,9,9
"Kenapa tidak bisa membuka pesan ,padahal bnyk yang mengirim pesan kepada saya..jadi tidak tau informasi dari teman teman",negatif,2021-09-03,2021,kenapa tidak bisa membuka pesan padahal bnyk yang mengirim pesan kepada saya jadi tidak tau informasi dari teman teman,18,19,kenapa tidak bisa membuka pesan padahal banyak yang mengirim pesan kepada saya jadi tidak tahu informasi dari teman teman,19,19,"['kenapa', 'tidak', 'bisa', 'membuka', 'pesan', 'padahal', 'banyak', 'yang', 'mengirim', 'pesan', 'kepada', 'saya', 'jadi', 'tidak', 'tahu', 'informasi', 'dari', 'teman', 'teman']","['tidak', 'membuka', 'pesan', 'mengirim', 'pesan', 'tidak', 'informasi', 'teman', 'teman']",19,9,10,tidak buka pesan kirim pesan tidak informasi teman teman,9,9
saya sangat puas dengan pakai apk ini makin di update makin lebih bagus dan makin berkembang dan makin keren the best,positif,2021-05-07,2021,saya sangat puas dengan pakai apk ini makin di update makin lebih bagus dan makin berkembang dan makin keren the best,21,21,saya sangat puas dengan pakai aplikasi ini makin di diperbarui makin lebih bagus dan makin berkembang dan makin keren the terbaik,21,21,"['saya', 'sangat', 'puas', 'dengan', 'pakai', 'aplikasi', 'ini', 'makin', 'di', 'diperbarui', 'makin', 'lebih', 'bagus', 'dan', 'makin', 'berkembang', 'dan', 'makin', 'keren', 'the', 'terbaik']","['puas', 'pakai', 'aplikasi', 'diperbarui', 'bagus', 'berkembang', 'keren', 'the', 'terbaik']",21,9,12,puas pakai aplikasi baru bagus kembang keren the baik,9,9
"Apk gak jelas verifikasi susah bener, Di coba gambar yg normal salah di coba gambar yang hadap atas salah juga. Aneh bener dah payah",negatif,2022-03-11,2022,apk gak jelas verifikasi susah bener di coba gambar yg normal salah di coba gambar yang hadap atas salah juga aneh bener dah payah,24,24,aplikasi tidak jelas verifikasi susah benar di coba gambar yang normal salah di coba gambar yang hadap atas salah juga aneh benar sudah payah,24,24,"['aplikasi', 'tidak', 'jelas', 'verifikasi', 'susah', 'benar', 'di', 'coba', 'gambar', 'yang', 'normal', 'salah', 'di', 'coba', 'gambar', 'yang', 'hadap', 'atas', 'salah', 'juga', 'aneh', 'benar', 'sudah', 'payah']","['aplikasi', 'tidak', 'verifikasi', 'susah', 'coba', 'gambar', 'normal', 'salah', 'coba', 'gambar', 'hadap', 'salah', 'aneh', 'payah']",24,14,10,aplikasi tidak verifikasi susah coba gambar normal salah coba gambar hadap salah aneh payah,14,14
"Sentuh gambar yg mengadap keatas, pala kau, cape, udah plis ga usah ada yg instal loginnya di persulit, mending instal joobstreet atau apk loker yg lain.",negatif,2021-10-14,2021,sentuh gambar yg mengadap keatas pala kau cape udah plis ga usah ada yg instal loginnya di persulit mending instal joobstreet atau apk loker yg lain,26,26,sentuh gambar yang mengadap keatas pala kau capek sudah tolong tidak usah ada yang memasang loginnya di persulit mending memasang joobstreet atau aplikasi loker yang lain,26,26,"['sentuh', 'gambar', 'yang', 'mengadap', 'keatas', 'pala', 'kau', 'capek', 'sudah', 'tolong', 'tidak', 'usah', 'ada', 'yang', 'memasang', 'loginnya', 'di', 'persulit', 'mending', 'memasang', 'joobstreet', 'atau', 'aplikasi', 'loker', 'yang', 'lain']","['sentuh', 'gambar', 'mengadap', 'keatas', 'pala', 'kau', 'capek', 'tolong', 'tidak', 'memasang', 'loginnya', 'persulit', 'mending', 'memasang', 'joobstreet', 'aplikasi', 'loker']",26,17,9,sentuh gambar adap atas pala kau capek tolong tidak pasang loginnya sulit mending pasang joobstreet aplikasi loker,17,17
Sangat membantu sekali...menambah jaringan pertemànan dan koneksi tentu nya,positif,2022-07-08,2022,sangat membantu sekali menambah jaringan pertemànan dan koneksi tentu nya,9,10,sangat membantu sekali menambah jaringan pertemànan dan koneksi tentu nya,10,10,"['sangat', 'membantu', 'sekali', 'menambah', 'jaringan', 'pertemànan', 'dan', 'koneksi', 'tentu', 'nya']","['membantu', 'menambah', 'jaringan', 'pertemànan', 'koneksi', 'nya']",10,6,4,bantu tambah jaring tem nan koneksi nya,6,7
"Aplikasi yang bagus buat mereka yang berkiprah sebagai profesional, karena di sinilah komunitas para profesional dan tempat bertemu para profesional di seluruh dunia",positif,2021-05-09,2021,aplikasi yang bagus buat mereka yang berkiprah sebagai profesional karena di sinilah komunitas para profesional dan tempat bertemu para profesional di seluruh dunia,23,23,aplikasi yang bagus buat mereka yang berkiprah sebagai profesional karena di sinilah komunitas para profesional dan tempat bertemu para profesional di seluruh dunia,23,23,"['aplikasi', 'yang', 'bagus', 'buat', 'mereka', 'yang', 'berkiprah', 'sebagai', 'profesional', 'karena', 'di', 'sinilah', 'komunitas', 'para', 'profesional', 'dan', 'tempat', 'bertemu', 'para', 'profesional', 'di', 'seluruh', 'dunia']","['aplikasi', 'bagus', 'berkiprah', 'profesional', 'komunitas', 'profesional', 'bertemu', 'profesional', 'dunia']",23,9,14,aplikasi bagus kiprah profesional komunitas profesional temu profesional dunia,9,9
apasih linkedin gak bisa diakses terus padahal udh premium mana nanti bayarnya mahal lagi 1jt lebih heran jd males deh buat langganan,negatif,2022-03-10,2022,apasih linkedin gak bisa diakses terus padahal udh premium mana nanti bayarnya mahal lagi jt lebih heran jd males deh buat langganan,22,22,apa sih linkedin tidak bisa diakses terus padahal sudah premium mana nanti bayarnya mahal lagi jt lebih heran jadi malas deh buat langganan,22,23,"['apa', 'sih', 'linkedin', 'tidak', 'bisa', 'diakses', 'terus', 'padahal', 'sudah', 'premium', 'mana', 'nanti', 'bayarnya', 'mahal', 'lagi', 'jt', 'lebih', 'heran', 'jadi', 'malas', 'deh', 'buat', 'langganan']","['sih', 'linkedin', 'tidak', 'diakses', 'premium', 'bayarnya', 'mahal', 'jt', 'heran', 'malas', 'deh', 'langganan']",23,12,11,sih linkedin tidak akses premium bayar mahal jt heran malas deh langgan,12,12
Terjadi masalh terus. Padahal signal full. Jdi ga dpet informasi sama skali.,negatif,2021-11-01,2021,terjadi masalh terus padahal signal full jdi ga dpet informasi sama skali,12,12,terjadi masalh terus padahal signal full jadi tidak dapat informasi sama sekali,12,12,"['terjadi', 'masalh', 'terus', 'padahal', 'signal', 'full', 'jadi', 'tidak', 'dapat', 'informasi', 'sama', 'sekali']","['masalh', 'signal', 'full', 'tidak', 'informasi']",12,5,7,masalh signal full tidak informasi,5,5
Aplikasi bagus untuk mencari lowongan kerja serta refernce.,positif,2022-11-30,2022,aplikasi bagus untuk mencari lowongan kerja serta refernce,8,8,aplikasi bagus untuk mencari lowongan kerja serta refernce,8,8,"['aplikasi', 'bagus', 'untuk', 'mencari', 'lowongan', 'kerja', 'serta', 'refernce']","['aplikasi', 'bagus', 'mencari', 'lowongan', 'kerja', 'refernce']",8,6,2,aplikasi bagus cari lowong kerja refernce,6,6
"Aplikasinya sangat lemot sekarang padahal koneksi buat apapun lancar,mohon diperbaiki agar bisa lancar kembali",negatif,2021-06-03,2021,aplikasinya sangat lemot sekarang padahal koneksi buat apapun lancar mohon diperbaiki agar bisa lancar kembali,14,15,aplikasi nya sangat lambat sekarang padahal koneksi buat apapun lancar mohon di perbaiki agar bisa lancar kembali,15,17,"['aplikasi', 'nya', 'sangat', 'lambat', 'sekarang', 'padahal', 'koneksi', 'buat', 'apapun', 'lancar', 'mohon', 'di', 'perbaiki', 'agar', 'bisa', 'lancar', 'kembali']","['aplikasi', 'nya', 'lambat', 'koneksi', 'apapun', 'lancar', 'mohon', 'perbaiki', 'lancar']",17,9,8,aplikasi nya lambat koneksi apa lancar mohon baik lancar,9,9
"Saya kira, saya tidak perlu aplikasi ini. Karena saya memakai hand phone untuk komunikasi biasa saja",negatif,2023-01-26,2023,saya kira saya tidak perlu aplikasi ini karena saya memakai hand phone untuk komunikasi biasa saja,16,16,saya kira saya tidak perlu aplikasi ini karena saya memakai hand phone untuk komunikasi biasa saja,16,16,"['saya', 'kira', 'saya', 'tidak', 'perlu', 'aplikasi', 'ini', 'karena', 'saya', 'memakai', 'hand', 'phone', 'untuk', 'komunikasi', 'biasa', 'saja']","['tidak', 'aplikasi', 'memakai', 'hand', 'phone', 'komunikasi']",16,6,10,tidak aplikasi pakai hand phone komunikasi,6,6
"Sangat baik,membantu memberi ruang para pencaker dan recruiter untuk saling berkoneksi",positif,2022-05-24,2022,sangat baik membantu memberi ruang para pencaker dan recruiter untuk saling berkoneksi,11,12,sangat baik membantu memberi ruang para pencaker dan recruiter untuk saling berkoneksi,12,12,"['sangat', 'baik', 'membantu', 'memberi', 'ruang', 'para', 'pencaker', 'dan', 'recruiter', 'untuk', 'saling', 'berkoneksi']","['membantu', 'ruang', 'pencaker', 'recruiter', 'berkoneksi']",12,5,7,bantu ruang pencaker recruiter koneksi,5,5
"Apa kali, mau daftar tp ituin gambar dulu, di coba berkali2 salah trs gajelas.",negatif,2022-01-07,2022,apa kali mau daftar tp ituin gambar dulu di coba berkali salah trs gajelas,14,14,apa kali mau daftar tapi ituin gambar dahulu di coba berkali salah terus tidak jelas,14,15,"['apa', 'kali', 'mau', 'daftar', 'tapi', 'ituin', 'gambar', 'dahulu', 'di', 'coba', 'berkali', 'salah', 'terus', 'tidak', 'jelas']","['kali', 'daftar', 'ituin', 'gambar', 'coba', 'berkali', 'salah', 'tidak']",15,8,7,kali daftar ituin gambar coba kali salah tidak,8,8
Aplikasi ini kok maksa sekali harus ada di ponsel Samsung saya tidak bisa dihapus hanya bisa nonaktifkan saja!!,negatif,2021-06-30,2021,aplikasi ini kok maksa sekali harus ada di ponsel samsung saya tidak bisa dihapus hanya bisa nonaktifkan saja,18,18,aplikasi ini kok maksa sekali harus ada di ponsel samsung saya tidak bisa dihapus hanya bisa nonaktifkan saja,18,18,"['aplikasi', 'ini', 'kok', 'maksa', 'sekali', 'harus', 'ada', 'di', 'ponsel', 'samsung', 'saya', 'tidak', 'bisa', 'dihapus', 'hanya', 'bisa', 'nonaktifkan', 'saja']","['aplikasi', 'maksa', 'ponsel', 'samsung', 'tidak', 'dihapus', 'nonaktifkan']",18,7,11,aplikasi maksa ponsel samsung tidak hapus nonaktif,7,7
"Aplikasi yang bagus, tidak hanya untuk apply lowker saja, tapi d sni bisa silahturahmi dengan orang2 hebat dan baik2",positif,2020-12-01,2020,aplikasi yang bagus tidak hanya untuk apply lowker saja tapi d sni bisa silahturahmi dengan orang hebat dan baik,19,19,aplikasi yang bagus tidak hanya untuk apply lowker saja tapi di sini bisa silahturahmi dengan orang hebat dan baik,19,19,"['aplikasi', 'yang', 'bagus', 'tidak', 'hanya', 'untuk', 'apply', 'lowker', 'saja', 'tapi', 'di', 'sini', 'bisa', 'silahturahmi', 'dengan', 'orang', 'hebat', 'dan', 'baik']","['aplikasi', 'bagus', 'tidak', 'apply', 'lowker', 'silahturahmi', 'orang', 'hebat']",19,8,11,aplikasi bagus tidak apply lowker silahturahmi orang hebat,8,8
Sangat membantu sekali dalam hal mencari info lowongab pekerjaan karena terkoneksi secara global,positif,2021-12-10,2021,sangat membantu sekali dalam hal mencari info lowongab pekerjaan karena terkoneksi secara global,13,13,sangat membantu sekali dalam hal mencari informasi lowongab pekerjaan karena terkoneksi secara global,13,13,"['sangat', 'membantu', 'sekali', 'dalam', 'hal', 'mencari', 'informasi', 'lowongab', 'pekerjaan', 'karena', 'terkoneksi', 'secara', 'global']","['membantu', 'mencari', 'informasi', 'lowongab', 'pekerjaan', 'terkoneksi', 'global']",13,7,6,bantu cari informasi lowongab kerja koneksi global,7,7
Saya kira aplikasi ini bisa diinstall di semua perangkat tapi ternyata di android 7.1.1 tidak bisa,negatif,2022-08-16,2022,saya kira aplikasi ini bisa diinstall di semua perangkat tapi ternyata di android tidak bisa,16,15,saya kira aplikasi ini bisa diinstall di semua perangkat tapi ternyata di android tidak bisa,15,15,"['saya', 'kira', 'aplikasi', 'ini', 'bisa', 'diinstall', 'di', 'semua', 'perangkat', 'tapi', 'ternyata', 'di', 'android', 'tidak', 'bisa']","['aplikasi', 'diinstall', 'perangkat', 'android', 'tidak']",15,5,10,aplikasi diinstall perangkat android tidak,5,5
"Akun saya di nonaktifkan terus menerus. Padahal saya gak ngapa ngapain. Saya butuh banget buat tugas kuliah saya, udah bikin 3 kali yang baru , payah banget , nyusahin.",negatif,2020-10-16,2020,akun saya di nonaktifkan terus menerus padahal saya gak ngapa ngapain saya butuh banget buat tugas kuliah saya udah bikin kali yang baru payah banget nyusahin,29,26,akun saya di nonaktifkan terus menerus padahal saya tidak ngapa buat apa saya butuh banget buat tugas kuliah saya sudah bikin kali yang baru payah banget nyusahin,26,27,"['akun', 'saya', 'di', 'nonaktifkan', 'terus', 'menerus', 'padahal', 'saya', 'tidak', 'ngapa', 'buat', 'apa', 'saya', 'butuh', 'banget', 'buat', 'tugas', 'kuliah', 'saya', 'sudah', 'bikin', 'kali', 'yang', 'baru', 'payah', 'banget', 'nyusahin']","['akun', 'nonaktifkan', 'menerus', 'tidak', 'ngapa', 'butuh', 'banget', 'tugas', 'kuliah', 'bikin', 'kali', 'payah', 'banget', 'nyusahin']",27,14,13,akun nonaktif terus tidak ngapa butuh banget tugas kuliah bikin kali payah banget nyusahin,14,14
"Aku kira Aplikasi ini bisa membantu cari kerja,, ternyata cuma curhat² kerja’n doang, kebanyakan cuma pada Share pengalaman doank",negatif,2021-09-24,2021,aku kira aplikasi ini bisa membantu cari kerja ternyata cuma curhat² kerja’n doang kebanyakan cuma pada share pengalaman doank,19,19,aku kira aplikasi ini bisa membantu cari kerja ternyata cuma curhat² kerja ’ dan saja kebanyakan cuma pada share pengalaman doank,19,21,"['aku', 'kira', 'aplikasi', 'ini', 'bisa', 'membantu', 'cari', 'kerja', 'ternyata', 'cuma', 'curhat²', 'kerja', '’', 'dan', 'saja', 'kebanyakan', 'cuma', 'pada', 'share', 'pengalaman', 'doank']","['aplikasi', 'membantu', 'cari', 'kerja', 'curhat²', 'kerja', '’', 'kebanyakan', 'share', 'pengalaman', 'doank']",21,11,10,aplikasi bantu cari kerja curhat kerja banyak share alam doank,11,10
"Sangat menginspirasi dan seneng banget ketemu dgn org2 yg luar biasa di semua bidang terutama bidang (sales, marketing, finance dan operation) 🙏 Sukses selalu bersama Li",positif,2020-06-11,2020,sangat menginspirasi dan seneng banget ketemu dgn org yg luar biasa di semua bidang terutama bidang sales marketing finance dan operation sukses selalu bersama li,26,25,sangat menginspirasi dan senang banget ketemu dengan orang yang luar biasa di semua bidang terutama bidang sales marketing finance dan operation sukses selalu bersama li,25,25,"['sangat', 'menginspirasi', 'dan', 'senang', 'banget', 'ketemu', 'dengan', 'orang', 'yang', 'luar', 'biasa', 'di', 'semua', 'bidang', 'terutama', 'bidang', 'sales', 'marketing', 'finance', 'dan', 'operation', 'sukses', 'selalu', 'bersama', 'li']","['menginspirasi', 'senang', 'banget', 'ketemu', 'orang', 'bidang', 'bidang', 'sales', 'marketing', 'finance', 'operation', 'sukses', 'li']",25,13,12,inspirasi senang banget ketemu orang bidang bidang sales marketing finance operation sukses li,13,13
Terimakasih sudah mengembangkan aplikasi yang menjadi sarana penghubung untuk pencari dan pemberi kerja. God bless you.,positif,2021-11-12,2021,terimakasih sudah mengembangkan aplikasi yang menjadi sarana penghubung untuk pencari dan pemberi kerja god bless you,16,16,terima kasih sudah mengembangkan aplikasi yang menjadi sarana penghubung untuk pencari dan pemberi kerja god bless you,16,17,"['terima', 'kasih', 'sudah', 'mengembangkan', 'aplikasi', 'yang', 'menjadi', 'sarana', 'penghubung', 'untuk', 'pencari', 'dan', 'pemberi', 'kerja', 'god', 'bless', 'you']","['terima', 'kasih', 'mengembangkan', 'aplikasi', 'sarana', 'penghubung', 'pencari', 'pemberi', 'kerja', 'god', 'bless', 'you']",17,12,5,terima kasih kembang aplikasi sarana hubung cari beri kerja god bless you,12,12
Aplikasi yang bagus sekali bisa menjalin dengan para profesional di bidangnya dan tempat mencari pekerjaan baru,positif,2020-08-06,2020,aplikasi yang bagus sekali bisa menjalin dengan para profesional di bidangnya dan tempat mencari pekerjaan baru,16,16,aplikasi yang bagus sekali bisa menjalin dengan para profesional di bidangnya dan tempat mencari pekerjaan baru,16,16,"['aplikasi', 'yang', 'bagus', 'sekali', 'bisa', 'menjalin', 'dengan', 'para', 'profesional', 'di', 'bidangnya', 'dan', 'tempat', 'mencari', 'pekerjaan', 'baru']","['aplikasi', 'bagus', 'menjalin', 'profesional', 'bidangnya', 'mencari', 'pekerjaan']",16,7,9,aplikasi bagus jalin profesional bidang cari kerja,7,7
"Kenapa saya susah gabung padahal email dan kata sandi saya benar tapi kenapa susah masuk, trus kembali ke terus ke verifikasi tebak gambar gak buka buka linkden nya :(",negatif,2021-02-12,2021,kenapa saya susah gabung padahal email dan kata sandi saya benar tapi kenapa susah masuk trus kembali ke terus ke verifikasi tebak gambar gak buka buka linkden nya,29,28,kenapa saya susah gabung padahal email dan kata sandi saya benar tapi kenapa susah masuk terus kembali ke terus ke verifikasi tebak gambar tidak buka buka linkden nya,28,28,"['kenapa', 'saya', 'susah', 'gabung', 'padahal', 'email', 'dan', 'kata', 'sandi', 'saya', 'benar', 'tapi', 'kenapa', 'susah', 'masuk', 'terus', 'kembali', 'ke', 'terus', 'ke', 'verifikasi', 'tebak', 'gambar', 'tidak', 'buka', 'buka', 'linkden', 'nya']","['susah', 'gabung', 'email', 'sandi', 'susah', 'masuk', 'verifikasi', 'tebak', 'gambar', 'tidak', 'buka', 'buka', 'linkden', 'nya']",28,14,14,susah gabung email sandi susah masuk verifikasi tebak gambar tidak buka buka linkden nya,14,14
"Ini apaan sih cuma mau logindoang suruh pilih gambar ke arah atas mulu, dipilih jawaban gak sesuai mulu, cuma mau login doang aja ribet bener",negatif,2022-07-05,2022,ini apaan sih cuma mau logindoang suruh pilih gambar ke arah atas mulu dipilih jawaban gak sesuai mulu cuma mau login doang aja ribet bener,25,25,ini apa sih cuma mau logindoang suruh pilih gambar ke arah atas mulu dipilih jawaban tidak sesuai mulu cuma mau login saja saja rumit benar,25,25,"['ini', 'apa', 'sih', 'cuma', 'mau', 'logindoang', 'suruh', 'pilih', 'gambar', 'ke', 'arah', 'atas', 'mulu', 'dipilih', 'jawaban', 'tidak', 'sesuai', 'mulu', 'cuma', 'mau', 'login', 'saja', 'saja', 'rumit', 'benar']","['sih', 'logindoang', 'suruh', 'pilih', 'gambar', 'arah', 'mulu', 'dipilih', 'tidak', 'sesuai', 'mulu', 'login', 'rumit']",25,13,12,sih logindoang suruh pilih gambar arah mulu pilih tidak sesuai mulu login rumit,13,13
Bermanfaat untuk membangun koneksi baik praktisi profesional maupun dunia kerja,positif,2020-02-14,2020,bermanfaat untuk membangun koneksi baik praktisi profesional maupun dunia kerja,10,10,bermanfaat untuk membangun koneksi baik praktisi profesional maupun dunia kerja,10,10,"['bermanfaat', 'untuk', 'membangun', 'koneksi', 'baik', 'praktisi', 'profesional', 'maupun', 'dunia', 'kerja']","['bermanfaat', 'membangun', 'koneksi', 'praktisi', 'profesional', 'dunia', 'kerja']",10,7,3,manfaat bangun koneksi praktisi profesional dunia kerja,7,7
"Sangat cocok sekali untuk para pencari kerja, menambah koneksi dan berkesempatan mendapatkan pekerjaan baru",positif,2020-10-14,2020,sangat cocok sekali untuk para pencari kerja menambah koneksi dan berkesempatan mendapatkan pekerjaan baru,14,14,sangat cocok sekali untuk para pencari kerja menambah koneksi dan berkesempatan mendapatkan pekerjaan baru,14,14,"['sangat', 'cocok', 'sekali', 'untuk', 'para', 'pencari', 'kerja', 'menambah', 'koneksi', 'dan', 'berkesempatan', 'mendapatkan', 'pekerjaan', 'baru']","['cocok', 'pencari', 'kerja', 'menambah', 'koneksi', 'berkesempatan', 'pekerjaan']",14,7,7,cocok cari kerja tambah koneksi sempat kerja,7,7
"Dulu bagus, tapi sekarang sering stop working, sayang sekali. Mohoh perbaiki. Terimakasih",negatif,2020-08-08,2020,dulu bagus tapi sekarang sering stop working sayang sekali mohoh perbaiki terimakasih,12,12,dahulu bagus tapi sekarang sering stop working sayang sekali mohoh perbaikan terima kasih,12,13,"['dahulu', 'bagus', 'tapi', 'sekarang', 'sering', 'stop', 'working', 'sayang', 'sekali', 'mohoh', 'perbaikan', 'terima', 'kasih']","['bagus', 'stop', 'working', 'sayang', 'mohoh', 'perbaikan', 'terima', 'kasih']",13,8,5,bagus stop working sayang mohoh baik terima kasih,8,8
"Parah,bru mw pake apk nya,eh malah error,padahal data2 uda msuk semua...saya sarankan jangan download...dr pda nyesal nnti..",negatif,2021-04-29,2021,parah bru mw pake apk nya eh malah error padahal data uda msuk semua saya sarankan jangan download dr pda nyesal nnti,17,22,parah baru mau pakai aplikasi nya eh bahkan error padahal data sudah msuk semua saya sarankan jangan unduh dari pda menyesal nanti,22,22,"['parah', 'baru', 'mau', 'pakai', 'aplikasi', 'nya', 'eh', 'bahkan', 'error', 'padahal', 'data', 'sudah', 'msuk', 'semua', 'saya', 'sarankan', 'jangan', 'unduh', 'dari', 'pda', 'menyesal', 'nanti']","['parah', 'pakai', 'aplikasi', 'nya', 'eh', 'error', 'data', 'msuk', 'sarankan', 'unduh', 'pda', 'menyesal']",22,12,10,parah pakai aplikasi nya eh error data msuk saran unduh pda sesal,12,12
"Baru 2 minggu tidak aktif Linkedln, saat buka aplikasi lagi ternyata akun saya di nonaktifkan.",negatif,2020-06-13,2020,baru minggu tidak aktif linkedln saat buka aplikasi lagi ternyata akun saya di nonaktifkan,15,14,baru minggu tidak aktif linkedln saat buka aplikasi lagi ternyata akun saya di nonaktifkan,14,14,"['baru', 'minggu', 'tidak', 'aktif', 'linkedln', 'saat', 'buka', 'aplikasi', 'lagi', 'ternyata', 'akun', 'saya', 'di', 'nonaktifkan']","['minggu', 'tidak', 'aktif', 'linkedln', 'buka', 'aplikasi', 'akun', 'nonaktifkan']",14,8,6,minggu tidak aktif linkedln buka aplikasi akun nonaktif,8,8
Kenapa setiap pake aplikasinya suruh login berulang kali ya. Udah login disuruh login lagi terus menerus,negatif,2022-06-25,2022,kenapa setiap pake aplikasinya suruh login berulang kali ya udah login disuruh login lagi terus menerus,16,16,kenapa setiap pakai aplikasi nya suruh login berulang kali ya sudah login disuruh login lagi terus menerus,16,17,"['kenapa', 'setiap', 'pakai', 'aplikasi', 'nya', 'suruh', 'login', 'berulang', 'kali', 'ya', 'sudah', 'login', 'disuruh', 'login', 'lagi', 'terus', 'menerus']","['pakai', 'aplikasi', 'nya', 'suruh', 'login', 'berulang', 'kali', 'ya', 'login', 'disuruh', 'login', 'menerus']",17,12,5,pakai aplikasi nya suruh login ulang kali ya login suruh login terus,12,12
"aplikasinya gmn sih ,mau login aja susah bgt ,suruh milih gambar di atas gk ad habis""nya :(",negatif,2021-12-01,2021,aplikasinya gmn sih mau login aja susah bgt suruh milih gambar di atas gk ad habis nya,17,17,aplikasi nya bagaimana sih mau login saja susah banget suruh memilih gambar di atas tidak ada habis nya,17,18,"['aplikasi', 'nya', 'bagaimana', 'sih', 'mau', 'login', 'saja', 'susah', 'banget', 'suruh', 'memilih', 'gambar', 'di', 'atas', 'tidak', 'ada', 'habis', 'nya']","['aplikasi', 'nya', 'sih', 'login', 'susah', 'banget', 'suruh', 'memilih', 'gambar', 'tidak', 'habis', 'nya']",18,12,6,aplikasi nya sih login susah banget suruh pilih gambar tidak habis nya,12,12
Aplikasi ga jelas..habis download mau buka tapi kode verifikasi nya ga masuk2.. Padahal sinyal lancar,negatif,2023-03-17,2023,aplikasi ga jelas habis download mau buka tapi kode verifikasi nya ga masuk padahal sinyal lancar,15,16,aplikasi tidak jelas habis unduh mau buka tapi kode verifikasi nya tidak masuk padahal sinyal lancar,16,16,"['aplikasi', 'tidak', 'jelas', 'habis', 'unduh', 'mau', 'buka', 'tapi', 'kode', 'verifikasi', 'nya', 'tidak', 'masuk', 'padahal', 'sinyal', 'lancar']","['aplikasi', 'tidak', 'habis', 'unduh', 'buka', 'kode', 'verifikasi', 'nya', 'tidak', 'masuk', 'sinyal', 'lancar']",16,12,4,aplikasi tidak habis unduh buka kode verifikasi nya tidak masuk sinyal lancar,12,12
"Aplikasi yang sangat bagus untuk pecari kerja, maupun untuk menjalin network dengan orang lain",positif,2021-12-06,2021,aplikasi yang sangat bagus untuk pecari kerja maupun untuk menjalin network dengan orang lain,14,14,aplikasi yang sangat bagus untuk pecari kerja maupun untuk menjalin network dengan orang lain,14,14,"['aplikasi', 'yang', 'sangat', 'bagus', 'untuk', 'pecari', 'kerja', 'maupun', 'untuk', 'menjalin', 'network', 'dengan', 'orang', 'lain']","['aplikasi', 'bagus', 'pecari', 'kerja', 'menjalin', 'network', 'orang']",14,7,7,aplikasi bagus cari kerja jalin network orang,7,7
Aplikaei linkedin sangat membantu saya dalam mencari info pekerjaan & mendapat koneksi dari beberapa perusahaan. Terimakasih,positif,2020-06-15,2020,aplikaei linkedin sangat membantu saya dalam mencari info pekerjaan mendapat koneksi dari beberapa perusahaan terimakasih,16,15,aplikaei linkedin sangat membantu saya dalam mencari informasi pekerjaan mendapat koneksi dari beberapa perusahaan terima kasih,15,16,"['aplikaei', 'linkedin', 'sangat', 'membantu', 'saya', 'dalam', 'mencari', 'informasi', 'pekerjaan', 'mendapat', 'koneksi', 'dari', 'beberapa', 'perusahaan', 'terima', 'kasih']","['aplikaei', 'linkedin', 'membantu', 'mencari', 'informasi', 'pekerjaan', 'koneksi', 'perusahaan', 'terima', 'kasih']",16,10,6,aplikaei linkedin bantu cari informasi kerja koneksi usaha terima kasih,10,10
Aplikasi yang sangat bagus dan sangat bermanfaat bagi saya dan sesama seprofesi saya yaitu sebagai pelaut aplikasi LinkedIn ini sangat bermanfaat,positif,2022-06-18,2022,aplikasi yang sangat bagus dan sangat bermanfaat bagi saya dan sesama seprofesi saya yaitu sebagai pelaut aplikasi linkedin ini sangat bermanfaat,21,21,aplikasi yang sangat bagus dan sangat bermanfaat bagi saya dan sesama seprofesi saya yaitu sebagai pelaut aplikasi linkedin ini sangat bermanfaat,21,21,"['aplikasi', 'yang', 'sangat', 'bagus', 'dan', 'sangat', 'bermanfaat', 'bagi', 'saya', 'dan', 'sesama', 'seprofesi', 'saya', 'yaitu', 'sebagai', 'pelaut', 'aplikasi', 'linkedin', 'ini', 'sangat', 'bermanfaat']","['aplikasi', 'bagus', 'bermanfaat', 'seprofesi', 'pelaut', 'aplikasi', 'linkedin', 'bermanfaat']",21,8,13,aplikasi bagus manfaat profesi laut aplikasi linkedin manfaat,8,8
susah banget buat verifikasi nya. pernyataannya nya ga make sense. tolong dikembangkan lagi aplikasi nya.,negatif,2022-12-22,2022,susah banget buat verifikasi nya pernyataannya nya ga make sense tolong dikembangkan lagi aplikasi nya,15,15,susah banget buat verifikasi nya pernyataannya nya tidak make sense tolong dikembangkan lagi aplikasi nya,15,15,"['susah', 'banget', 'buat', 'verifikasi', 'nya', 'pernyataannya', 'nya', 'tidak', 'make', 'sense', 'tolong', 'dikembangkan', 'lagi', 'aplikasi', 'nya']","['susah', 'banget', 'verifikasi', 'nya', 'pernyataannya', 'nya', 'tidak', 'make', 'sense', 'tolong', 'dikembangkan', 'aplikasi', 'nya']",15,13,2,susah banget verifikasi nya nyata nya tidak make sense tolong kembang aplikasi nya,13,13
Bingkai baru ini merupakan salah satu inovasi LinkedIn yang bagus dan melakukan gerak cepat atas kebutuhan penggunanya.,positif,2020-07-02,2020,bingkai baru ini merupakan salah satu inovasi linkedin yang bagus dan melakukan gerak cepat atas kebutuhan penggunanya,17,17,bingkai baru ini merupakan salah satu inovasi linkedin yang bagus dan melakukan gerak cepat atas kebutuhan penggunanya,17,17,"['bingkai', 'baru', 'ini', 'merupakan', 'salah', 'satu', 'inovasi', 'linkedin', 'yang', 'bagus', 'dan', 'melakukan', 'gerak', 'cepat', 'atas', 'kebutuhan', 'penggunanya']","['bingkai', 'salah', 'inovasi', 'linkedin', 'bagus', 'gerak', 'cepat', 'kebutuhan', 'penggunanya']",17,9,8,bingkai salah inovasi linkedin bagus gerak cepat butuh guna,9,9
Saat uploaded video malah ada bug yg membuat proses uploading lama sekali,negatif,2022-01-18,2022,saat uploaded video malah ada bug yg membuat proses uploading lama sekali,12,12,saat uploaded video bahkan ada bug yang membuat proses uploading lama sekali,12,12,"['saat', 'uploaded', 'video', 'bahkan', 'ada', 'bug', 'yang', 'membuat', 'proses', 'uploading', 'lama', 'sekali']","['uploaded', 'video', 'bug', 'proses', 'uploading']",12,5,7,uploaded video bug proses uploading,5,5
"Saya tidak sengaja merubah menjadi premium ternyata mahal banget,,dan ingin di batalkan susahhh Banget",negatif,2021-12-20,2021,saya tidak sengaja merubah menjadi premium ternyata mahal banget dan ingin di batalkan susahhh banget,14,15,saya tidak sengaja merubah menjadi premium ternyata mahal banget dan ingin di batalkan susahhh banget,15,15,"['saya', 'tidak', 'sengaja', 'merubah', 'menjadi', 'premium', 'ternyata', 'mahal', 'banget', 'dan', 'ingin', 'di', 'batalkan', 'susahhh', 'banget']","['tidak', 'sengaja', 'merubah', 'premium', 'mahal', 'banget', 'batalkan', 'susahhh', 'banget']",15,9,6,tidak sengaja rubah premium mahal banget batal susahhh banget,9,9
Verifikasi captcha terus diulangi padahal pilihan sudah benar. Susah login,negatif,2023-04-16,2023,verifikasi captcha terus diulangi padahal pilihan sudah benar susah login,10,10,verifikasi captcha terus diulangi padahal pilihan sudah benar susah login,10,10,"['verifikasi', 'captcha', 'terus', 'diulangi', 'padahal', 'pilihan', 'sudah', 'benar', 'susah', 'login']","['verifikasi', 'captcha', 'diulangi', 'pilihan', 'susah', 'login']",10,6,4,verifikasi captcha ulang pilih susah login,6,6
F*k mau tinjau lamaran kerja gk bisa udh diklik button tinjau gk guna sama sekali. Sinyal mah ada emg app rusak,negatif,2022-01-12,2022,f k mau tinjau lamaran kerja gk bisa udh diklik button tinjau gk guna sama sekali sinyal mah ada emg app rusak,21,22,f ke mau tinjau lamaran kerja tidak bisa sudah diklik button tinjau tidak guna sama sekali sinyal mah ada memang aplikasi rusak,22,22,"['f', 'ke', 'mau', 'tinjau', 'lamaran', 'kerja', 'tidak', 'bisa', 'sudah', 'diklik', 'button', 'tinjau', 'tidak', 'guna', 'sama', 'sekali', 'sinyal', 'mah', 'ada', 'memang', 'aplikasi', 'rusak']","['f', 'tinjau', 'lamaran', 'kerja', 'tidak', 'diklik', 'button', 'tinjau', 'tidak', 'sinyal', 'mah', 'aplikasi', 'rusak']",22,13,9,f tinjau lamar kerja tidak klik button tinjau tidak sinyal mah aplikasi rusak,13,13
LinkedIn memang mantap.jaringan internasitional yg benar benar sangat membantu sepluruh lapisan masyarakat.sukses selalu...,positif,2022-04-23,2022,linkedin memang mantap jaringan internasitional yg benar benar sangat membantu sepluruh lapisan masyarakat sukses selalu,13,15,linkedin memang mantap jaringan internasitional yang benar benar sangat membantu sepluruh lapisan masyarakat sukses selalu,15,15,"['linkedin', 'memang', 'mantap', 'jaringan', 'internasitional', 'yang', 'benar', 'benar', 'sangat', 'membantu', 'sepluruh', 'lapisan', 'masyarakat', 'sukses', 'selalu']","['linkedin', 'mantap', 'jaringan', 'internasitional', 'membantu', 'sepluruh', 'lapisan', 'masyarakat', 'sukses']",15,9,6,linkedin mantap jaring internasitional bantu sepluruh lapis masyarakat sukses,9,9
Aneh tiap ngisi captcha udah bener tapi outputnya salah mulu hadeuhh gimana ini ko gitu terus yaa kirain udah dibetulin bug nya eh malah masih kaya gini,negatif,2023-04-29,2023,aneh tiap ngisi captcha udah bener tapi outputnya salah mulu hadeuhh gimana ini ko gitu terus yaa kirain udah dibetulin bug nya eh malah masih kaya gini,27,27,aneh tiap mengisi captcha sudah benar tapi outputnya salah mulu hadeuhh bagaimana ini kok begitu terus ya kirain sudah dibetulin bug nya eh bahkan masih kayak begini,27,27,"['aneh', 'tiap', 'mengisi', 'captcha', 'sudah', 'benar', 'tapi', 'outputnya', 'salah', 'mulu', 'hadeuhh', 'bagaimana', 'ini', 'kok', 'begitu', 'terus', 'ya', 'kirain', 'sudah', 'dibetulin', 'bug', 'nya', 'eh', 'bahkan', 'masih', 'kayak', 'begini']","['aneh', 'mengisi', 'captcha', 'outputnya', 'salah', 'mulu', 'hadeuhh', 'ya', 'kirain', 'dibetulin', 'bug', 'nya', 'eh', 'kayak']",27,14,13,aneh isi captcha outputnya salah mulu hadeuhh ya kirain dibetulin bug nya eh kayak,14,14
"Aplikasi mempersulit, mau login aja susah, udah di masukan identitas dan udah jelas gambarnya masih gagal. Harus di antar ke kantor langsung kah?",negatif,2023-05-10,2023,aplikasi mempersulit mau login aja susah udah di masukan identitas dan udah jelas gambarnya masih gagal harus di antar ke kantor langsung kah,23,23,aplikasi mempersulit mau login saja susah sudah di masukan identitas dan sudah jelas gambarnya masih gagal harus di antar ke kantor langsung kah,23,23,"['aplikasi', 'mempersulit', 'mau', 'login', 'saja', 'susah', 'sudah', 'di', 'masukan', 'identitas', 'dan', 'sudah', 'jelas', 'gambarnya', 'masih', 'gagal', 'harus', 'di', 'antar', 'ke', 'kantor', 'langsung', 'kah']","['aplikasi', 'mempersulit', 'login', 'susah', 'masukan', 'identitas', 'gambarnya', 'gagal', 'kantor', 'langsung', 'kah']",23,11,12,aplikasi sulit login susah masuk identitas gambar gagal kantor langsung kah,11,11
Akun saya sudah dibatasi sejak beberapa bulan lalu sampai sekarang. Untuk verifikasi pun tidak ada pemberitahuan di email.,negatif,2022-05-03,2022,akun saya sudah dibatasi sejak beberapa bulan lalu sampai sekarang untuk verifikasi pun tidak ada pemberitahuan di email,18,18,akun saya sudah dibatasi sejak beberapa bulan lalu sampai sekarang untuk verifikasi pun tidak ada pemberitahuan di email,18,18,"['akun', 'saya', 'sudah', 'dibatasi', 'sejak', 'beberapa', 'bulan', 'lalu', 'sampai', 'sekarang', 'untuk', 'verifikasi', 'pun', 'tidak', 'ada', 'pemberitahuan', 'di', 'email']","['akun', 'dibatasi', 'verifikasi', 'tidak', 'pemberitahuan', 'email']",18,6,12,akun batas verifikasi tidak pemberitahuan email,6,6
Saya kasih bintang 1 dulu.. karena saya kesal .. saya kan baru download apk ini bru 1 hari saya sudah di suruh upgrade lagi .. gimna kali,negatif,2020-06-20,2020,saya kasih bintang dulu karena saya kesal saya kan baru download apk ini bru hari saya sudah di suruh upgrade lagi gimna kali,27,23,saya kasih bintang dahulu karena saya kesal saya akan baru unduh aplikasi ini baru hari saya sudah di suruh upgrade lagi bagaimana kali,23,23,"['saya', 'kasih', 'bintang', 'dahulu', 'karena', 'saya', 'kesal', 'saya', 'akan', 'baru', 'unduh', 'aplikasi', 'ini', 'baru', 'hari', 'saya', 'sudah', 'di', 'suruh', 'upgrade', 'lagi', 'bagaimana', 'kali']","['kasih', 'bintang', 'kesal', 'unduh', 'aplikasi', 'suruh', 'upgrade', 'kali']",23,8,15,kasih bintang kesal unduh aplikasi suruh upgrade kali,8,8
Login nya ruwet.. bikin betek bos.. emang gak ada cara login yg lebih gampang...,negatif,2021-06-05,2021,login nya ruwet bikin betek bos emang gak ada cara login yg lebih gampang,14,14,login nya ruwet bikin betek box memang tidak ada cara login yang lebih gampang,14,14,"['login', 'nya', 'ruwet', 'bikin', 'betek', 'box', 'memang', 'tidak', 'ada', 'cara', 'login', 'yang', 'lebih', 'gampang']","['login', 'nya', 'ruwet', 'bikin', 'betek', 'box', 'tidak', 'login', 'gampang']",14,9,5,login nya ruwet bikin betek box tidak login gampang,9,9
"Bagus sekali, mohon agar dipermudah saja settingannya untuk melamar pekerjaannya",positif,2021-10-28,2021,bagus sekali mohon agar dipermudah saja settingannya untuk melamar pekerjaannya,10,10,bagus sekali mohon agar dipermudah saja settingannya untuk melamar pekerjaannya,10,10,"['bagus', 'sekali', 'mohon', 'agar', 'dipermudah', 'saja', 'settingannya', 'untuk', 'melamar', 'pekerjaannya']","['bagus', 'mohon', 'dipermudah', 'settingannya', 'melamar', 'pekerjaannya']",10,6,4,bagus mohon mudah settingannya lamar kerja,6,6
Aplikasi yang sangat membantu bagi temen2 yg sedang mencari pekerjaan dan berbagi informasi,positif,2021-06-30,2021,aplikasi yang sangat membantu bagi temen yg sedang mencari pekerjaan dan berbagi informasi,13,13,aplikasi yang sangat membantu bagi teman yang sedang mencari pekerjaan dan berbagi informasi,13,13,"['aplikasi', 'yang', 'sangat', 'membantu', 'bagi', 'teman', 'yang', 'sedang', 'mencari', 'pekerjaan', 'dan', 'berbagi', 'informasi']","['aplikasi', 'membantu', 'teman', 'mencari', 'pekerjaan', 'berbagi', 'informasi']",13,7,6,aplikasi bantu teman cari kerja bagi informasi,7,7
Update nya keren.. Cuman kok gak ada fitur kita buat cek profile sendiri ya,positif,2020-11-17,2020,update nya keren cuman kok gak ada fitur kita buat cek profile sendiri ya,14,14,diperbarui nya keren cuman kok tidak ada fitur kita buat cek profile sendiri ya,14,14,"['diperbarui', 'nya', 'keren', 'cuman', 'kok', 'tidak', 'ada', 'fitur', 'kita', 'buat', 'cek', 'profile', 'sendiri', 'ya']","['diperbarui', 'nya', 'keren', 'cuman', 'tidak', 'fitur', 'cek', 'profile', 'ya']",14,9,5,baru nya keren cuman tidak fitur cek profile ya,9,9
"Sangat bagus, walau pun ada perbedaan dengan versi web, tapi kinerja tetap optimal.",positif,2023-03-13,2023,sangat bagus walau pun ada perbedaan dengan versi web tapi kinerja tetap optimal,13,13,sangat bagus walau pun ada perbedaan dengan versi web tapi kinerja tetap optimal,13,13,"['sangat', 'bagus', 'walau', 'pun', 'ada', 'perbedaan', 'dengan', 'versi', 'web', 'tapi', 'kinerja', 'tetap', 'optimal']","['bagus', 'perbedaan', 'versi', 'web', 'kinerja', 'optimal']",13,6,7,bagus beda versi web kerja optimal,6,6
"min astaga.. ini gue diminta verifikasi tebak gambar hewan ngadep ke atas. ya mana gue tau jir gambar aja gajelas, burem, warnanya bikin blur kepotong lagi. makan waktu banget loh ini.",negatif,2022-10-03,2022,min astaga ini gue diminta verifikasi tebak gambar hewan ngadep ke atas ya mana gue tau jir gambar aja gajelas burem warnanya bikin blur kepotong lagi makan waktu banget loh ini,31,31,minimal astaga ini saya diminta verifikasi tebak gambar hewan ngadep ke atas ya mana saya tahu jir gambar saja tidak jelas burem warnanya bikin blur terpotong lagi makan waktu banget loh ini,31,32,"['minimal', 'astaga', 'ini', 'saya', 'diminta', 'verifikasi', 'tebak', 'gambar', 'hewan', 'ngadep', 'ke', 'atas', 'ya', 'mana', 'saya', 'tahu', 'jir', 'gambar', 'saja', 'tidak', 'jelas', 'burem', 'warnanya', 'bikin', 'blur', 'terpotong', 'lagi', 'makan', 'waktu', 'banget', 'loh', 'ini']","['minimal', 'astaga', 'verifikasi', 'tebak', 'gambar', 'hewan', 'ngadep', 'ya', 'jir', 'gambar', 'tidak', 'burem', 'warnanya', 'bikin', 'blur', 'terpotong', 'makan', 'banget', 'loh']",32,19,13,minimal astaga verifikasi tebak gambar hewan ngadep ya jir gambar tidak burem warna bikin blur potong makan banget loh,19,19
"Sangat tidak jelas selalu salah saat di verifikasi, asal2 an di step 1-4 bisa ketika di step 5 selalu gagal",negatif,2022-03-21,2022,sangat tidak jelas selalu salah saat di verifikasi asal an di step bisa ketika di step selalu gagal,20,18,sangat tidak jelas selalu salah saat di verifikasi asal an di step bisa ketika di step selalu gagal,18,18,"['sangat', 'tidak', 'jelas', 'selalu', 'salah', 'saat', 'di', 'verifikasi', 'asal', 'an', 'di', 'step', 'bisa', 'ketika', 'di', 'step', 'selalu', 'gagal']","['tidak', 'salah', 'verifikasi', 'an', 'step', 'step', 'gagal']",18,7,11,tidak salah verifikasi an step step gagal,7,7
"apk nya tidak praktis, sudah daftar tapi disuruh verifikasi keamanan berkali"" hufff",negatif,2022-02-16,2022,apk nya tidak praktis sudah daftar tapi disuruh verifikasi keamanan berkali hufff,12,12,aplikasi nya tidak praktis sudah daftar tapi disuruh verifikasi keamanan berkali hufff,12,12,"['aplikasi', 'nya', 'tidak', 'praktis', 'sudah', 'daftar', 'tapi', 'disuruh', 'verifikasi', 'keamanan', 'berkali', 'hufff']","['aplikasi', 'nya', 'tidak', 'praktis', 'daftar', 'disuruh', 'verifikasi', 'keamanan', 'berkali', 'hufff']",12,10,2,aplikasi nya tidak praktis daftar suruh verifikasi aman kali hufff,10,10
Susah sekali untuk membuat akun dan daftar terlalu rumit selalu gagal untuk daftar sebagai pengguna baru,negatif,2020-01-07,2020,susah sekali untuk membuat akun dan daftar terlalu rumit selalu gagal untuk daftar sebagai pengguna baru,16,16,susah sekali untuk membuat akun dan daftar terlalu rumit selalu gagal untuk daftar sebagai pengguna baru,16,16,"['susah', 'sekali', 'untuk', 'membuat', 'akun', 'dan', 'daftar', 'terlalu', 'rumit', 'selalu', 'gagal', 'untuk', 'daftar', 'sebagai', 'pengguna', 'baru']","['susah', 'akun', 'daftar', 'rumit', 'gagal', 'daftar', 'pengguna']",16,7,9,susah akun daftar rumit gagal daftar guna,7,7
Selalu mengirim pemeberitahuan loker ke email tapi pas di coba tidak ada yang cocok,negatif,2022-11-11,2022,selalu mengirim pemeberitahuan loker ke email tapi pas di coba tidak ada yang cocok,14,14,selalu mengirim pemeberitahuan loker ke email tapi pas di coba tidak ada yang cocok,14,14,"['selalu', 'mengirim', 'pemeberitahuan', 'loker', 'ke', 'email', 'tapi', 'pas', 'di', 'coba', 'tidak', 'ada', 'yang', 'cocok']","['mengirim', 'pemeberitahuan', 'loker', 'email', 'pas', 'coba', 'tidak', 'cocok']",14,8,6,kirim pemeberitahuan loker email pas coba tidak cocok,8,8
Terimakasih Linkedln.... aplikasi yang benar benar bgus untuk pencari kerja,positif,2022-03-22,2022,terimakasih linkedln aplikasi yang benar benar bgus untuk pencari kerja,10,10,terima kasih linkedln aplikasi yang benar benar bagus untuk pencari kerja,10,11,"['terima', 'kasih', 'linkedln', 'aplikasi', 'yang', 'benar', 'benar', 'bagus', 'untuk', 'pencari', 'kerja']","['terima', 'kasih', 'linkedln', 'aplikasi', 'bagus', 'pencari', 'kerja']",11,7,4,terima kasih linkedln aplikasi bagus cari kerja,7,7
Terimakasih kepada yang buatnya aplikasi Android ini karna bisa simpan data maupun foto ❤️❤️,positif,2020-02-16,2020,terimakasih kepada yang buatnya aplikasi android ini karna bisa simpan data maupun foto,14,13,terima kasih kepada yang buatnya aplikasi android ini karena bisa simpan data maupun foto,13,14,"['terima', 'kasih', 'kepada', 'yang', 'buatnya', 'aplikasi', 'android', 'ini', 'karena', 'bisa', 'simpan', 'data', 'maupun', 'foto']","['terima', 'kasih', 'buatnya', 'aplikasi', 'android', 'simpan', 'data', 'foto']",14,8,6,terima kasih buat aplikasi android simpan data foto,8,8
"Bermanfaat sih, tapi saya selalu sabar menunggu rezeki dan berusaha terus untuk mencari pekerjaan meskipun belum ada satupun perusahaan yang merekrut saya melalui App LinkedIn ini. ☺️🤲",positif,2021-12-05,2021,bermanfaat sih tapi saya selalu sabar menunggu rezeki dan berusaha terus untuk mencari pekerjaan meskipun belum ada satupun perusahaan yang merekrut saya melalui app linkedin ini,27,26,bermanfaat sih tapi saya selalu sabar menunggu rezeki dan berusaha terus untuk mencari pekerjaan meskipun belum ada satupun perusahaan yang merekrut saya melalui aplikasi linkedin ini,26,26,"['bermanfaat', 'sih', 'tapi', 'saya', 'selalu', 'sabar', 'menunggu', 'rezeki', 'dan', 'berusaha', 'terus', 'untuk', 'mencari', 'pekerjaan', 'meskipun', 'belum', 'ada', 'satupun', 'perusahaan', 'yang', 'merekrut', 'saya', 'melalui', 'aplikasi', 'linkedin', 'ini']","['bermanfaat', 'sih', 'sabar', 'menunggu', 'rezeki', 'berusaha', 'mencari', 'pekerjaan', 'satupun', 'perusahaan', 'merekrut', 'aplikasi', 'linkedin']",26,13,13,manfaat sih sabar tunggu rezeki usaha cari kerja satu usaha rekrut aplikasi linkedin,13,13
Applikasi yang profesional. Banyak membantu orang-orang yang butuh pekerjaan. The Best,positif,2021-01-06,2021,applikasi yang profesional banyak membantu orang orang yang butuh pekerjaan the best,11,12,aplikasi yang profesional banyak membantu orang orang yang butuh pekerjaan the terbaik,12,12,"['aplikasi', 'yang', 'profesional', 'banyak', 'membantu', 'orang', 'orang', 'yang', 'butuh', 'pekerjaan', 'the', 'terbaik']","['aplikasi', 'profesional', 'membantu', 'orang', 'orang', 'butuh', 'pekerjaan', 'the', 'terbaik']",12,9,3,aplikasi profesional bantu orang orang butuh kerja the baik,9,9
"Kesel stlh update gabisa download foto dan video di postingan, padahal perlu bgt.",negatif,2023-03-31,2023,kesel stlh update gabisa download foto dan video di postingan padahal perlu bgt,13,13,kesel setelah diperbarui tidak bisa unduh foto dan video di postingan padahal perlu banget,13,14,"['kesel', 'setelah', 'diperbarui', 'tidak', 'bisa', 'unduh', 'foto', 'dan', 'video', 'di', 'postingan', 'padahal', 'perlu', 'banget']","['kesel', 'diperbarui', 'tidak', 'unduh', 'foto', 'video', 'postingan', 'banget']",14,8,6,kesel baru tidak unduh foto video postingan banget,8,8
"Aplikasi gak guna, banyak iklan2 ga nyambung dari perusahaan2 gak jelas.",negatif,2021-04-24,2021,aplikasi gak guna banyak iklan ga nyambung dari perusahaan gak jelas,11,11,aplikasi tidak guna banyak iklan tidak nyambung dari perusahaan tidak jelas,11,11,"['aplikasi', 'tidak', 'guna', 'banyak', 'iklan', 'tidak', 'nyambung', 'dari', 'perusahaan', 'tidak', 'jelas']","['aplikasi', 'tidak', 'iklan', 'tidak', 'nyambung', 'perusahaan', 'tidak']",11,7,4,aplikasi tidak iklan tidak nyambung usaha tidak,7,7
"Sangat memuaskan untuk pencari kerja, baik lokal maupun luar negri.",positif,2020-10-18,2020,sangat memuaskan untuk pencari kerja baik lokal maupun luar negri,10,10,sangat memuaskan untuk pencari kerja baik lokal maupun luar negri,10,10,"['sangat', 'memuaskan', 'untuk', 'pencari', 'kerja', 'baik', 'lokal', 'maupun', 'luar', 'negri']","['memuaskan', 'pencari', 'kerja', 'lokal', 'negri']",10,5,5,muas cari kerja lokal negri,5,5
"Udah ribet, spam terus di email, dari 2018 sebelum lulus loh, apply ndak ada kelanjutan, malah banyak spam email",negatif,2022-05-30,2022,udah ribet spam terus di email dari sebelum lulus loh apply ndak ada kelanjutan malah banyak spam email,19,18,sudah rumit spam terus di email dari sebelum lulus loh apply tidak ada kelanjutan bahkan banyak spam email,18,18,"['sudah', 'rumit', 'spam', 'terus', 'di', 'email', 'dari', 'sebelum', 'lulus', 'loh', 'apply', 'tidak', 'ada', 'kelanjutan', 'bahkan', 'banyak', 'spam', 'email']","['rumit', 'spam', 'email', 'lulus', 'loh', 'apply', 'tidak', 'kelanjutan', 'spam', 'email']",18,10,8,rumit spam email lulus loh apply tidak lanjut spam email,10,10
bagus banget aplikasi ini .bisa saya mendapatkan pekerjaan melalui aplikasi linkedin sya sangat bertrimaksih.,positif,2020-03-20,2020,bagus banget aplikasi ini bisa saya mendapatkan pekerjaan melalui aplikasi linkedin sya sangat bertrimaksih,14,14,bagus banget aplikasi ini bisa saya mendapatkan pekerjaan melalui aplikasi linkedin saya sangat bertrimaksih,14,14,"['bagus', 'banget', 'aplikasi', 'ini', 'bisa', 'saya', 'mendapatkan', 'pekerjaan', 'melalui', 'aplikasi', 'linkedin', 'saya', 'sangat', 'bertrimaksih']","['bagus', 'banget', 'aplikasi', 'pekerjaan', 'aplikasi', 'linkedin', 'bertrimaksih']",14,7,7,bagus banget aplikasi kerja aplikasi linkedin bertrimaksih,7,7
"Verifikasi kacau, mau bener atau ngasal pasti di awal benar tapi pas gambar terakhir salah",negatif,2023-05-14,2023,verifikasi kacau mau bener atau ngasal pasti di awal benar tapi pas gambar terakhir salah,15,15,verifikasi kacau mau benar atau ngasal pasti di awal benar tapi pas gambar terakhir salah,15,15,"['verifikasi', 'kacau', 'mau', 'benar', 'atau', 'ngasal', 'pasti', 'di', 'awal', 'benar', 'tapi', 'pas', 'gambar', 'terakhir', 'salah']","['verifikasi', 'kacau', 'ngasal', 'pas', 'gambar', 'salah']",15,6,9,verifikasi kacau ngasal pas gambar salah,6,6
Puas dan keren sih menurut saya. Membantu banget update informasi dan pengetahuan.,positif,2022-07-22,2022,puas dan keren sih menurut saya membantu banget update informasi dan pengetahuan,12,12,puas dan keren sih menurut saya membantu banget diperbarui informasi dan pengetahuan,12,12,"['puas', 'dan', 'keren', 'sih', 'menurut', 'saya', 'membantu', 'banget', 'diperbarui', 'informasi', 'dan', 'pengetahuan']","['puas', 'keren', 'sih', 'membantu', 'banget', 'diperbarui', 'informasi', 'pengetahuan']",12,8,4,puas keren sih bantu banget baru informasi tahu,8,8
Kirim notifikasi di tungguin lama gak masuk2. Kirim cara lain( lewat telp) malah g bisa. 😑,negatif,2022-03-19,2022,kirim notifikasi di tungguin lama gak masuk kirim cara lain lewat telp malah g bisa,16,15,kirim notifikasi di tungguin lama tidak masuk kirim cara lain lewat telepon bahkan tidak bisa,15,15,"['kirim', 'notifikasi', 'di', 'tungguin', 'lama', 'tidak', 'masuk', 'kirim', 'cara', 'lain', 'lewat', 'telepon', 'bahkan', 'tidak', 'bisa']","['kirim', 'notifikasi', 'tungguin', 'tidak', 'masuk', 'kirim', 'telepon', 'tidak']",15,8,7,kirim notifikasi tungguin tidak masuk kirim telepon tidak,8,8
Kenapa setiap mau melamar malah di arahkan ke situs web lain lagi malah disuruh buat akun. bukannya klo udh klik lamar langsung kekirim ya??? tp ini malah digiring ke situs web lain lagi merepotkan,negatif,2022-12-17,2022,kenapa setiap mau melamar malah di arahkan ke situs web lain lagi malah disuruh buat akun bukannya klo udh klik lamar langsung kekirim ya tp ini malah digiring ke situs web lain lagi merepotkan,34,34,kenapa setiap mau melamar bahkan di arahkan ke situs web lain lagi bahkan disuruh buat akun bukannya kalau sudah klik lamar langsung kekirim ya tapi ini bahkan digiring ke situs web lain lagi merepotkan,34,34,"['kenapa', 'setiap', 'mau', 'melamar', 'bahkan', 'di', 'arahkan', 'ke', 'situs', 'web', 'lain', 'lagi', 'bahkan', 'disuruh', 'buat', 'akun', 'bukannya', 'kalau', 'sudah', 'klik', 'lamar', 'langsung', 'kekirim', 'ya', 'tapi', 'ini', 'bahkan', 'digiring', 'ke', 'situs', 'web', 'lain', 'lagi', 'merepotkan']","['melamar', 'arahkan', 'situs', 'web', 'disuruh', 'akun', 'klik', 'lamar', 'langsung', 'kekirim', 'ya', 'digiring', 'situs', 'web', 'merepotkan']",34,15,19,lamar arah situs web suruh akun klik lamar langsung kirim ya giring situs web repot,15,15
"Verifikasinya aneh banget, padahal udh ambil yang menghadap ke atas, masih aja salah2 terus",negatif,2022-10-23,2022,verifikasinya aneh banget padahal udh ambil yang menghadap ke atas masih aja salah terus,14,14,verifikasinya aneh banget padahal sudah ambil yang menghadap ke atas masih saja salah terus,14,14,"['verifikasinya', 'aneh', 'banget', 'padahal', 'sudah', 'ambil', 'yang', 'menghadap', 'ke', 'atas', 'masih', 'saja', 'salah', 'terus']","['verifikasinya', 'aneh', 'banget', 'ambil', 'menghadap', 'salah']",14,6,8,verifikasi aneh banget ambil hadap salah,6,6
"Aplikasi sosial media yang sangat positif, mudah-mudahan bisa terjaga seterusnya.",positif,2020-07-13,2020,aplikasi sosial media yang sangat positif mudah mudahan bisa terjaga seterusnya,10,11,aplikasi sosial media yang sangat positif mudah mudahan bisa terjaga seterusnya,11,11,"['aplikasi', 'sosial', 'media', 'yang', 'sangat', 'positif', 'mudah', 'mudahan', 'bisa', 'terjaga', 'seterusnya']","['aplikasi', 'sosial', 'media', 'positif', 'mudah', 'mudahan', 'terjaga']",11,7,4,aplikasi sosial media positif mudah mudah jaga,7,7
Sangat memudahkan dan salah satu pilihan tepat dalam membantu mencari pekerjaan.,positif,2022-02-14,2022,sangat memudahkan dan salah satu pilihan tepat dalam membantu mencari pekerjaan,11,11,sangat memudahkan dan salah satu pilihan tepat dalam membantu mencari pekerjaan,11,11,"['sangat', 'memudahkan', 'dan', 'salah', 'satu', 'pilihan', 'tepat', 'dalam', 'membantu', 'mencari', 'pekerjaan']","['memudahkan', 'salah', 'pilihan', 'membantu', 'mencari', 'pekerjaan']",11,6,5,mudah salah pilih bantu cari kerja,6,6
Membantu dalam pekerjaan saya sebagai marketing bisa bertemu profesional...tapi sayang kok saya ga bisa kirim video di status.. Mohon di respon dong admin,positif,2020-03-06,2020,membantu dalam pekerjaan saya sebagai marketing bisa bertemu profesional tapi sayang kok saya ga bisa kirim video di status mohon di respon dong admin,23,24,membantu dalam pekerjaan saya sebagai marketing bisa bertemu profesional tapi sayang kok saya tidak bisa kirim video di status mohon di respons dong admin,24,24,"['membantu', 'dalam', 'pekerjaan', 'saya', 'sebagai', 'marketing', 'bisa', 'bertemu', 'profesional', 'tapi', 'sayang', 'kok', 'saya', 'tidak', 'bisa', 'kirim', 'video', 'di', 'status', 'mohon', 'di', 'respons', 'dong', 'admin']","['membantu', 'pekerjaan', 'marketing', 'bertemu', 'profesional', 'sayang', 'tidak', 'kirim', 'video', 'status', 'mohon', 'respons', 'admin']",24,13,11,bantu kerja marketing temu profesional sayang tidak kirim video status mohon respons admin,13,13
"Kalian ini mempermainkan orang. Lebih 10 kali saya mencoba daftar. Verifikasi lihat keatas, 1 s.d 4 ok, masuk yang kelima salah coba lagi. Begitu seterusnya. Sampai lebih 10 kali. Kau makan saja aplikasi kau ini, sakit aja hati orang kau buat.",negatif,2022-10-25,2022,kalian ini mempermainkan orang lebih kali saya mencoba daftar verifikasi lihat keatas s d ok masuk yang kelima salah coba lagi begitu seterusnya sampai lebih kali kau makan saja aplikasi kau ini sakit aja hati orang kau buat,41,38,kalian ini mempermainkan orang lebih kali saya mencoba daftar verifikasi lihat keatas s di oke masuk yang kelima salah coba lagi begitu seterusnya sampai lebih kali kau makan saja aplikasi kau ini sakit saja hati orang kau buat,38,38,"['kalian', 'ini', 'mempermainkan', 'orang', 'lebih', 'kali', 'saya', 'mencoba', 'daftar', 'verifikasi', 'lihat', 'keatas', 's', 'di', 'oke', 'masuk', 'yang', 'kelima', 'salah', 'coba', 'lagi', 'begitu', 'seterusnya', 'sampai', 'lebih', 'kali', 'kau', 'makan', 'saja', 'aplikasi', 'kau', 'ini', 'sakit', 'saja', 'hati', 'orang', 'kau', 'buat']","['mempermainkan', 'orang', 'kali', 'mencoba', 'daftar', 'verifikasi', 'lihat', 'keatas', 's', 'oke', 'masuk', 'salah', 'coba', 'kali', 'kau', 'makan', 'aplikasi', 'kau', 'sakit', 'hati', 'orang', 'kau']",38,22,16,main orang kali coba daftar verifikasi lihat atas s oke masuk salah coba kali kau makan aplikasi kau sakit hati orang kau,22,22
"Sangat bagus,walaupun saya sama sekali belum pernah memdapat kan pekerjaan dari linkedln,tetap semangat dan berusaha",negatif,2020-10-02,2020,sangat bagus walaupun saya sama sekali belum pernah memdapat kan pekerjaan dari linkedln tetap semangat dan berusaha,15,17,sangat bagus walaupun saya sama sekali belum pernah memdapat akan pekerjaan dari linkedln tetap semangat dan berusaha,17,17,"['sangat', 'bagus', 'walaupun', 'saya', 'sama', 'sekali', 'belum', 'pernah', 'memdapat', 'akan', 'pekerjaan', 'dari', 'linkedln', 'tetap', 'semangat', 'dan', 'berusaha']","['bagus', 'memdapat', 'pekerjaan', 'linkedln', 'semangat', 'berusaha']",17,6,11,bagus memdapat kerja linkedln semangat usaha,6,6
"Sumber informasi yg akurat dan luas sangat diperlukan di era sekarang, baik informasi peluang kerja atau informasi jaringan bisnis seperti yg di Linkedin.",positif,2021-07-14,2021,sumber informasi yg akurat dan luas sangat diperlukan di era sekarang baik informasi peluang kerja atau informasi jaringan bisnis seperti yg di linkedin,23,23,sumber informasi yang akurat dan luas sangat diperlukan di era sekarang baik informasi peluang kerja atau informasi jaringan bisnis seperti yang di linkedin,23,23,"['sumber', 'informasi', 'yang', 'akurat', 'dan', 'luas', 'sangat', 'diperlukan', 'di', 'era', 'sekarang', 'baik', 'informasi', 'peluang', 'kerja', 'atau', 'informasi', 'jaringan', 'bisnis', 'seperti', 'yang', 'di', 'linkedin']","['sumber', 'informasi', 'akurat', 'luas', 'era', 'informasi', 'peluang', 'kerja', 'informasi', 'jaringan', 'bisnis', 'linkedin']",23,12,11,sumber informasi akurat luas era informasi peluang kerja informasi jaring bisnis linkedin,12,12
"Aplikasi yang bagus, sangat membantu terutama jika mau kerja keluar negeri.",positif,2022-05-05,2022,aplikasi yang bagus sangat membantu terutama jika mau kerja keluar negeri,11,11,aplikasi yang bagus sangat membantu terutama jika mau kerja keluar negeri,11,11,"['aplikasi', 'yang', 'bagus', 'sangat', 'membantu', 'terutama', 'jika', 'mau', 'kerja', 'keluar', 'negeri']","['aplikasi', 'bagus', 'membantu', 'kerja', 'negeri']",11,5,6,aplikasi bagus bantu kerja negeri,5,5
Aplikasi linkedin memberi kemudahan saya dalam mengenalkan profil dan profesi saya ke perusahaan yang mencari profesi yg selaras. Terima kasih linkedin.,positif,2020-02-14,2020,aplikasi linkedin memberi kemudahan saya dalam mengenalkan profil dan profesi saya ke perusahaan yang mencari profesi yg selaras terima kasih linkedin,21,21,aplikasi linkedin memberi kemudahan saya dalam mengenalkan profil dan profesi saya ke perusahaan yang mencari profesi yang selaras terima kasih linkedin,21,21,"['aplikasi', 'linkedin', 'memberi', 'kemudahan', 'saya', 'dalam', 'mengenalkan', 'profil', 'dan', 'profesi', 'saya', 'ke', 'perusahaan', 'yang', 'mencari', 'profesi', 'yang', 'selaras', 'terima', 'kasih', 'linkedin']","['aplikasi', 'linkedin', 'kemudahan', 'mengenalkan', 'profil', 'profesi', 'perusahaan', 'mencari', 'profesi', 'selaras', 'terima', 'kasih', 'linkedin']",21,13,8,aplikasi linkedin mudah kenal profil profesi usaha cari profesi selaras terima kasih linkedin,13,13
Sangat berguna bagi saya untk terkoneksi dgn semua teman/relasi dan bermanfaat jika sdg butuh loker,positif,2022-04-02,2022,sangat berguna bagi saya untk terkoneksi dgn semua teman relasi dan bermanfaat jika sdg butuh loker,15,16,sangat berguna bagi saya untuk terkoneksi dengan semua teman relasi dan bermanfaat jika sedang butuh loker,16,16,"['sangat', 'berguna', 'bagi', 'saya', 'untuk', 'terkoneksi', 'dengan', 'semua', 'teman', 'relasi', 'dan', 'bermanfaat', 'jika', 'sedang', 'butuh', 'loker']","['berguna', 'terkoneksi', 'teman', 'relasi', 'bermanfaat', 'butuh', 'loker']",16,7,9,guna koneksi teman relasi manfaat butuh loker,7,7
Komunikasi mudah dan banyak info2 terupdate yang bisa dilihat setiap saat.,positif,2020-02-14,2020,komunikasi mudah dan banyak info terupdate yang bisa dilihat setiap saat,11,11,komunikasi mudah dan banyak informasi terupdate yang bisa dilihat setiap saat,11,11,"['komunikasi', 'mudah', 'dan', 'banyak', 'informasi', 'terupdate', 'yang', 'bisa', 'dilihat', 'setiap', 'saat']","['komunikasi', 'mudah', 'informasi', 'terupdate']",11,4,7,komunikasi mudah informasi terupdate,4,4
"Kenapa ya akun nya terus saja keluar,,terus mau login malahan ada pemberihatuan akun di blok,padahal saya belum pernah buat apa,tolong dong yang tau",negatif,2020-12-19,2020,kenapa ya akun nya terus saja keluar terus mau login malahan ada pemberihatuan akun di blok padahal saya belum pernah buat apa tolong dong yang tau,23,26,kenapa ya akun nya terus saja keluar terus mau login malahan ada pemberihatuan akun di blok padahal saya belum pernah buat apa tolong dong yang tahu,26,26,"['kenapa', 'ya', 'akun', 'nya', 'terus', 'saja', 'keluar', 'terus', 'mau', 'login', 'malahan', 'ada', 'pemberihatuan', 'akun', 'di', 'blok', 'padahal', 'saya', 'belum', 'pernah', 'buat', 'apa', 'tolong', 'dong', 'yang', 'tahu']","['ya', 'akun', 'nya', 'login', 'pemberihatuan', 'akun', 'blok', 'tolong']",26,8,18,ya akun nya login pemberihatuan akun blok tolong,8,8
"Sumpahhh ya mau riset sandi cuma verikasi verikasi trusss gada slesainya cuma dimuter muterin aja ga slesai"" mkasutnya gimana sih ini aplikasinya udah di update udah masih aja sama!.",negatif,2023-02-15,2023,sumpahhh ya mau riset sandi cuma verikasi verikasi trusss gada slesainya cuma dimuter muterin aja ga slesai mkasutnya gimana sih ini aplikasinya udah di update udah masih aja sama,29,29,sumpahhh ya mau riset sandi cuma verikasi verikasi trusss tidak ada slesainya cuma dimuter muterin saja tidak selesai mkasutnya bagaimana sih ini aplikasi nya sudah di diperbarui sudah masih saja sama,29,31,"['sumpahhh', 'ya', 'mau', 'riset', 'sandi', 'cuma', 'verikasi', 'verikasi', 'trusss', 'tidak', 'ada', 'slesainya', 'cuma', 'dimuter', 'muterin', 'saja', 'tidak', 'selesai', 'mkasutnya', 'bagaimana', 'sih', 'ini', 'aplikasi', 'nya', 'sudah', 'di', 'diperbarui', 'sudah', 'masih', 'saja', 'sama']","['sumpahhh', 'ya', 'riset', 'sandi', 'verikasi', 'verikasi', 'trusss', 'tidak', 'slesainya', 'dimuter', 'muterin', 'tidak', 'selesai', 'mkasutnya', 'sih', 'aplikasi', 'nya', 'diperbarui']",31,18,13,sumpahhh ya riset sandi verikasi verikasi trusss tidak slesainya dimuter muterin tidak selesai mkasutnya sih aplikasi nya baru,18,18
"Sangat bagus dan inovatif dalam lingkungan dunia kerja, tapi terlali commercial harga premiumnya sangaaaaat mahal",positif,2022-03-20,2022,sangat bagus dan inovatif dalam lingkungan dunia kerja tapi terlali commercial harga premiumnya sangaaaaat mahal,15,15,sangat bagus dan inovatif dalam lingkungan dunia kerja tapi terlali commercial harga premiumnya sangaaaaat mahal,15,15,"['sangat', 'bagus', 'dan', 'inovatif', 'dalam', 'lingkungan', 'dunia', 'kerja', 'tapi', 'terlali', 'commercial', 'harga', 'premiumnya', 'sangaaaaat', 'mahal']","['bagus', 'inovatif', 'lingkungan', 'dunia', 'kerja', 'terlali', 'commercial', 'harga', 'premiumnya', 'sangaaaaat', 'mahal']",15,11,4,bagus inovatif lingkung dunia kerja lali commercial harga premium sangaaaaat mahal,11,11
"Periksa keamanan saat masuk login yang tidak jelas maunya ap, terimakasih",negatif,2021-10-30,2021,periksa keamanan saat masuk login yang tidak jelas maunya ap terimakasih,11,11,periksa keamanan saat masuk login yang tidak jelas maunya apa terima kasih,11,12,"['periksa', 'keamanan', 'saat', 'masuk', 'login', 'yang', 'tidak', 'jelas', 'maunya', 'apa', 'terima', 'kasih']","['periksa', 'keamanan', 'masuk', 'login', 'tidak', 'maunya', 'terima', 'kasih']",12,8,4,periksa aman masuk login tidak mau terima kasih,8,8
Sangat membantu mendapatkan jaringan untuk pekerjaan. Terima kasih. Sukeses selalu.,positif,2020-04-09,2020,sangat membantu mendapatkan jaringan untuk pekerjaan terima kasih sukeses selalu,10,10,sangat membantu mendapatkan jaringan untuk pekerjaan terima kasih sukeses selalu,10,10,"['sangat', 'membantu', 'mendapatkan', 'jaringan', 'untuk', 'pekerjaan', 'terima', 'kasih', 'sukeses', 'selalu']","['membantu', 'jaringan', 'pekerjaan', 'terima', 'kasih', 'sukeses']",10,6,4,bantu jaring kerja terima kasih sukeses,6,6
"Akun saya selalu keluar sendiri, pas mau login lewat google ga bisa, terus login manual juga gabisa tulisannya menunggu terus, ini gimana sih,",negatif,2021-08-16,2021,akun saya selalu keluar sendiri pas mau login lewat google ga bisa terus login manual juga gabisa tulisannya menunggu terus ini gimana sih,23,23,akun saya selalu keluar sendiri pas mau login lewat google tidak bisa terus login manual juga tidak bisa tulisannya menunggu terus ini bagaimana sih,23,24,"['akun', 'saya', 'selalu', 'keluar', 'sendiri', 'pas', 'mau', 'login', 'lewat', 'google', 'tidak', 'bisa', 'terus', 'login', 'manual', 'juga', 'tidak', 'bisa', 'tulisannya', 'menunggu', 'terus', 'ini', 'bagaimana', 'sih']","['akun', 'pas', 'login', 'google', 'tidak', 'login', 'manual', 'tidak', 'tulisannya', 'menunggu', 'sih']",24,11,13,akun pas login google tidak login manual tidak tulis tunggu sih,11,11
LinkedIn semoga lebih bermanfaat untuk para pencari kerja dan lapangan kerja. Dan perbarui LinkedIn dari tampilan untuk tambah lebih mudah dimengerti orang... Semoga jadi yang paling Baik 🤲,positif,2023-03-11,2023,linkedin semoga lebih bermanfaat untuk para pencari kerja dan lapangan kerja dan perbarui linkedin dari tampilan untuk tambah lebih mudah dimengerti orang semoga jadi yang paling baik,28,27,linkedin semoga lebih bermanfaat untuk para pencari kerja dan lapangan kerja dan perbarui linkedin dari tampilan untuk tambah lebih mudah dimengerti orang semoga jadi yang paling baik,27,27,"['linkedin', 'semoga', 'lebih', 'bermanfaat', 'untuk', 'para', 'pencari', 'kerja', 'dan', 'lapangan', 'kerja', 'dan', 'perbarui', 'linkedin', 'dari', 'tampilan', 'untuk', 'tambah', 'lebih', 'mudah', 'dimengerti', 'orang', 'semoga', 'jadi', 'yang', 'paling', 'baik']","['linkedin', 'semoga', 'bermanfaat', 'pencari', 'kerja', 'lapangan', 'kerja', 'perbarui', 'linkedin', 'tampilan', 'mudah', 'dimengerti', 'orang', 'semoga']",27,14,13,linkedin moga manfaat cari kerja lapang kerja baru linkedin tampil mudah erti orang moga,14,14
"Mohon masukan Linked in saya pada menu tambah pengalaman bagian *industri tidak bisa diedit atau keluar kata kunci, adakah solusi?",negatif,2022-03-25,2022,mohon masukan linked in saya pada menu tambah pengalaman bagian industri tidak bisa diedit atau keluar kata kunci adakah solusi,20,20,mohon masukan linked in saya pada menu tambah pengalaman bagian industri tidak bisa diedit atau keluar kata kunci adakah solusi,20,20,"['mohon', 'masukan', 'linked', 'in', 'saya', 'pada', 'menu', 'tambah', 'pengalaman', 'bagian', 'industri', 'tidak', 'bisa', 'diedit', 'atau', 'keluar', 'kata', 'kunci', 'adakah', 'solusi']","['mohon', 'masukan', 'linked', 'in', 'menu', 'pengalaman', 'industri', 'tidak', 'diedit', 'kunci', 'adakah', 'solusi']",20,12,8,mohon masuk linked in menu alam industri tidak edit kunci ada solusi,12,12
Thank you aplikasinya ga cuma cari loker aja cuma buka relasi lebih luas. 😊👍👍👍,positif,2020-08-31,2020,thank you aplikasinya ga cuma cari loker aja cuma buka relasi lebih luas,14,13,terima kasih you aplikasi nya tidak cuma cari loker saja cuma buka relasi lebih luas,13,15,"['terima', 'kasih', 'you', 'aplikasi', 'nya', 'tidak', 'cuma', 'cari', 'loker', 'saja', 'cuma', 'buka', 'relasi', 'lebih', 'luas']","['terima', 'kasih', 'you', 'aplikasi', 'nya', 'tidak', 'cari', 'loker', 'buka', 'relasi', 'luas']",15,11,4,terima kasih you aplikasi nya tidak cari loker buka relasi luas,11,11
"Sangat sulit mengupload dokumen sertifikat, sortirnya tidak bisa keinginan user",negatif,2022-06-01,2022,sangat sulit mengupload dokumen sertifikat sortirnya tidak bisa keinginan user,10,10,sangat sulit mengupload dokumen sertifikat sortirnya tidak bisa keinginan user,10,10,"['sangat', 'sulit', 'mengupload', 'dokumen', 'sertifikat', 'sortirnya', 'tidak', 'bisa', 'keinginan', 'user']","['sulit', 'mengupload', 'dokumen', 'sertifikat', 'sortirnya', 'tidak', 'user']",10,7,3,sulit mengupload dokumen sertifikat sortir tidak user,7,7
Perbaiki aplikasi anda.. Kendala login verifikasi yg terus berulang... Bintang satu untuk apk anda.,negatif,2023-05-26,2023,perbaiki aplikasi anda kendala login verifikasi yg terus berulang bintang satu untuk apk anda,14,14,perbaikan aplikasi anda kendala login verifikasi yang terus berulang bintang satu untuk aplikasi anda,14,14,"['perbaikan', 'aplikasi', 'anda', 'kendala', 'login', 'verifikasi', 'yang', 'terus', 'berulang', 'bintang', 'satu', 'untuk', 'aplikasi', 'anda']","['perbaikan', 'aplikasi', 'kendala', 'login', 'verifikasi', 'berulang', 'bintang', 'aplikasi']",14,8,6,baik aplikasi kendala login verifikasi ulang bintang aplikasi,8,8
"Mohon diperbaiki,sudah verifikasi dan verifikasi lagi terus menurus kapan selesainya nih padahal jawaban saya benar kenapa dikasih lagi",negatif,2022-07-31,2022,mohon diperbaiki sudah verifikasi dan verifikasi lagi terus menurus kapan selesainya nih padahal jawaban saya benar kenapa dikasih lagi,18,19,mohon di perbaiki sudah verifikasi dan verifikasi lagi terus menurus kapan selesainya nih padahal jawaban saya benar kenapa dikasih lagi,19,20,"['mohon', 'di', 'perbaiki', 'sudah', 'verifikasi', 'dan', 'verifikasi', 'lagi', 'terus', 'menurus', 'kapan', 'selesainya', 'nih', 'padahal', 'jawaban', 'saya', 'benar', 'kenapa', 'dikasih', 'lagi']","['mohon', 'perbaiki', 'verifikasi', 'verifikasi', 'menurus', 'selesainya', 'nih', 'dikasih']",20,8,12,mohon baik verifikasi verifikasi turus selesai nih kasih,8,8
Aplikasi keren untuk menambah jejaring dan support karir..,positif,2020-10-28,2020,aplikasi keren untuk menambah jejaring dan support karir,8,8,aplikasi keren untuk menambah jejaring dan support karir,8,8,"['aplikasi', 'keren', 'untuk', 'menambah', 'jejaring', 'dan', 'support', 'karir']","['aplikasi', 'keren', 'menambah', 'jejaring', 'support', 'karir']",8,6,2,aplikasi keren tambah jejaring support karir,6,6
"Sumpah saya kira saya aja yang ngk bisa login, please lah di perbaiki bug nya",negatif,2023-05-14,2023,sumpah saya kira saya aja yang ngk bisa login please lah di perbaiki bug nya,15,15,sumpah saya kira saya saja yang tidak bisa login please lah di perbaikan bug nya,15,15,"['sumpah', 'saya', 'kira', 'saya', 'saja', 'yang', 'tidak', 'bisa', 'login', 'please', 'lah', 'di', 'perbaikan', 'bug', 'nya']","['sumpah', 'tidak', 'login', 'please', 'perbaikan', 'bug', 'nya']",15,7,8,sumpah tidak login please baik bug nya,7,7
"Aplikasi kontol, gua udah punya akun bangsat mau masuk kagak bisa gimana caranya, suruh recapcha trus ttep gak bisa masuk anjing, gak usah di download gak guna",negatif,2020-04-20,2020,aplikasi kontol gua udah punya akun bangsat mau masuk kagak bisa gimana caranya suruh recapcha trus ttep gak bisa masuk anjing gak usah di download gak guna,27,27,aplikasi kontol saya sudah punya akun bangsat mau masuk tidak bisa bagaimana caranya suruh recapcha terus ttep tidak bisa masuk anjing tidak usah di unduh tidak guna,27,27,"['aplikasi', 'kontol', 'saya', 'sudah', 'punya', 'akun', 'bangsat', 'mau', 'masuk', 'tidak', 'bisa', 'bagaimana', 'caranya', 'suruh', 'recapcha', 'terus', 'ttep', 'tidak', 'bisa', 'masuk', 'anjing', 'tidak', 'usah', 'di', 'unduh', 'tidak', 'guna']","['aplikasi', 'kontol', 'akun', 'bangsat', 'masuk', 'tidak', 'suruh', 'recapcha', 'ttep', 'tidak', 'masuk', 'anjing', 'tidak', 'unduh', 'tidak']",27,15,12,aplikasi kontol akun bangsat masuk tidak suruh recapcha ttep tidak masuk anjing tidak unduh tidak,15,15
Aplikasi sangat bermanfaat untuk dunia kerja dan pendidikan secara profesional,positif,2021-06-05,2021,aplikasi sangat bermanfaat untuk dunia kerja dan pendidikan secara profesional,10,10,aplikasi sangat bermanfaat untuk dunia kerja dan pendidikan secara profesional,10,10,"['aplikasi', 'sangat', 'bermanfaat', 'untuk', 'dunia', 'kerja', 'dan', 'pendidikan', 'secara', 'profesional']","['aplikasi', 'bermanfaat', 'dunia', 'kerja', 'pendidikan', 'profesional']",10,6,4,aplikasi manfaat dunia kerja didik profesional,6,6
Tidak bisa buat akun.. cek ulasan ternyata memang banyak yang tidak bisa buat akun.. apa masalahnya? Kalau memang tidak mau memberi bantuan lebih baik hapus aplikasi ini.,negatif,2021-09-22,2021,tidak bisa buat akun cek ulasan ternyata memang banyak yang tidak bisa buat akun apa masalahnya kalau memang tidak mau memberi bantuan lebih baik hapus aplikasi ini,27,27,tidak bisa buat akun cek ulasan ternyata memang banyak yang tidak bisa buat akun apa masalahnya kalau memang tidak mau memberi bantuan lebih baik hapus aplikasi ini,27,27,"['tidak', 'bisa', 'buat', 'akun', 'cek', 'ulasan', 'ternyata', 'memang', 'banyak', 'yang', 'tidak', 'bisa', 'buat', 'akun', 'apa', 'masalahnya', 'kalau', 'memang', 'tidak', 'mau', 'memberi', 'bantuan', 'lebih', 'baik', 'hapus', 'aplikasi', 'ini']","['tidak', 'akun', 'cek', 'ulasan', 'tidak', 'akun', 'tidak', 'bantuan', 'hapus', 'aplikasi']",27,10,17,tidak akun cek ulas tidak akun tidak bantu hapus aplikasi,10,10
"Woi lah buat login aja susah buat human verifikasinya. Apps nya mulai rusak, tolong perbaiki",negatif,2023-05-19,2023,woi lah buat login aja susah buat human verifikasinya apps nya mulai rusak tolong perbaiki,15,15,woi lah buat login saja susah buat human verifikasinya aplikasi nya mulai rusak tolong perbaikan,15,15,"['woi', 'lah', 'buat', 'login', 'saja', 'susah', 'buat', 'human', 'verifikasinya', 'aplikasi', 'nya', 'mulai', 'rusak', 'tolong', 'perbaikan']","['woi', 'login', 'susah', 'human', 'verifikasinya', 'aplikasi', 'nya', 'rusak', 'tolong', 'perbaikan']",15,10,5,woi login susah human verifikasi aplikasi nya rusak tolong baik,10,10
Bagus infonya dg banyak teman yg rata2 profesional carrier dan pemikirannya...good very good,positif,2020-02-17,2020,bagus infonya dg banyak teman yg rata profesional carrier dan pemikirannya good very good,13,14,bagus informasinya dengan banyak teman yang rata profesional carrier dan pemikirannya bagus sangat bagus,14,14,"['bagus', 'informasinya', 'dengan', 'banyak', 'teman', 'yang', 'rata', 'profesional', 'carrier', 'dan', 'pemikirannya', 'bagus', 'sangat', 'bagus']","['bagus', 'informasinya', 'teman', 'profesional', 'carrier', 'pemikirannya', 'bagus', 'bagus']",14,8,6,bagus informasi teman profesional carrier pikir bagus bagus,8,8
Salah satu platform media sosial yang luar biasa. Lebih tepatnya adalah platform untuk personal branding.,positif,2020-07-06,2020,salah satu platform media sosial yang luar biasa lebih tepatnya adalah platform untuk personal branding,15,15,salah satu platform media sosial yang luar biasa lebih tepatnya adalah platform untuk personal branding,15,15,"['salah', 'satu', 'platform', 'media', 'sosial', 'yang', 'luar', 'biasa', 'lebih', 'tepatnya', 'adalah', 'platform', 'untuk', 'personal', 'branding']","['salah', 'platform', 'media', 'sosial', 'tepatnya', 'platform', 'personal', 'branding']",15,8,7,salah platform media sosial tepat platform personal branding,8,8
"saya membantu untuk mencari info sekitar pekerjaan,sehingga bisa melihat profile semua para pencari loker,",positif,2020-06-14,2020,saya membantu untuk mencari info sekitar pekerjaan sehingga bisa melihat profile semua para pencari loker,14,15,saya membantu untuk mencari informasi sekitar pekerjaan sehingga bisa melihat profile semua para pencari loker,15,15,"['saya', 'membantu', 'untuk', 'mencari', 'informasi', 'sekitar', 'pekerjaan', 'sehingga', 'bisa', 'melihat', 'profile', 'semua', 'para', 'pencari', 'loker']","['membantu', 'mencari', 'informasi', 'pekerjaan', 'profile', 'pencari', 'loker']",15,7,8,bantu cari informasi kerja profile cari loker,7,7
"Bagus sekali app untuk networking, banyak ide dan pengalaman baik dari network, maupun dari akun yang kita follow",positif,2023-02-06,2023,bagus sekali app untuk networking banyak ide dan pengalaman baik dari network maupun dari akun yang kita follow,18,18,bagus sekali aplikasi untuk networking banyak ide dan pengalaman baik dari network maupun dari akun yang kita follow,18,18,"['bagus', 'sekali', 'aplikasi', 'untuk', 'networking', 'banyak', 'ide', 'dan', 'pengalaman', 'baik', 'dari', 'network', 'maupun', 'dari', 'akun', 'yang', 'kita', 'follow']","['bagus', 'aplikasi', 'networking', 'ide', 'pengalaman', 'network', 'akun', 'follow']",18,8,10,bagus aplikasi networking ide alam network akun follow,8,8
"Login aja susah, verifikasi gagal terus padahal udh bener, emng laen",negatif,2023-05-27,2023,login aja susah verifikasi gagal terus padahal udh bener emng laen,11,11,login saja susah verifikasi gagal terus padahal sudah benar memang lain,11,11,"['login', 'saja', 'susah', 'verifikasi', 'gagal', 'terus', 'padahal', 'sudah', 'benar', 'memang', 'lain']","['login', 'susah', 'verifikasi', 'gagal']",11,4,7,login susah verifikasi gagal,4,4
"Menambah ilmu, memperluas jaringan, banyak peluang baru yang bisa dimasuki, menambah motivasi",positif,2022-05-12,2022,menambah ilmu memperluas jaringan banyak peluang baru yang bisa dimasuki menambah motivasi,12,12,menambah ilmu memperluas jaringan banyak peluang baru yang bisa dimasuki menambah motivasi,12,12,"['menambah', 'ilmu', 'memperluas', 'jaringan', 'banyak', 'peluang', 'baru', 'yang', 'bisa', 'dimasuki', 'menambah', 'motivasi']","['menambah', 'ilmu', 'memperluas', 'jaringan', 'peluang', 'dimasuki', 'menambah', 'motivasi']",12,8,4,tambah ilmu luas jaring peluang masuk tambah motivasi,8,8
Sangat membantu setiap ad lowongan ngasih tau..terima kasih linkedln,positif,2021-09-06,2021,sangat membantu setiap ad lowongan ngasih tau terima kasih linkedln,9,10,sangat membantu setiap ada lowongan memberikan tahu terima kasih linkedln,10,10,"['sangat', 'membantu', 'setiap', 'ada', 'lowongan', 'memberikan', 'tahu', 'terima', 'kasih', 'linkedln']","['membantu', 'lowongan', 'terima', 'kasih', 'linkedln']",10,5,5,bantu lowong terima kasih linkedln,5,5
Banyak manfaat untuk perihal lowongan pekerjaan maupun koneksi yang bisa menambah pengetahuan dan keterampilan kerja,positif,2020-06-09,2020,banyak manfaat untuk perihal lowongan pekerjaan maupun koneksi yang bisa menambah pengetahuan dan keterampilan kerja,15,15,banyak manfaat untuk perihal lowongan pekerjaan maupun koneksi yang bisa menambah pengetahuan dan keterampilan kerja,15,15,"['banyak', 'manfaat', 'untuk', 'perihal', 'lowongan', 'pekerjaan', 'maupun', 'koneksi', 'yang', 'bisa', 'menambah', 'pengetahuan', 'dan', 'keterampilan', 'kerja']","['manfaat', 'perihal', 'lowongan', 'pekerjaan', 'koneksi', 'menambah', 'pengetahuan', 'keterampilan', 'kerja']",15,9,6,manfaat perihal lowong kerja koneksi tambah tahu terampil kerja,9,9
Memang gak menyangka aplikasi ini sangat dan sangat luar biasa berguna bagi semua comunitaz. Lebih dari BETTER,positif,2020-04-09,2020,memang gak menyangka aplikasi ini sangat dan sangat luar biasa berguna bagi semua comunitaz lebih dari better,17,17,memang tidak menyangka aplikasi ini sangat dan sangat luar biasa berguna bagi semua comunitaz lebih dari better,17,17,"['memang', 'tidak', 'menyangka', 'aplikasi', 'ini', 'sangat', 'dan', 'sangat', 'luar', 'biasa', 'berguna', 'bagi', 'semua', 'comunitaz', 'lebih', 'dari', 'better']","['tidak', 'menyangka', 'aplikasi', 'berguna', 'comunitaz', 'better']",17,6,11,tidak sangka aplikasi guna comunitaz better,6,6
Lemot banget mau update doang. Pdhl jaringan inet oke,negatif,2020-06-27,2020,lemot banget mau update doang pdhl jaringan inet oke,9,9,lambat banget mau diperbarui saja padahal jaringan inet oke,9,9,"['lambat', 'banget', 'mau', 'diperbarui', 'saja', 'padahal', 'jaringan', 'inet', 'oke']","['lambat', 'banget', 'diperbarui', 'jaringan', 'inet', 'oke']",9,6,3,lambat banget baru jaring inet oke,6,6
Sangat informatif dan menyenangkan banyak teman sahabat yg memiliki kompetensi dan profesionalis,positif,2020-02-13,2020,sangat informatif dan menyenangkan banyak teman sahabat yg memiliki kompetensi dan profesionalis,12,12,sangat informatif dan menyenangkan banyak teman sahabat yang memiliki kompetensi dan profesionalis,12,12,"['sangat', 'informatif', 'dan', 'menyenangkan', 'banyak', 'teman', 'sahabat', 'yang', 'memiliki', 'kompetensi', 'dan', 'profesionalis']","['informatif', 'menyenangkan', 'teman', 'sahabat', 'memiliki', 'kompetensi', 'profesionalis']",12,7,5,informatif senang teman sahabat milik kompetensi profesional,7,7
"Min, mau bertanya tadi kan saya klik yg berkalimat ""coba premium gratis selama 1 bulan"" apakah saya nantinya akan berlangganan atau tidak ya, saya takutnya nanti disuruh bayar padahal tidak ingin berlangganan, bagaimana cara membatalkannya min?",negatif,2020-05-20,2020,min mau bertanya tadi kan saya klik yg berkalimat coba premium gratis selama bulan apakah saya nantinya akan berlangganan atau tidak ya saya takutnya nanti disuruh bayar padahal tidak ingin berlangganan bagaimana cara membatalkannya min,36,35,minimal mau bertanya tadi akan saya klik yang berkalimat coba premium gratis selama bulan apakah saya nantinya akan berlangganan atau tidak ya saya takutnya nanti disuruh bayar padahal tidak ingin berlangganan bagaimana cara membatalkannya minimal,35,35,"['minimal', 'mau', 'bertanya', 'tadi', 'akan', 'saya', 'klik', 'yang', 'berkalimat', 'coba', 'premium', 'gratis', 'selama', 'bulan', 'apakah', 'saya', 'nantinya', 'akan', 'berlangganan', 'atau', 'tidak', 'ya', 'saya', 'takutnya', 'nanti', 'disuruh', 'bayar', 'padahal', 'tidak', 'ingin', 'berlangganan', 'bagaimana', 'cara', 'membatalkannya', 'minimal']","['minimal', 'klik', 'berkalimat', 'coba', 'premium', 'gratis', 'berlangganan', 'tidak', 'ya', 'takutnya', 'disuruh', 'bayar', 'tidak', 'berlangganan', 'membatalkannya', 'minimal']",35,16,19,minimal klik kalimat coba premium gratis langgan tidak ya takut suruh bayar tidak langgan batal minimal,16,16
Mohon untuk diperbaiki proses verifikasi ketika akan login. Verifikasi sudah benar namun sistem tidak merespon dengan baik sehingga berulang kali melakukan verifikasi namun tetap gagal.,negatif,2023-04-04,2023,mohon untuk diperbaiki proses verifikasi ketika akan login verifikasi sudah benar namun sistem tidak merespon dengan baik sehingga berulang kali melakukan verifikasi namun tetap gagal,25,25,mohon untuk di perbaiki proses verifikasi ketika akan login verifikasi sudah benar namun sistem tidak merespons dengan baik sehingga berulang kali melakukan verifikasi namun tetap gagal,25,26,"['mohon', 'untuk', 'di', 'perbaiki', 'proses', 'verifikasi', 'ketika', 'akan', 'login', 'verifikasi', 'sudah', 'benar', 'namun', 'sistem', 'tidak', 'merespons', 'dengan', 'baik', 'sehingga', 'berulang', 'kali', 'melakukan', 'verifikasi', 'namun', 'tetap', 'gagal']","['mohon', 'perbaiki', 'proses', 'verifikasi', 'login', 'verifikasi', 'sistem', 'tidak', 'merespons', 'berulang', 'kali', 'verifikasi', 'gagal']",26,13,13,mohon baik proses verifikasi login verifikasi sistem tidak respons ulang kali verifikasi gagal,13,13
Terimah kasih Appk ni sangat membantu mencari inpormasi Semoga bermanfaat bagi kita semua Saya sangat suka good,positif,2020-09-18,2020,terimah kasih appk ni sangat membantu mencari inpormasi semoga bermanfaat bagi kita semua saya sangat suka good,17,17,terimah kasih appk ini sangat membantu mencari inpormasi semoga bermanfaat bagi kita semua saya sangat suka bagus,17,17,"['terimah', 'kasih', 'appk', 'ini', 'sangat', 'membantu', 'mencari', 'inpormasi', 'semoga', 'bermanfaat', 'bagi', 'kita', 'semua', 'saya', 'sangat', 'suka', 'bagus']","['terimah', 'kasih', 'appk', 'membantu', 'mencari', 'inpormasi', 'semoga', 'bermanfaat', 'suka', 'bagus']",17,10,7,terimah kasih appk bantu cari inpormasi moga manfaat suka bagus,10,10
Apk taiiiii masa udh bener verifikasinya malah terus²an suruh verifikasi ga beres² .. sekalian aja bikin apk tebak gambar gaush bikin apk kaya ginian. Niat hati mau nyari peluang malah dibikin pusing,negatif,2022-07-11,2022,apk taiiiii masa udh bener verifikasinya malah terus²an suruh verifikasi ga beres² sekalian aja bikin apk tebak gambar gaush bikin apk kaya ginian niat hati mau nyari peluang malah dibikin pusing,32,31,aplikasi taiiiii masa sudah benar verifikasinya bahkan terus²an suruh verifikasi tidak beres² sekalian saja bikin aplikasi tebak gambar gaush bikin aplikasi kayak ginian niat hati mau mencari peluang bahkan dibikin pusing,31,31,"['aplikasi', 'taiiiii', 'masa', 'sudah', 'benar', 'verifikasinya', 'bahkan', 'terus²an', 'suruh', 'verifikasi', 'tidak', 'beres²', 'sekalian', 'saja', 'bikin', 'aplikasi', 'tebak', 'gambar', 'gaush', 'bikin', 'aplikasi', 'kayak', 'ginian', 'niat', 'hati', 'mau', 'mencari', 'peluang', 'bahkan', 'dibikin', 'pusing']","['aplikasi', 'taiiiii', 'verifikasinya', 'terus²an', 'suruh', 'verifikasi', 'tidak', 'beres²', 'bikin', 'aplikasi', 'tebak', 'gambar', 'gaush', 'bikin', 'aplikasi', 'kayak', 'ginian', 'niat', 'hati', 'mencari', 'peluang', 'dibikin', 'pusing']",31,23,8,aplikasi taiiiii verifikasi terus an suruh verifikasi tidak beres bikin aplikasi tebak gambar gaush bikin aplikasi kayak ginian niat hati cari peluang bikin pusing,23,24
Aplikasi Job yg sangat membantu dan bermanfaat.... Good Job,positif,2020-06-17,2020,aplikasi job yg sangat membantu dan bermanfaat good job,9,9,aplikasi kerja yang sangat membantu dan bermanfaat bagus kerja,9,9,"['aplikasi', 'kerja', 'yang', 'sangat', 'membantu', 'dan', 'bermanfaat', 'bagus', 'kerja']","['aplikasi', 'kerja', 'membantu', 'bermanfaat', 'bagus', 'kerja']",9,6,3,aplikasi kerja bantu manfaat bagus kerja,6,6
"Kenapa masuknya sekarang susah, tebak gambar salah terus. Verivikasi ngga jelas",negatif,2021-02-17,2021,kenapa masuknya sekarang susah tebak gambar salah terus verivikasi ngga jelas,11,11,kenapa masuknya sekarang susah tebak gambar salah terus verivikasi tidak jelas,11,11,"['kenapa', 'masuknya', 'sekarang', 'susah', 'tebak', 'gambar', 'salah', 'terus', 'verivikasi', 'tidak', 'jelas']","['masuknya', 'susah', 'tebak', 'gambar', 'salah', 'verivikasi', 'tidak']",11,7,4,masuk susah tebak gambar salah verivikasi tidak,7,7
"Sudah dua hari sy tidak bisa akses akun saya. Sudah saya update juga, tp ttp tdk bisa diakses. Padahal sebelumnya baik2 saja. Hmm",negatif,2022-02-27,2022,sudah dua hari sy tidak bisa akses akun saya sudah saya update juga tp ttp tdk bisa diakses padahal sebelumnya baik saja hmm,23,23,sudah dua hari saya tidak bisa akses akun saya sudah saya diperbarui juga tapi tetap tidak bisa diakses padahal sebelumnya baik saja hmm,23,23,"['sudah', 'dua', 'hari', 'saya', 'tidak', 'bisa', 'akses', 'akun', 'saya', 'sudah', 'saya', 'diperbarui', 'juga', 'tapi', 'tetap', 'tidak', 'bisa', 'diakses', 'padahal', 'sebelumnya', 'baik', 'saja', 'hmm']","['tidak', 'akses', 'akun', 'diperbarui', 'tidak', 'diakses', 'hmm']",23,7,16,tidak akses akun baru tidak akses hmm,7,7
saya punya linked udah lama dan gapernah langganan tiba tiba saldo kepotong sendiri dengan alasan langganan tolong kebijakannya ini lumayan loh langganannya 600 rb lebih,negatif,2023-03-31,2023,saya punya linked udah lama dan gapernah langganan tiba tiba saldo kepotong sendiri dengan alasan langganan tolong kebijakannya ini lumayan loh langganannya rb lebih,25,24,saya punya linked sudah lama dan tidak pernah langganan tiba tiba saldo terpotong sendiri dengan alasan langganan tolong kebijakannya ini lumayan loh langganannya ribu lebih,24,25,"['saya', 'punya', 'linked', 'sudah', 'lama', 'dan', 'tidak', 'pernah', 'langganan', 'tiba', 'tiba', 'saldo', 'terpotong', 'sendiri', 'dengan', 'alasan', 'langganan', 'tolong', 'kebijakannya', 'ini', 'lumayan', 'loh', 'langganannya', 'ribu', 'lebih']","['linked', 'tidak', 'langganan', 'saldo', 'terpotong', 'alasan', 'langganan', 'tolong', 'kebijakannya', 'lumayan', 'loh', 'langganannya', 'ribu']",25,13,12,linked tidak langgan saldo potong alas langgan tolong bijak lumayan loh langgan ribu,13,13
"Tolong diperbaiki lagi aplikasinya, karena user tidak dapat membuka akun personal padahal tidak pernah bertindak yang melanggar aturan Linkedin.",negatif,2020-08-27,2020,tolong diperbaiki lagi aplikasinya karena user tidak dapat membuka akun personal padahal tidak pernah bertindak yang melanggar aturan linkedin,19,19,tolong di perbaiki lagi aplikasi nya karena user tidak dapat membuka akun personal padahal tidak pernah bertindak yang melanggar aturan linkedin,19,21,"['tolong', 'di', 'perbaiki', 'lagi', 'aplikasi', 'nya', 'karena', 'user', 'tidak', 'dapat', 'membuka', 'akun', 'personal', 'padahal', 'tidak', 'pernah', 'bertindak', 'yang', 'melanggar', 'aturan', 'linkedin']","['tolong', 'perbaiki', 'aplikasi', 'nya', 'user', 'tidak', 'membuka', 'akun', 'personal', 'tidak', 'bertindak', 'melanggar', 'aturan', 'linkedin']",21,14,7,tolong baik aplikasi nya user tidak buka akun personal tidak tindak langgar atur linkedin,14,14
Aplikasi Linkedln ini bagus sekali meyempurnakan koneksi jaringan saya dimanapun saya berada,positif,2022-12-28,2022,aplikasi linkedln ini bagus sekali meyempurnakan koneksi jaringan saya dimanapun saya berada,12,12,aplikasi linkedln ini bagus sekali meyempurnakan koneksi jaringan saya dimanapun saya berasa,12,12,"['aplikasi', 'linkedln', 'ini', 'bagus', 'sekali', 'meyempurnakan', 'koneksi', 'jaringan', 'saya', 'dimanapun', 'saya', 'berasa']","['aplikasi', 'linkedln', 'bagus', 'meyempurnakan', 'koneksi', 'jaringan', 'dimanapun', 'berasa']",12,8,4,aplikasi linkedln bagus meyempurnakan koneksi jaring mana asa,8,8
"Aplikasi perlu diperbaiki lagi, verifikasi untuk pengguna untuk masuk ke aplikasi dipersulit dengan gambar dan keterangan yang tidak jelas",negatif,2021-10-29,2021,aplikasi perlu diperbaiki lagi verifikasi untuk pengguna untuk masuk ke aplikasi dipersulit dengan gambar dan keterangan yang tidak jelas,19,19,aplikasi perlu di perbaiki lagi verifikasi untuk pengguna untuk masuk ke aplikasi dipersulit dengan gambar dan keterangan yang tidak jelas,19,20,"['aplikasi', 'perlu', 'di', 'perbaiki', 'lagi', 'verifikasi', 'untuk', 'pengguna', 'untuk', 'masuk', 'ke', 'aplikasi', 'dipersulit', 'dengan', 'gambar', 'dan', 'keterangan', 'yang', 'tidak', 'jelas']","['aplikasi', 'perbaiki', 'verifikasi', 'pengguna', 'masuk', 'aplikasi', 'dipersulit', 'gambar', 'keterangan', 'tidak']",20,10,10,aplikasi baik verifikasi guna masuk aplikasi sulit gambar terang tidak,10,10
"Bermanfaat banget buat nambah link pertemenana dan mencari atau membagikan info bukan tentang loker saja tapi motivasi, cara2 untuk mendapatkan pekerjaan dll",positif,2020-06-20,2020,bermanfaat banget buat nambah link pertemenana dan mencari atau membagikan info bukan tentang loker saja tapi motivasi cara untuk mendapatkan pekerjaan dll,22,22,bermanfaat banget buat nambah link pertemenana dan mencari atau membagikan informasi bukan tentang loker saja tapi motivasi cara untuk mendapatkan pekerjaan dan lain lain,22,24,"['bermanfaat', 'banget', 'buat', 'nambah', 'link', 'pertemenana', 'dan', 'mencari', 'atau', 'membagikan', 'informasi', 'bukan', 'tentang', 'loker', 'saja', 'tapi', 'motivasi', 'cara', 'untuk', 'mendapatkan', 'pekerjaan', 'dan', 'lain', 'lain']","['bermanfaat', 'banget', 'nambah', 'link', 'pertemenana', 'mencari', 'membagikan', 'informasi', 'loker', 'motivasi', 'pekerjaan']",24,11,13,manfaat banget nambah link pertemenana cari bagi informasi loker motivasi kerja,11,11
Tolong pihak linkedin di perbaiki lagi masa iya jaringan sinyal saya bagus kouta ada tapi kenapa g bisa login?,negatif,2022-06-28,2022,tolong pihak linkedin di perbaiki lagi masa iya jaringan sinyal saya bagus kouta ada tapi kenapa g bisa login,19,19,tolong pihak linkedin di perbaikan lagi masa iya jaringan sinyal saya bagus kouta ada tapi kenapa tidak bisa login,19,19,"['tolong', 'pihak', 'linkedin', 'di', 'perbaikan', 'lagi', 'masa', 'iya', 'jaringan', 'sinyal', 'saya', 'bagus', 'kouta', 'ada', 'tapi', 'kenapa', 'tidak', 'bisa', 'login']","['tolong', 'linkedin', 'perbaikan', 'iya', 'jaringan', 'sinyal', 'bagus', 'kouta', 'tidak', 'login']",19,10,9,tolong linkedin baik iya jaring sinyal bagus kouta tidak login,10,10
Percumah mosting lowongan karena gak jelas lowongannya hanya membuat penuh aplikasi di handphone aja,negatif,2023-03-18,2023,percumah mosting lowongan karena gak jelas lowongannya hanya membuat penuh aplikasi di handphone aja,14,14,percumah mosting lowongan karena tidak jelas lowongannya hanya membuat penuh aplikasi di handphone saja,14,14,"['percumah', 'mosting', 'lowongan', 'karena', 'tidak', 'jelas', 'lowongannya', 'hanya', 'membuat', 'penuh', 'aplikasi', 'di', 'handphone', 'saja']","['percumah', 'mosting', 'lowongan', 'tidak', 'lowongannya', 'penuh', 'aplikasi', 'handphone']",14,8,6,percumah mosting lowong tidak lowong penuh aplikasi handphone,8,8
"Saya kasih bintang 2 dulu, karena baru join in application, lihat perkembangan job kedepannya dulu. Thanks.",negatif,2020-08-06,2020,saya kasih bintang dulu karena baru join in application lihat perkembangan job kedepannya dulu thanks,16,15,saya kasih bintang dahulu karena baru join in application lihat perkembangan kerja kedepannya dahulu terima kasih,15,16,"['saya', 'kasih', 'bintang', 'dahulu', 'karena', 'baru', 'join', 'in', 'application', 'lihat', 'perkembangan', 'kerja', 'kedepannya', 'dahulu', 'terima', 'kasih']","['kasih', 'bintang', 'join', 'in', 'application', 'lihat', 'perkembangan', 'kerja', 'kedepannya', 'terima', 'kasih']",16,11,5,kasih bintang join in application lihat kembang kerja depan terima kasih,11,11
"Aplikasi nya aneh saya g prnah download tpi ada pemberitahuan kalo akun email saya trdftr tiba""pdhal punya aplikasi ny aja ngga",negatif,2023-02-21,2023,aplikasi nya aneh saya g prnah download tpi ada pemberitahuan kalo akun email saya trdftr tiba pdhal punya aplikasi ny aja ngga,21,22,aplikasi nya aneh saya tidak pernah unduh tetapi ada pemberitahuan kalau akun email saya trdftr tiba pdhal punya aplikasi nya saja tidak,22,22,"['aplikasi', 'nya', 'aneh', 'saya', 'tidak', 'pernah', 'unduh', 'tetapi', 'ada', 'pemberitahuan', 'kalau', 'akun', 'email', 'saya', 'trdftr', 'tiba', 'pdhal', 'punya', 'aplikasi', 'nya', 'saja', 'tidak']","['aplikasi', 'nya', 'aneh', 'tidak', 'unduh', 'pemberitahuan', 'akun', 'email', 'trdftr', 'pdhal', 'aplikasi', 'nya', 'tidak']",22,13,9,aplikasi nya aneh tidak unduh pemberitahuan akun email trdftr pdhal aplikasi nya tidak,13,13
"Kga bisa di download stuck di 85% mulu, di ulang ulang jga, udh android 10 pdhl",negatif,2022-09-29,2022,kga bisa di download stuck di mulu di ulang ulang jga udh android pdhl,16,14,kga bisa di unduh stuck di mulu di ulang ulang juga sudah android padahal,14,14,"['kga', 'bisa', 'di', 'unduh', 'stuck', 'di', 'mulu', 'di', 'ulang', 'ulang', 'juga', 'sudah', 'android', 'padahal']","['kga', 'unduh', 'stuck', 'mulu', 'ulang', 'ulang', 'android']",14,7,7,kga unduh stuck mulu ulang ulang android,7,7
"Saya jadi mudah mendapatkan informasi soal pekerjaan, walaupun blm ada yang cocok lowongan kerja untuk sya.",positif,2020-06-02,2020,saya jadi mudah mendapatkan informasi soal pekerjaan walaupun blm ada yang cocok lowongan kerja untuk sya,16,16,saya jadi mudah mendapatkan informasi soal pekerjaan walaupun belum ada yang cocok lowongan kerja untuk saya,16,16,"['saya', 'jadi', 'mudah', 'mendapatkan', 'informasi', 'soal', 'pekerjaan', 'walaupun', 'belum', 'ada', 'yang', 'cocok', 'lowongan', 'kerja', 'untuk', 'saya']","['mudah', 'informasi', 'pekerjaan', 'cocok', 'lowongan', 'kerja']",16,6,10,mudah informasi kerja cocok lowong kerja,6,6
Sya usulkan untuk bagiab verivikasi diganti saya pakr mobil atau motor atau benda lain yang jelas... krn yg ada skrg manusia pintar ber iq tinggi pun tdk sanggup menyelesaikan verifikasi jangan menyulitkan pelanggan baru dgn verifikasi yg aneh2....sy sdndiri sudh coba verifikasi belasan kali tetap tdk bisa karna gambarnya kura2 tdk jelas,negatif,2023-04-16,2023,sya usulkan untuk bagiab verivikasi diganti saya pakr mobil atau motor atau benda lain yang jelas krn yg ada skrg manusia pintar ber iq tinggi pun tdk sanggup menyelesaikan verifikasi jangan menyulitkan pelanggan baru dgn verifikasi yg aneh sy sdndiri sudh coba verifikasi belasan kali tetap tdk bisa karna gambarnya kura tdk jelas,52,53,saya usulkan untuk bagiab verivikasi diganti saya pakr mobil atau motor atau benda lain yang jelas karena yang ada sekarang manusia pintar ber iq tinggi pun tidak sanggup menyelesaikan verifikasi jangan menyulitkan pelanggan baru dengan verifikasi yang aneh saya sdndiri sudh coba verifikasi belasan kali tetap tidak bisa karena gambarnya kura tidak jelas,53,53,"['saya', 'usulkan', 'untuk', 'bagiab', 'verivikasi', 'diganti', 'saya', 'pakr', 'mobil', 'atau', 'motor', 'atau', 'benda', 'lain', 'yang', 'jelas', 'karena', 'yang', 'ada', 'sekarang', 'manusia', 'pintar', 'ber', 'iq', 'tinggi', 'pun', 'tidak', 'sanggup', 'menyelesaikan', 'verifikasi', 'jangan', 'menyulitkan', 'pelanggan', 'baru', 'dengan', 'verifikasi', 'yang', 'aneh', 'saya', 'sdndiri', 'sudh', 'coba', 'verifikasi', 'belasan', 'kali', 'tetap', 'tidak', 'bisa', 'karena', 'gambarnya', 'kura', 'tidak', 'jelas']","['usulkan', 'bagiab', 'verivikasi', 'diganti', 'pakr', 'mobil', 'motor', 'benda', 'manusia', 'pintar', 'ber', 'iq', 'tidak', 'sanggup', 'menyelesaikan', 'verifikasi', 'menyulitkan', 'pelanggan', 'verifikasi', 'aneh', 'sdndiri', 'sudh', 'coba', 'verifikasi', 'belasan', 'kali', 'tidak', 'gambarnya', 'kura', 'tidak']",53,30,23,usul bagiab verivikasi ganti pakr mobil motor benda manusia pintar ber iq tidak sanggup selesai verifikasi sulit langgan verifikasi aneh sdndiri sudh coba verifikasi bas kali tidak gambar kura tidak,30,30
"Selamat Siang , Pihak Development Saya mau komplain terkait akun saya yang di nonaktifkan tanpa sebab, dan saya sudah melakukan verifikasi identitas , mohon dibantu di proses pembukaannya. Tks",negatif,2022-02-07,2022,selamat siang pihak development saya mau komplain terkait akun saya yang di nonaktifkan tanpa sebab dan saya sudah melakukan verifikasi identitas mohon dibantu di proses pembukaannya tks,29,27,selamat siang pihak development saya mau komplain terkait akun saya yang di nonaktifkan tanpa sebab dan saya sudah melakukan verifikasi identitas mohon dibantu di proses pembukaannya terima kasih,27,28,"['selamat', 'siang', 'pihak', 'development', 'saya', 'mau', 'komplain', 'terkait', 'akun', 'saya', 'yang', 'di', 'nonaktifkan', 'tanpa', 'sebab', 'dan', 'saya', 'sudah', 'melakukan', 'verifikasi', 'identitas', 'mohon', 'dibantu', 'di', 'proses', 'pembukaannya', 'terima', 'kasih']","['selamat', 'siang', 'development', 'komplain', 'terkait', 'akun', 'nonaktifkan', 'verifikasi', 'identitas', 'mohon', 'dibantu', 'proses', 'pembukaannya', 'terima', 'kasih']",28,15,13,selamat siang development komplain kait akun nonaktif verifikasi identitas mohon bantu proses buka terima kasih,15,15
"Akun tidak bisa di pakai, malah setelah di update akunnya yg lama hilang, apakah diretas akun yang dulu, bagaimana solusinya ini akun yg lama tidak bisa kembali",negatif,2023-09-27,2023,akun tidak bisa di pakai malah setelah di update akunnya yg lama hilang apakah diretas akun yang dulu bagaimana solusinya ini akun yg lama tidak bisa kembali,27,27,akun tidak bisa di pakai bahkan setelah di diperbarui akunnya yang lama hilang apakah diretas akun yang dahulu bagaimana solusinya ini akun yang lama tidak bisa kembali,27,27,"['akun', 'tidak', 'bisa', 'di', 'pakai', 'bahkan', 'setelah', 'di', 'diperbarui', 'akunnya', 'yang', 'lama', 'hilang', 'apakah', 'diretas', 'akun', 'yang', 'dahulu', 'bagaimana', 'solusinya', 'ini', 'akun', 'yang', 'lama', 'tidak', 'bisa', 'kembali']","['akun', 'tidak', 'pakai', 'diperbarui', 'akunnya', 'hilang', 'diretas', 'akun', 'solusinya', 'akun', 'tidak']",27,11,16,akun tidak pakai baru akun hilang retas akun solusi akun tidak,11,11
Oi developer_- knp sulit banget verifikasi gambarnya ya hadap ke atas apa ke bawah salah semua meski dah di miring in layar juga,negatif,2022-06-04,2022,oi developer knp sulit banget verifikasi gambarnya ya hadap ke atas apa ke bawah salah semua meski dah di miring in layar juga,23,23,oi developer kenapa sulit banget verifikasi gambarnya ya hadap ke atas apa ke bawah salah semua meski sudah di murah in layar juga,23,23,"['oi', 'developer', 'kenapa', 'sulit', 'banget', 'verifikasi', 'gambarnya', 'ya', 'hadap', 'ke', 'atas', 'apa', 'ke', 'bawah', 'salah', 'semua', 'meski', 'sudah', 'di', 'murah', 'in', 'layar', 'juga']","['oi', 'developer', 'sulit', 'banget', 'verifikasi', 'gambarnya', 'ya', 'hadap', 'salah', 'murah', 'in', 'layar']",23,12,11,oi developer sulit banget verifikasi gambar ya hadap salah murah in layar,12,12
tmn bnyk yg nyaranin donlot apk ini tp pas login gagal terus pdhl udh dipencet berkali' tetep aja stuck :),negatif,2023-06-24,2023,tmn bnyk yg nyaranin donlot apk ini tp pas login gagal terus pdhl udh dipencet berkali tetep aja stuck,20,19,teman banyak yang nyaranin download aplikasi ini tapi pas login gagal terus padahal sudah dipencet berkali tetap saja stuck,19,19,"['teman', 'banyak', 'yang', 'nyaranin', 'download', 'aplikasi', 'ini', 'tapi', 'pas', 'login', 'gagal', 'terus', 'padahal', 'sudah', 'dipencet', 'berkali', 'tetap', 'saja', 'stuck']","['teman', 'nyaranin', 'download', 'aplikasi', 'pas', 'login', 'gagal', 'dipencet', 'berkali', 'stuck']",19,10,9,teman nyaranin download aplikasi pas login gagal pencet kali stuck,10,10
"masa saya mau login harus verifikasi identitas ktp dulu, pas udah verifikasi malah ga masuk2. udah dicoba beberapa kali tetep ngga bisa masuk",negatif,2023-08-16,2023,masa saya mau login harus verifikasi identitas ktp dulu pas udah verifikasi malah ga masuk udah dicoba beberapa kali tetep ngga bisa masuk,23,23,masa saya mau login harus verifikasi identitas ktp dahulu pas sudah verifikasi bahkan tidak masuk sudah dicoba beberapa kali tetap tidak bisa masuk,23,23,"['masa', 'saya', 'mau', 'login', 'harus', 'verifikasi', 'identitas', 'ktp', 'dahulu', 'pas', 'sudah', 'verifikasi', 'bahkan', 'tidak', 'masuk', 'sudah', 'dicoba', 'beberapa', 'kali', 'tetap', 'tidak', 'bisa', 'masuk']","['login', 'verifikasi', 'identitas', 'ktp', 'pas', 'verifikasi', 'tidak', 'masuk', 'dicoba', 'kali', 'tidak', 'masuk']",23,12,11,login verifikasi identitas ktp pas verifikasi tidak masuk coba kali tidak masuk,12,12
"Aplikasi ngak bermutu, setiap mau masuk di aplikasi linkedin selalau ferivikasi terus menerus, mau login aja susahnya minta ampun, dah kacau ni aplikasi",negatif,2023-08-11,2023,aplikasi ngak bermutu setiap mau masuk di aplikasi linkedin selalau ferivikasi terus menerus mau login aja susahnya minta ampun dah kacau ni aplikasi,23,23,aplikasi tidak bermutu setiap mau masuk di aplikasi linkedin selalau ferivikasi terus menerus mau login saja susahnya minta ampun sudah kacau ini aplikasi,23,23,"['aplikasi', 'tidak', 'bermutu', 'setiap', 'mau', 'masuk', 'di', 'aplikasi', 'linkedin', 'selalau', 'ferivikasi', 'terus', 'menerus', 'mau', 'login', 'saja', 'susahnya', 'minta', 'ampun', 'sudah', 'kacau', 'ini', 'aplikasi']","['aplikasi', 'tidak', 'bermutu', 'masuk', 'aplikasi', 'linkedin', 'selalau', 'ferivikasi', 'menerus', 'login', 'susahnya', 'ampun', 'kacau', 'aplikasi']",23,14,9,aplikasi tidak mutu masuk aplikasi linkedin lalau ferivikasi terus login susah ampun kacau aplikasi,14,14
"Google AppStore memang TOP. Saya download Linkdin by Google AppStore lebih cepat, nyaman tanpa iklan.",positif,2023-09-12,2023,google appstore memang top saya download linkdin by google appstore lebih cepat nyaman tanpa iklan,15,15,google appstore memang top saya unduh linkdin by google appstore lebih cepat nyaman tanpa iklan,15,15,"['google', 'appstore', 'memang', 'top', 'saya', 'unduh', 'linkdin', 'by', 'google', 'appstore', 'lebih', 'cepat', 'nyaman', 'tanpa', 'iklan']","['google', 'appstore', 'top', 'unduh', 'linkdin', 'by', 'google', 'appstore', 'cepat', 'nyaman', 'iklan']",15,11,4,google appstore top unduh linkdin by google appstore cepat nyaman iklan,11,11
"Lama gak login, sekali login susah bgt, verifikasi gagal terus padahal datanya benar.",negatif,2022-10-14,2022,lama gak login sekali login susah bgt verifikasi gagal terus padahal datanya benar,13,13,lama tidak login sekali login susah banget verifikasi gagal terus padahal datanya benar,13,13,"['lama', 'tidak', 'login', 'sekali', 'login', 'susah', 'banget', 'verifikasi', 'gagal', 'terus', 'padahal', 'datanya', 'benar']","['tidak', 'login', 'login', 'susah', 'banget', 'verifikasi', 'gagal', 'datanya']",13,8,5,tidak login login susah banget verifikasi gagal data,8,8
"Aplikasi jelek banget, verifikasi ribet banget, belum lagi mau verif kode otp malah aplikasi lain seperti aplikasi pinjol yg masuk",negatif,2022-06-03,2022,aplikasi jelek banget verifikasi ribet banget belum lagi mau verif kode otp malah aplikasi lain seperti aplikasi pinjol yg masuk,20,20,aplikasi jelek banget verifikasi rumit banget belum lagi mau verif kode one time password bahkan aplikasi lain seperti aplikasi pinjol yang masuk,20,22,"['aplikasi', 'jelek', 'banget', 'verifikasi', 'rumit', 'banget', 'belum', 'lagi', 'mau', 'verif', 'kode', 'one', 'time', 'password', 'bahkan', 'aplikasi', 'lain', 'seperti', 'aplikasi', 'pinjol', 'yang', 'masuk']","['aplikasi', 'jelek', 'banget', 'verifikasi', 'rumit', 'banget', 'verif', 'kode', 'one', 'time', 'password', 'aplikasi', 'aplikasi', 'pinjol', 'masuk']",22,15,7,aplikasi jelek banget verifikasi rumit banget verif kode one time password aplikasi aplikasi pinjol masuk,15,15
"Hanya based premium yang bisa di respon baik oleh owner perusahaan , based reguler sangat tidak di artikan , saya kurang rekomendasi untuk yang benar benar cari kerja",negatif,2024-02-19,2024,hanya based premium yang bisa di respon baik oleh owner perusahaan based reguler sangat tidak di artikan saya kurang rekomendasi untuk yang benar benar cari kerja,28,26,hanya based premium yang bisa di respons baik oleh owner perusahaan based reguler sangat tidak di artikan saya kurang rekomendasi untuk yang benar benar cari kerja,26,26,"['hanya', 'based', 'premium', 'yang', 'bisa', 'di', 'respons', 'baik', 'oleh', 'owner', 'perusahaan', 'based', 'reguler', 'sangat', 'tidak', 'di', 'artikan', 'saya', 'kurang', 'rekomendasi', 'untuk', 'yang', 'benar', 'benar', 'cari', 'kerja']","['based', 'premium', 'respons', 'owner', 'perusahaan', 'based', 'reguler', 'tidak', 'artikan', 'rekomendasi', 'cari', 'kerja']",26,12,14,based premium respons owner usaha based reguler tidak arti rekomendasi cari kerja,12,12
Setiap mau masuk harus update ulang dan aplikasi tidak bisa kita pindah ke destop / menu handphone,negatif,2022-11-06,2022,setiap mau masuk harus update ulang dan aplikasi tidak bisa kita pindah ke destop menu handphone,17,16,setiap mau masuk harus diperbarui ulang dan aplikasi tidak bisa kita pindah ke destop menu handphone,16,16,"['setiap', 'mau', 'masuk', 'harus', 'diperbarui', 'ulang', 'dan', 'aplikasi', 'tidak', 'bisa', 'kita', 'pindah', 'ke', 'destop', 'menu', 'handphone']","['masuk', 'diperbarui', 'ulang', 'aplikasi', 'tidak', 'pindah', 'destop', 'menu', 'handphone']",16,9,7,masuk baru ulang aplikasi tidak pindah destop menu handphone,9,9
Ribet amat mau login aja suruh main teka teki gajelas suruh pilih gambar yg paling tepat menghadap atas padahal gambarnya cuma diputar2 ga jelas 😅 uninstall bye sampah!,negatif,2021-04-04,2021,ribet amat mau login aja suruh main teka teki gajelas suruh pilih gambar yg paling tepat menghadap atas padahal gambarnya cuma diputar ga jelas uninstall bye sampah,28,27,rumit amat mau login saja suruh main teka teki tidak jelas suruh pilih gambar yang paling tepat menghadap atas padahal gambarnya cuma diputar tidak jelas uninstall bye sampah,27,28,"['rumit', 'amat', 'mau', 'login', 'saja', 'suruh', 'main', 'teka', 'teki', 'tidak', 'jelas', 'suruh', 'pilih', 'gambar', 'yang', 'paling', 'tepat', 'menghadap', 'atas', 'padahal', 'gambarnya', 'cuma', 'diputar', 'tidak', 'jelas', 'uninstall', 'bye', 'sampah']","['rumit', 'login', 'suruh', 'main', 'teka', 'teki', 'tidak', 'suruh', 'pilih', 'gambar', 'menghadap', 'gambarnya', 'diputar', 'tidak', 'uninstall', 'bye', 'sampah']",28,17,11,rumit login suruh main teka teki tidak suruh pilih gambar hadap gambar putar tidak uninstall bye sampah,17,17
Gak bisa login padahal captcha udah bener. Mohon di perbaiki. Udah terlalu banyak yg ngasih bintang 1,negatif,2023-11-24,2023,gak bisa login padahal captcha udah bener mohon di perbaiki udah terlalu banyak yg ngasih bintang,17,16,tidak bisa login padahal captcha sudah benar mohon di perbaikan sudah terlalu banyak yang memberikan bintang,16,16,"['tidak', 'bisa', 'login', 'padahal', 'captcha', 'sudah', 'benar', 'mohon', 'di', 'perbaikan', 'sudah', 'terlalu', 'banyak', 'yang', 'memberikan', 'bintang']","['tidak', 'login', 'captcha', 'mohon', 'perbaikan', 'bintang']",16,6,10,tidak login captcha mohon baik bintang,6,6
"Sangat membantu sekali untuk menemukan pekerjaan, dan bisa sharing-sharing kepada sesama yang berada dalam jaringan.",positif,2024-01-02,2024,sangat membantu sekali untuk menemukan pekerjaan dan bisa sharing sharing kepada sesama yang berada dalam jaringan,15,16,sangat membantu sekali untuk menemukan pekerjaan dan bisa sharing sharing kepada sesama yang berasa dalam jaringan,16,16,"['sangat', 'membantu', 'sekali', 'untuk', 'menemukan', 'pekerjaan', 'dan', 'bisa', 'sharing', 'sharing', 'kepada', 'sesama', 'yang', 'berasa', 'dalam', 'jaringan']","['membantu', 'menemukan', 'pekerjaan', 'sharing', 'sharing', 'berasa', 'jaringan']",16,7,9,bantu temu kerja sharing sharing asa jaring,7,7
"aplikasi bikin marah, mau login gabisa harus masukin kode captha berulang ulang meskipun bener tapi ttep ga bisa masuk, kntl, gblk",negatif,2023-10-02,2023,aplikasi bikin marah mau login gabisa harus masukin kode captha berulang ulang meskipun bener tapi ttep ga bisa masuk kntl gblk,21,21,aplikasi bikin marah mau login tidak bisa harus masukkan kode captha berulang ulang meskipun benar tapi ttep tidak bisa masuk bodoh gblk,21,22,"['aplikasi', 'bikin', 'marah', 'mau', 'login', 'tidak', 'bisa', 'harus', 'masukkan', 'kode', 'captha', 'berulang', 'ulang', 'meskipun', 'benar', 'tapi', 'ttep', 'tidak', 'bisa', 'masuk', 'bodoh', 'gblk']","['aplikasi', 'bikin', 'marah', 'login', 'tidak', 'masukkan', 'kode', 'captha', 'berulang', 'ulang', 'ttep', 'tidak', 'masuk', 'bodoh', 'gblk']",22,15,7,aplikasi bikin marah login tidak masuk kode captha ulang ulang ttep tidak masuk bodoh gblk,15,15
"Platform yang bukan saja sebagai pencari pekerjaan, tetapi juga sebagai wadah connecting all the people on the world. Kita bisa berinteraksi dgn sesama pengguna, posting informasi2 penting yg mungkin dibutuhkan oleh orang lain. Saling berbagi informasi pekerjaan. Awesome 👍👍",positif,2023-07-26,2023,platform yang bukan saja sebagai pencari pekerjaan tetapi juga sebagai wadah connecting all the people on the world kita bisa berinteraksi dgn sesama pengguna posting informasi penting yg mungkin dibutuhkan oleh orang lain saling berbagi informasi pekerjaan awesome,39,38,platform yang bukan saja sebagai pencari pekerjaan tetapi juga sebagai wadah connecting all the people on the world kita bisa berinteraksi dengan sesama pengguna posting informasi penting yang mungkin dibutuhkan oleh orang lain saling berbagi informasi pekerjaan luar biasa,38,39,"['platform', 'yang', 'bukan', 'saja', 'sebagai', 'pencari', 'pekerjaan', 'tetapi', 'juga', 'sebagai', 'wadah', 'connecting', 'all', 'the', 'people', 'on', 'the', 'world', 'kita', 'bisa', 'berinteraksi', 'dengan', 'sesama', 'pengguna', 'posting', 'informasi', 'penting', 'yang', 'mungkin', 'dibutuhkan', 'oleh', 'orang', 'lain', 'saling', 'berbagi', 'informasi', 'pekerjaan', 'luar', 'biasa']","['platform', 'pencari', 'pekerjaan', 'wadah', 'connecting', 'all', 'the', 'people', 'on', 'the', 'world', 'berinteraksi', 'pengguna', 'posting', 'informasi', 'dibutuhkan', 'orang', 'berbagi', 'informasi', 'pekerjaan']",39,20,19,platform cari kerja wadah connecting all the people on the world interaksi guna posting informasi butuh orang bagi informasi kerja,20,20
Sudah di upgrade ga bisa masuk ya ampun masa disuruh upgrade lagi padahal baru kemaren,negatif,2020-09-25,2020,sudah di upgrade ga bisa masuk ya ampun masa disuruh upgrade lagi padahal baru kemaren,15,15,sudah di upgrade tidak bisa masuk ya ampun masa disuruh upgrade lagi padahal baru kemarin,15,15,"['sudah', 'di', 'upgrade', 'tidak', 'bisa', 'masuk', 'ya', 'ampun', 'masa', 'disuruh', 'upgrade', 'lagi', 'padahal', 'baru', 'kemarin']","['upgrade', 'tidak', 'masuk', 'ya', 'ampun', 'disuruh', 'upgrade', 'kemarin']",15,8,7,upgrade tidak masuk ya ampun suruh upgrade kemarin,8,8
Informasi yang diberikan sangat up to date sehingga memudahkan para pencari kerja untuk dapat meningkatkan karier dalam bekerja dan perbaikan taraf hidupnya. Keep the awesome job.....LinkedIn,positif,2024-01-24,2024,informasi yang diberikan sangat up to date sehingga memudahkan para pencari kerja untuk dapat meningkatkan karier dalam bekerja dan perbaikan taraf hidupnya keep the awesome job linkedin,26,27,informasi yang diberikan sangat up to date sehingga memudahkan para pencari kerja untuk dapat meningkatkan karier dalam bekerja dan perbaikan taraf hidupnya keep the luar biasa kerja linkedin,27,28,"['informasi', 'yang', 'diberikan', 'sangat', 'up', 'to', 'date', 'sehingga', 'memudahkan', 'para', 'pencari', 'kerja', 'untuk', 'dapat', 'meningkatkan', 'karier', 'dalam', 'bekerja', 'dan', 'perbaikan', 'taraf', 'hidupnya', 'keep', 'the', 'luar', 'biasa', 'kerja', 'linkedin']","['informasi', 'up', 'to', 'date', 'memudahkan', 'pencari', 'kerja', 'meningkatkan', 'karier', 'perbaikan', 'taraf', 'hidupnya', 'keep', 'the', 'kerja', 'linkedin']",28,16,12,informasi up to date mudah cari kerja tingkat karier baik taraf hidup keep the kerja linkedin,16,16
"Saya tidak menerima pesan teks kode verifikasi, ketika mencoba mendaftar ulang, muncul halaman ""let's do a quick security cek""",negatif,2023-10-03,2023,saya tidak menerima pesan teks kode verifikasi ketika mencoba mendaftar ulang muncul halaman let s do a quick security cek,19,20,saya tidak menerima pesan teks kode verifikasi ketika mencoba mendaftar ulang muncul halaman let s do a quick security cek,20,20,"['saya', 'tidak', 'menerima', 'pesan', 'teks', 'kode', 'verifikasi', 'ketika', 'mencoba', 'mendaftar', 'ulang', 'muncul', 'halaman', 'let', 's', 'do', 'a', 'quick', 'security', 'cek']","['tidak', 'menerima', 'pesan', 'teks', 'kode', 'verifikasi', 'mencoba', 'mendaftar', 'ulang', 'muncul', 'halaman', 'let', 's', 'do', 'a', 'quick', 'security', 'cek']",20,18,2,tidak terima pesan teks kode verifikasi coba daftar ulang muncul halaman let s do a quick security cek,18,18
Tolong tingkatkan lagi aplikasinya dan beri kemudahan untuk para pengguna biar para pengguna bisa lancar login aplikasi dan mudah menggunakannya,negatif,2023-08-25,2023,tolong tingkatkan lagi aplikasinya dan beri kemudahan untuk para pengguna biar para pengguna bisa lancar login aplikasi dan mudah menggunakannya,20,20,tolong tingkatkan lagi aplikasi nya dan beri kemudahan untuk para pengguna biar para pengguna bisa lancar login aplikasi dan mudah menggunakannya,20,21,"['tolong', 'tingkatkan', 'lagi', 'aplikasi', 'nya', 'dan', 'beri', 'kemudahan', 'untuk', 'para', 'pengguna', 'biar', 'para', 'pengguna', 'bisa', 'lancar', 'login', 'aplikasi', 'dan', 'mudah', 'menggunakannya']","['tolong', 'tingkatkan', 'aplikasi', 'nya', 'kemudahan', 'pengguna', 'biar', 'pengguna', 'lancar', 'login', 'aplikasi', 'mudah', 'menggunakannya']",21,13,8,tolong tingkat aplikasi nya mudah guna biar guna lancar login aplikasi mudah guna,13,13
"Kurang bermanfaat , banyak bug nya di aplikasi ini . sudah bikin akun gabisa masuk malah disuruh main tebak2an",negatif,2023-08-28,2023,kurang bermanfaat banyak bug nya di aplikasi ini sudah bikin akun gabisa masuk malah disuruh main tebak an,19,18,kurang bermanfaat banyak bug nya di aplikasi ini sudah bikin akun tidak bisa masuk bahkan disuruh main tebak an,18,19,"['kurang', 'bermanfaat', 'banyak', 'bug', 'nya', 'di', 'aplikasi', 'ini', 'sudah', 'bikin', 'akun', 'tidak', 'bisa', 'masuk', 'bahkan', 'disuruh', 'main', 'tebak', 'an']","['bermanfaat', 'bug', 'nya', 'aplikasi', 'bikin', 'akun', 'tidak', 'masuk', 'disuruh', 'main', 'tebak', 'an']",19,12,7,manfaat bug nya aplikasi bikin akun tidak masuk suruh main tebak an,12,12
Linknya ga bisa diedit. Udah dicoba berkali-kali tapi tetep link yang awal yang panjang banget:(,negatif,2023-12-30,2023,linknya ga bisa diedit udah dicoba berkali kali tapi tetep link yang awal yang panjang banget,15,16,linknya tidak bisa diedit sudah dicoba berkali kali tapi tetap link yang awal yang panjang banget,16,16,"['linknya', 'tidak', 'bisa', 'diedit', 'sudah', 'dicoba', 'berkali', 'kali', 'tapi', 'tetap', 'link', 'yang', 'awal', 'yang', 'panjang', 'banget']","['linknya', 'tidak', 'diedit', 'dicoba', 'berkali', 'kali', 'link', 'banget']",16,8,8,linknya tidak edit coba kali kali link banget,8,8
"Ini gimana tanggal berakhir pengalaman gabisa dipilih di klik juga gabisa,masa cuma tanggal mulainya aja",negatif,2023-08-27,2023,ini gimana tanggal berakhir pengalaman gabisa dipilih di klik juga gabisa masa cuma tanggal mulainya aja,15,16,ini bagaimana tanggal berakhir pengalaman tidak bisa dipilih di klik juga tidak bisa masa cuma tanggal mulainya saja,16,18,"['ini', 'bagaimana', 'tanggal', 'berakhir', 'pengalaman', 'tidak', 'bisa', 'dipilih', 'di', 'klik', 'juga', 'tidak', 'bisa', 'masa', 'cuma', 'tanggal', 'mulainya', 'saja']","['tanggal', 'pengalaman', 'tidak', 'dipilih', 'klik', 'tidak', 'tanggal', 'mulainya']",18,8,10,tanggal alam tidak pilih klik tidak tanggal mulai,8,8
"Ini gimana yaa berkali"" buat akun gabisa"" sampe ganti nomor telepon gabisa"" suruh ganti nomer"" tolong diperbaiki dong",negatif,2023-06-21,2023,ini gimana yaa berkali buat akun gabisa sampe ganti nomor telepon gabisa suruh ganti nomer tolong diperbaiki dong,18,18,ini bagaimana ya berkali buat akun tidak bisa sampai ganti nomor telpon tidak bisa suruh ganti nomor tolong di perbaiki dong,18,21,"['ini', 'bagaimana', 'ya', 'berkali', 'buat', 'akun', 'tidak', 'bisa', 'sampai', 'ganti', 'nomor', 'telpon', 'tidak', 'bisa', 'suruh', 'ganti', 'nomor', 'tolong', 'di', 'perbaiki', 'dong']","['ya', 'berkali', 'akun', 'tidak', 'ganti', 'nomor', 'telpon', 'tidak', 'suruh', 'ganti', 'nomor', 'tolong', 'perbaiki']",21,13,8,ya kali akun tidak ganti nomor telpon tidak suruh ganti nomor tolong baik,13,13
"Susah login, gambar capcha sudah diisi dengan benar selalu tidak bisa masuk.",negatif,2023-09-13,2023,susah login gambar capcha sudah diisi dengan benar selalu tidak bisa masuk,12,12,susah login gambar capcha sudah diisi dengan benar selalu tidak bisa masuk,12,12,"['susah', 'login', 'gambar', 'capcha', 'sudah', 'diisi', 'dengan', 'benar', 'selalu', 'tidak', 'bisa', 'masuk']","['susah', 'login', 'gambar', 'capcha', 'diisi', 'tidak', 'masuk']",12,7,5,susah login gambar capcha isi tidak masuk,7,7
"Tidak wort it, ga berguna, ga pernah ada panggilan kerja, aplikasi hanya mencari kebutuhan sendiri saja",negatif,2023-09-14,2023,tidak wort it ga berguna ga pernah ada panggilan kerja aplikasi hanya mencari kebutuhan sendiri saja,16,16,tidak wort it tidak berguna tidak pernah ada panggilan kerja aplikasi hanya mencari kebutuhan sendiri saja,16,16,"['tidak', 'wort', 'it', 'tidak', 'berguna', 'tidak', 'pernah', 'ada', 'panggilan', 'kerja', 'aplikasi', 'hanya', 'mencari', 'kebutuhan', 'sendiri', 'saja']","['tidak', 'wort', 'it', 'tidak', 'berguna', 'tidak', 'panggilan', 'kerja', 'aplikasi', 'mencari', 'kebutuhan']",16,11,5,tidak wort it tidak guna tidak panggil kerja aplikasi cari butuh,11,11
Susah banget masuknya.. Terus minta verifikasi. Padahal udah bener. Tapi kenapa response code nocaptcha anda tidak valid atau belum diisi. Terussss HERANNNNNN,negatif,2023-07-23,2023,susah banget masuknya terus minta verifikasi padahal udah bener tapi kenapa response code nocaptcha anda tidak valid atau belum diisi terussss herannnnnn,22,22,susah banget masuknya terus minta verifikasi padahal sudah benar tapi kenapa respons code nocaptcha anda tidak valid atau belum diisi terussss herannnnnn,22,22,"['susah', 'banget', 'masuknya', 'terus', 'minta', 'verifikasi', 'padahal', 'sudah', 'benar', 'tapi', 'kenapa', 'respons', 'code', 'nocaptcha', 'anda', 'tidak', 'valid', 'atau', 'belum', 'diisi', 'terussss', 'herannnnnn']","['susah', 'banget', 'masuknya', 'verifikasi', 'respons', 'code', 'nocaptcha', 'tidak', 'valid', 'diisi', 'terussss', 'herannnnnn']",22,12,10,susah banget masuk verifikasi respons code nocaptcha tidak valid isi terussss herannnnnn,12,12
"HATI"".. Akun mudah di hack dengan cara menautkan email yg lain. Sedangkan saya tidak pernah menyetujuinya. Akun email saya tidak dapat diakses kembali karena sudah berganti dengan akun email yg lain, namun masih menggunakan data diri saya di LinkedIn.",negatif,2023-11-03,2023,hati akun mudah di hack dengan cara menautkan email yg lain sedangkan saya tidak pernah menyetujuinya akun email saya tidak dapat diakses kembali karena sudah berganti dengan akun email yg lain namun masih menggunakan data diri saya di linkedin,39,39,hati akun mudah di hack dengan cara menautkan email yang lain sedangkan saya tidak pernah menyetujuinya akun email saya tidak dapat diakses kembali karena sudah berganti dengan akun email yang lain namun masih menggunakan data diri saya di linkedin,39,39,"['hati', 'akun', 'mudah', 'di', 'hack', 'dengan', 'cara', 'menautkan', 'email', 'yang', 'lain', 'sedangkan', 'saya', 'tidak', 'pernah', 'menyetujuinya', 'akun', 'email', 'saya', 'tidak', 'dapat', 'diakses', 'kembali', 'karena', 'sudah', 'berganti', 'dengan', 'akun', 'email', 'yang', 'lain', 'namun', 'masih', 'menggunakan', 'data', 'diri', 'saya', 'di', 'linkedin']","['hati', 'akun', 'mudah', 'hack', 'menautkan', 'email', 'tidak', 'menyetujuinya', 'akun', 'email', 'tidak', 'diakses', 'berganti', 'akun', 'email', 'data', 'linkedin']",39,17,22,hati akun mudah hack taut email tidak tuju akun email tidak akses ganti akun email data linkedin,17,17
"Dari tadi verifikasi gambar gabisa login, padahal udah bener tolong diperbaiki lagi.",negatif,2023-07-20,2023,dari tadi verifikasi gambar gabisa login padahal udah bener tolong diperbaiki lagi,12,12,dari tadi verifikasi gambar tidak bisa login padahal sudah benar tolong di perbaiki lagi,12,14,"['dari', 'tadi', 'verifikasi', 'gambar', 'tidak', 'bisa', 'login', 'padahal', 'sudah', 'benar', 'tolong', 'di', 'perbaiki', 'lagi']","['verifikasi', 'gambar', 'tidak', 'login', 'tolong', 'perbaiki']",14,6,8,verifikasi gambar tidak login tolong baik,6,6
Aplikasi ini sangat membantu freshgrad untuk mencari informasi lowongan kerja serta dapat terkoneksi langsung dengan HR yang sangat membantu untuk mengetahui tips lolos job recruitment,positif,2023-10-26,2023,aplikasi ini sangat membantu freshgrad untuk mencari informasi lowongan kerja serta dapat terkoneksi langsung dengan hr yang sangat membantu untuk mengetahui tips lolos job recruitment,25,25,aplikasi ini sangat membantu freshgrad untuk mencari informasi lowongan kerja serta dapat terkoneksi langsung dengan hari yang sangat membantu untuk mengetahui tips lolos kerja recruitment,25,25,"['aplikasi', 'ini', 'sangat', 'membantu', 'freshgrad', 'untuk', 'mencari', 'informasi', 'lowongan', 'kerja', 'serta', 'dapat', 'terkoneksi', 'langsung', 'dengan', 'hari', 'yang', 'sangat', 'membantu', 'untuk', 'mengetahui', 'tips', 'lolos', 'kerja', 'recruitment']","['aplikasi', 'membantu', 'freshgrad', 'mencari', 'informasi', 'lowongan', 'kerja', 'terkoneksi', 'langsung', 'membantu', 'tips', 'lolos', 'kerja', 'recruitment']",25,14,11,aplikasi bantu freshgrad cari informasi lowong kerja koneksi langsung bantu tips lolos kerja recruitment,14,14
Aplikasi bagus bisa buat cari pekerjaan yg kita inginkan.tapi aku sekrang masih maih ada pekerjaan.,positif,2023-09-24,2023,aplikasi bagus bisa buat cari pekerjaan yg kita inginkan tapi aku sekrang masih maih ada pekerjaan,15,16,aplikasi bagus bisa buat cari pekerjaan yang kita inginkan tapi aku sekarang masih maih ada pekerjaan,16,16,"['aplikasi', 'bagus', 'bisa', 'buat', 'cari', 'pekerjaan', 'yang', 'kita', 'inginkan', 'tapi', 'aku', 'sekarang', 'masih', 'maih', 'ada', 'pekerjaan']","['aplikasi', 'bagus', 'cari', 'pekerjaan', 'maih', 'pekerjaan']",16,6,10,aplikasi bagus cari kerja maih kerja,6,6
"Terima kasih LinkedIn, Aplikasi ini sangat bermanfaat buat pencari kerja karena kita bisa mendapatkan informasi kerja yang sesuai dengan ke ahlian kita.",positif,2023-08-06,2023,terima kasih linkedin aplikasi ini sangat bermanfaat buat pencari kerja karena kita bisa mendapatkan informasi kerja yang sesuai dengan ke ahlian kita,22,22,terima kasih linkedin aplikasi ini sangat bermanfaat buat pencari kerja karena kita bisa mendapatkan informasi kerja yang sesuai dengan ke ahlian kita,22,22,"['terima', 'kasih', 'linkedin', 'aplikasi', 'ini', 'sangat', 'bermanfaat', 'buat', 'pencari', 'kerja', 'karena', 'kita', 'bisa', 'mendapatkan', 'informasi', 'kerja', 'yang', 'sesuai', 'dengan', 'ke', 'ahlian', 'kita']","['terima', 'kasih', 'linkedin', 'aplikasi', 'bermanfaat', 'pencari', 'kerja', 'informasi', 'kerja', 'sesuai', 'ahlian']",22,11,11,terima kasih linkedin aplikasi manfaat cari kerja informasi kerja sesuai ahli,11,11
"Apknya error itu min, coba diperbaiki lagi, udah puluhan kali captha selalu bener tapi gk bisa masuk",negatif,2023-09-14,2023,apknya error itu min coba diperbaiki lagi udah puluhan kali captha selalu bener tapi gk bisa masuk,17,17,aplikasinya error itu minimal coba di perbaiki lagi sudah puluhan kali captha selalu benar tapi tidak bisa masuk,17,18,"['aplikasinya', 'error', 'itu', 'minimal', 'coba', 'di', 'perbaiki', 'lagi', 'sudah', 'puluhan', 'kali', 'captha', 'selalu', 'benar', 'tapi', 'tidak', 'bisa', 'masuk']","['aplikasinya', 'error', 'minimal', 'coba', 'perbaiki', 'puluhan', 'kali', 'captha', 'tidak', 'masuk']",18,10,8,aplikasi error minimal coba baik puluh kali captha tidak masuk,10,10
Ketika saya login ulang kenapa Verivikasi berulang ulang ini sangat mengganggu dan buruk sekali karena saya tidak bisa masuk ke akun saya,negatif,2023-09-10,2023,ketika saya login ulang kenapa verivikasi berulang ulang ini sangat mengganggu dan buruk sekali karena saya tidak bisa masuk ke akun saya,22,22,ketika saya login ulang kenapa verivikasi berulang ulang ini sangat mengganggu dan buruk sekali karena saya tidak bisa masuk ke akun saya,22,22,"['ketika', 'saya', 'login', 'ulang', 'kenapa', 'verivikasi', 'berulang', 'ulang', 'ini', 'sangat', 'mengganggu', 'dan', 'buruk', 'sekali', 'karena', 'saya', 'tidak', 'bisa', 'masuk', 'ke', 'akun', 'saya']","['login', 'ulang', 'verivikasi', 'berulang', 'ulang', 'mengganggu', 'buruk', 'tidak', 'masuk', 'akun']",22,10,12,login ulang verivikasi ulang ulang ganggu buruk tidak masuk akun,10,10
"Mau upload sertifikasi dan lisensi kesalahan tidak diketahui terus, peecuman ada fitur itu",negatif,2024-02-20,2024,mau upload sertifikasi dan lisensi kesalahan tidak diketahui terus peecuman ada fitur itu,13,13,mau unggah sertifikasi dan lisensi kesalahan tidak diketahui terus peecuman ada fitur itu,13,13,"['mau', 'unggah', 'sertifikasi', 'dan', 'lisensi', 'kesalahan', 'tidak', 'diketahui', 'terus', 'peecuman', 'ada', 'fitur', 'itu']","['unggah', 'sertifikasi', 'lisensi', 'kesalahan', 'tidak', 'peecuman', 'fitur']",13,7,6,unggah sertifikasi lisensi salah tidak peecuman fitur,7,7
aplikasi terbaik dan terpercaya terima kasih kepada owner dan menegerian aplikasi ini telah membantu saya dalam memecahkan kehidupan karena dapat lowongan di perantauan,positif,2023-12-02,2023,aplikasi terbaik dan terpercaya terima kasih kepada owner dan menegerian aplikasi ini telah membantu saya dalam memecahkan kehidupan karena dapat lowongan di perantauan,23,23,aplikasi terbaik dan terpercaya terima kasih kepada owner dan menegerian aplikasi ini telah membantu saya dalam memecahkan kehidupan karena dapat lowongan di perantauan,23,23,"['aplikasi', 'terbaik', 'dan', 'terpercaya', 'terima', 'kasih', 'kepada', 'owner', 'dan', 'menegerian', 'aplikasi', 'ini', 'telah', 'membantu', 'saya', 'dalam', 'memecahkan', 'kehidupan', 'karena', 'dapat', 'lowongan', 'di', 'perantauan']","['aplikasi', 'terbaik', 'terpercaya', 'terima', 'kasih', 'owner', 'menegerian', 'aplikasi', 'membantu', 'memecahkan', 'kehidupan', 'lowongan', 'perantauan']",23,13,10,aplikasi baik percaya terima kasih owner negeri aplikasi bantu pecah hidup lowong rantau,13,13
"Aplikasi Lucu, dia bilang gratis uji coba satu bulan. eh giliran mau nyoba dia minta transfer. jangan bohoong lah. kalau gak gratis uji coba ya bilang aja dari awal",negatif,2023-11-15,2023,aplikasi lucu dia bilang gratis uji coba satu bulan eh giliran mau nyoba dia minta transfer jangan bohoong lah kalau gak gratis uji coba ya bilang aja dari awal,29,29,aplikasi lucu dia bilang gratis uji coba satu bulan eh giliran mau mencoba dia minta transfer jangan bohoong lah kalau tidak gratis uji coba ya bilang saja dari awal,29,29,"['aplikasi', 'lucu', 'dia', 'bilang', 'gratis', 'uji', 'coba', 'satu', 'bulan', 'eh', 'giliran', 'mau', 'mencoba', 'dia', 'minta', 'transfer', 'jangan', 'bohoong', 'lah', 'kalau', 'tidak', 'gratis', 'uji', 'coba', 'ya', 'bilang', 'saja', 'dari', 'awal']","['aplikasi', 'lucu', 'bilang', 'gratis', 'uji', 'coba', 'eh', 'giliran', 'mencoba', 'transfer', 'bohoong', 'tidak', 'gratis', 'uji', 'coba', 'ya', 'bilang']",29,17,12,aplikasi lucu bilang gratis uji coba eh gilir coba transfer bohoong tidak gratis uji coba ya bilang,17,17
"Apps yg berguna untuk cari temen, dan nqmbah channel... peluang kerjanya jg bagus krn ga semua otng tau",positif,2023-11-14,2023,apps yg berguna untuk cari temen dan nqmbah channel peluang kerjanya jg bagus krn ga semua otng tau,18,18,aplikasi yang berguna untuk cari teman dan nqmbah channel peluang kerjanya juga bagus karena tidak semua otng tahu,18,18,"['aplikasi', 'yang', 'berguna', 'untuk', 'cari', 'teman', 'dan', 'nqmbah', 'channel', 'peluang', 'kerjanya', 'juga', 'bagus', 'karena', 'tidak', 'semua', 'otng', 'tahu']","['aplikasi', 'berguna', 'cari', 'teman', 'nqmbah', 'channel', 'peluang', 'kerjanya', 'bagus', 'tidak', 'otng']",18,11,7,aplikasi guna cari teman nqmbah channel peluang kerja bagus tidak otng,11,11
Sangat membantu sekali bagi kita semua.. untuk mendapatkan informasi tentang lowongan kerja dan dapat mendapatkan pengetahuan dari berbagai aspek kehidupan,positif,2023-06-11,2023,sangat membantu sekali bagi kita semua untuk mendapatkan informasi tentang lowongan kerja dan dapat mendapatkan pengetahuan dari berbagai aspek kehidupan,20,20,sangat membantu sekali bagi kita semua untuk mendapatkan informasi tentang lowongan kerja dan dapat mendapatkan pengetahuan dari berbagai aspek kehidupan,20,20,"['sangat', 'membantu', 'sekali', 'bagi', 'kita', 'semua', 'untuk', 'mendapatkan', 'informasi', 'tentang', 'lowongan', 'kerja', 'dan', 'dapat', 'mendapatkan', 'pengetahuan', 'dari', 'berbagai', 'aspek', 'kehidupan']","['membantu', 'informasi', 'lowongan', 'kerja', 'pengetahuan', 'aspek', 'kehidupan']",20,7,13,bantu informasi lowong kerja tahu aspek hidup,7,7
"Berkali² coba log in tidak bisa terus padahal sebelumnya bisa, malah diminta buat verifikasi, tolong segera diperbaiki",negatif,2023-09-05,2023,berkali² coba log in tidak bisa terus padahal sebelumnya bisa malah diminta buat verifikasi tolong segera diperbaiki,17,17,berkali² coba log in tidak bisa terus padahal sebelumnya bisa bahkan diminta buat verifikasi tolong segera di perbaiki,17,18,"['berkali²', 'coba', 'log', 'in', 'tidak', 'bisa', 'terus', 'padahal', 'sebelumnya', 'bisa', 'bahkan', 'diminta', 'buat', 'verifikasi', 'tolong', 'segera', 'di', 'perbaiki']","['berkali²', 'coba', 'log', 'in', 'tidak', 'verifikasi', 'tolong', 'perbaiki']",18,8,10,kali coba log in tidak verifikasi tolong baik,8,8
Knp mau login ga bisa bisa sih? Buka apknya balik keluar. Mau post juga balik balik.,negatif,2023-07-02,2023,knp mau login ga bisa bisa sih buka apknya balik keluar mau post juga balik balik,16,16,kenapa mau login tidak bisa bisa sih buka aplikasinya balik keluar mau post juga balik balik,16,16,"['kenapa', 'mau', 'login', 'tidak', 'bisa', 'bisa', 'sih', 'buka', 'aplikasinya', 'balik', 'keluar', 'mau', 'post', 'juga', 'balik', 'balik']","['login', 'tidak', 'sih', 'buka', 'aplikasinya', 'post']",16,6,10,login tidak sih buka aplikasi post,6,6
"Daftar buat bikin akun aja di persulit,, padahal udah bener klik gambar itu malah di salahin pas pilihan terakhir",negatif,2023-10-11,2023,daftar buat bikin akun aja di persulit padahal udah bener klik gambar itu malah di salahin pas pilihan terakhir,19,19,daftar buat bikin akun saja di persulit padahal sudah benar klik gambar itu bahkan di salahin pas pilihan terakhir,19,19,"['daftar', 'buat', 'bikin', 'akun', 'saja', 'di', 'persulit', 'padahal', 'sudah', 'benar', 'klik', 'gambar', 'itu', 'bahkan', 'di', 'salahin', 'pas', 'pilihan', 'terakhir']","['daftar', 'bikin', 'akun', 'persulit', 'klik', 'gambar', 'salahin', 'pas', 'pilihan']",19,9,10,daftar bikin akun sulit klik gambar salahin pas pilih,9,9
"Aplikasi Taii, mau login aja susah, kudu verifikasi2 gk jelas, ujung2nya eror pula. Boro2 mau dapet kerjaan, login aja ruwet",negatif,2024-01-13,2024,aplikasi taii mau login aja susah kudu verifikasi gk jelas ujung nya eror pula boro mau dapet kerjaan login aja ruwet,20,21,aplikasi taii mau login saja susah kudu verifikasi tidak jelas ujung nya error pula boro mau dapat kerjaan login saja ruwet,21,21,"['aplikasi', 'taii', 'mau', 'login', 'saja', 'susah', 'kudu', 'verifikasi', 'tidak', 'jelas', 'ujung', 'nya', 'error', 'pula', 'boro', 'mau', 'dapat', 'kerjaan', 'login', 'saja', 'ruwet']","['aplikasi', 'taii', 'login', 'susah', 'kudu', 'verifikasi', 'tidak', 'ujung', 'nya', 'error', 'boro', 'kerjaan', 'login', 'ruwet']",21,14,7,aplikasi taii login susah kudu verifikasi tidak ujung nya error boro kerja login ruwet,14,14
Gak bisa login... Keterangan captha invalid padahal dah di masukin dengan benar,negatif,2023-08-22,2023,gak bisa login keterangan captha invalid padahal dah di masukin dengan benar,12,12,tidak bisa login keterangan captha invalid padahal sudah di masukkan dengan benar,12,12,"['tidak', 'bisa', 'login', 'keterangan', 'captha', 'invalid', 'padahal', 'sudah', 'di', 'masukkan', 'dengan', 'benar']","['tidak', 'login', 'keterangan', 'captha', 'invalid', 'masukkan']",12,6,6,tidak login terang captha invalid masuk,6,6
"Akun saya diretas udah beberapa kali dan sekarang kena bobol lagi, tolong lah keamananya ditingkatkan lagi. ko bisa bisanya sekelas google authenticator juga masi bisa kena bobol",negatif,2023-09-08,2023,akun saya diretas udah beberapa kali dan sekarang kena bobol lagi tolong lah keamananya ditingkatkan lagi ko bisa bisanya sekelas google authenticator juga masi bisa kena bobol,27,27,akun saya diretas sudah beberapa kali dan sekarang kena bobol lagi tolong lah keamananya ditingkatkan lagi kok bisa bisanya sekelas google authenticator juga masih bisa kena bobol,27,27,"['akun', 'saya', 'diretas', 'sudah', 'beberapa', 'kali', 'dan', 'sekarang', 'kena', 'bobol', 'lagi', 'tolong', 'lah', 'keamananya', 'ditingkatkan', 'lagi', 'kok', 'bisa', 'bisanya', 'sekelas', 'google', 'authenticator', 'juga', 'masih', 'bisa', 'kena', 'bobol']","['akun', 'diretas', 'kali', 'kena', 'bobol', 'tolong', 'keamananya', 'ditingkatkan', 'bisanya', 'sekelas', 'google', 'authenticator', 'kena', 'bobol']",27,14,13,akun retas kali kena bobol tolong keamananya tingkat bisa kelas google authenticator kena bobol,14,14
"Login susah sekarang, email dan password sudah benar dan captcha juga benar tapi gak bisa login",negatif,2024-01-11,2024,login susah sekarang email dan password sudah benar dan captcha juga benar tapi gak bisa login,16,16,login susah sekarang email dan password sudah benar dan captcha juga benar tapi tidak bisa login,16,16,"['login', 'susah', 'sekarang', 'email', 'dan', 'password', 'sudah', 'benar', 'dan', 'captcha', 'juga', 'benar', 'tapi', 'tidak', 'bisa', 'login']","['login', 'susah', 'email', 'password', 'captcha', 'tidak', 'login']",16,7,9,login susah email password captcha tidak login,7,7
Tolong di perbaiki Saya sudah memasukkan code dengan benar tapi tetap tidak bisa Lalu saya menunggu notifikasi kirim code juga tidak ada. Dan untuk nomor saya juga tidak bisa digunakan login,negatif,2023-08-14,2023,tolong di perbaiki saya sudah memasukkan code dengan benar tapi tetap tidak bisa lalu saya menunggu notifikasi kirim code juga tidak ada dan untuk nomor saya juga tidak bisa digunakan login,31,31,tolong di perbaikan saya sudah memasukkan code dengan benar tapi tetap tidak bisa lalu saya menunggu notifikasi kirim code juga tidak ada dan untuk nomor saya juga tidak bisa digunakan login,31,31,"['tolong', 'di', 'perbaikan', 'saya', 'sudah', 'memasukkan', 'code', 'dengan', 'benar', 'tapi', 'tetap', 'tidak', 'bisa', 'lalu', 'saya', 'menunggu', 'notifikasi', 'kirim', 'code', 'juga', 'tidak', 'ada', 'dan', 'untuk', 'nomor', 'saya', 'juga', 'tidak', 'bisa', 'digunakan', 'login']","['tolong', 'perbaikan', 'memasukkan', 'code', 'tidak', 'menunggu', 'notifikasi', 'kirim', 'code', 'tidak', 'nomor', 'tidak', 'login']",31,13,18,tolong baik masuk code tidak tunggu notifikasi kirim code tidak nomor tidak login,13,13
"Mohon diperbaiki apk nya, saya mau login tapi waktu verif captcha gagal terus sampai berkali kali",negatif,2024-01-20,2024,mohon diperbaiki apk nya saya mau login tapi waktu verif captcha gagal terus sampai berkali kali,16,16,mohon di perbaiki aplikasi nya saya mau login tapi waktu verif captcha gagal terus sampai berkali kali,16,17,"['mohon', 'di', 'perbaiki', 'aplikasi', 'nya', 'saya', 'mau', 'login', 'tapi', 'waktu', 'verif', 'captcha', 'gagal', 'terus', 'sampai', 'berkali', 'kali']","['mohon', 'perbaiki', 'aplikasi', 'nya', 'login', 'verif', 'captcha', 'gagal', 'berkali', 'kali']",17,10,7,mohon baik aplikasi nya login verif captcha gagal kali kali,10,10
"Ku kira aplikasi ini penting tapi ternyata merepotkan dari awal,susah banget untuk login,mohon di perbaiki",negatif,2024-03-28,2024,ku kira aplikasi ini penting tapi ternyata merepotkan dari awal susah banget untuk login mohon di perbaiki,15,17,saya kira aplikasi ini penting tapi ternyata merepotkan dari awal susah banget untuk login mohon di perbaikan,17,17,"['saya', 'kira', 'aplikasi', 'ini', 'penting', 'tapi', 'ternyata', 'merepotkan', 'dari', 'awal', 'susah', 'banget', 'untuk', 'login', 'mohon', 'di', 'perbaikan']","['aplikasi', 'merepotkan', 'susah', 'banget', 'login', 'mohon', 'perbaikan']",17,7,10,aplikasi repot susah banget login mohon baik,7,7
Wah aplikasinya sangat berguna bisa dapet kerjaan langsung dan dapat cuan tinggal isi misinya,positif,2023-07-18,2023,wah aplikasinya sangat berguna bisa dapet kerjaan langsung dan dapat cuan tinggal isi misinya,14,14,wah aplikasi nya sangat berguna bisa dapat kerjaan langsung dan dapat cuan tinggal isi misinya,14,15,"['wah', 'aplikasi', 'nya', 'sangat', 'berguna', 'bisa', 'dapat', 'kerjaan', 'langsung', 'dan', 'dapat', 'cuan', 'tinggal', 'isi', 'misinya']","['aplikasi', 'nya', 'berguna', 'kerjaan', 'langsung', 'cuan', 'tinggal', 'isi', 'misinya']",15,9,6,aplikasi nya guna kerja langsung cuan tinggal isi misi,9,9
"Verifikasi nya berulang2 dan ga bisa masuk terus, cape banget registrasi terus",negatif,2023-09-22,2023,verifikasi nya berulang dan ga bisa masuk terus cape banget registrasi terus,12,12,verifikasi nya berulang dan tidak bisa masuk terus capek banget registrasi terus,12,12,"['verifikasi', 'nya', 'berulang', 'dan', 'tidak', 'bisa', 'masuk', 'terus', 'capek', 'banget', 'registrasi', 'terus']","['verifikasi', 'nya', 'berulang', 'tidak', 'masuk', 'capek', 'banget', 'registrasi']",12,8,4,verifikasi nya ulang tidak masuk capek banget registrasi,8,8
"ini gimana dah, waktu udh di masukin no otp nya malah di suruh masukin no hp nya lagi, yaa kan udah terdaftar ege, udah 3 minggu kaga bisa daftar ini woy",negatif,2023-06-26,2023,ini gimana dah waktu udh di masukin no otp nya malah di suruh masukin no hp nya lagi yaa kan udah terdaftar ege udah minggu kaga bisa daftar ini woy,31,30,ini bagaimana sudah waktu sudah di masukkan nomor one time password nya bahkan di suruh masukkan nomor handphone nya lagi ya akan sudah terdaftar ege sudah minggu tidak bisa daftar ini woy,30,32,"['ini', 'bagaimana', 'sudah', 'waktu', 'sudah', 'di', 'masukkan', 'nomor', 'one', 'time', 'password', 'nya', 'bahkan', 'di', 'suruh', 'masukkan', 'nomor', 'handphone', 'nya', 'lagi', 'ya', 'akan', 'sudah', 'terdaftar', 'ege', 'sudah', 'minggu', 'tidak', 'bisa', 'daftar', 'ini', 'woy']","['masukkan', 'nomor', 'one', 'time', 'password', 'nya', 'suruh', 'masukkan', 'nomor', 'handphone', 'nya', 'ya', 'terdaftar', 'ege', 'minggu', 'tidak', 'daftar', 'woy']",32,18,14,masuk nomor one time password nya suruh masuk nomor handphone nya ya daftar ege minggu tidak daftar woy,18,18
"Udah di refresh dan updt sampe nginsal lagi tapi masih aja gabisa posting, kecewa niat dari awal mau posting di linkedin susah payah ngeditnya biar bisa kebaca infonya sama temen"" yang lain",negatif,2023-09-15,2023,udah di refresh dan updt sampe nginsal lagi tapi masih aja gabisa posting kecewa niat dari awal mau posting di linkedin susah payah ngeditnya biar bisa kebaca infonya sama temen yang lain,32,32,sudah di refresh dan updt sampai nginsal lagi tapi masih saja tidak bisa posting kecewa niat dari awal mau posting di linkedin susah payah ngeditnya biar bisa kebaca informasinya sama teman yang lain,32,33,"['sudah', 'di', 'refresh', 'dan', 'updt', 'sampai', 'nginsal', 'lagi', 'tapi', 'masih', 'saja', 'tidak', 'bisa', 'posting', 'kecewa', 'niat', 'dari', 'awal', 'mau', 'posting', 'di', 'linkedin', 'susah', 'payah', 'ngeditnya', 'biar', 'bisa', 'kebaca', 'informasinya', 'sama', 'teman', 'yang', 'lain']","['refresh', 'updt', 'nginsal', 'tidak', 'posting', 'kecewa', 'niat', 'posting', 'linkedin', 'susah', 'payah', 'ngeditnya', 'biar', 'kebaca', 'informasinya', 'teman']",33,16,17,refresh updt nginsal tidak posting kecewa niat posting linkedin susah payah ngeditnya biar baca informasi teman,16,16
"Gangerti gmna ini apk gabisa login,keterangan udah verifikasi tapi tinggal masukin kode pake no telpon ditunggu berkali kali ga masuk kodenya,ganti nomor lain juga sama aja heu",negatif,2023-08-18,2023,gangerti gmna ini apk gabisa login keterangan udah verifikasi tapi tinggal masukin kode pake no telpon ditunggu berkali kali ga masuk kodenya ganti nomor lain juga sama aja heu,27,29,tidak mengerti bagaimana ini aplikasi tidak bisa login keterangan sudah verifikasi tapi tinggal masukkan kode pakai nomor telpon ditunggu berkali kali tidak masuk kodenya ganti nomor lain juga sama saja heu,29,31,"['tidak', 'mengerti', 'bagaimana', 'ini', 'aplikasi', 'tidak', 'bisa', 'login', 'keterangan', 'sudah', 'verifikasi', 'tapi', 'tinggal', 'masukkan', 'kode', 'pakai', 'nomor', 'telpon', 'ditunggu', 'berkali', 'kali', 'tidak', 'masuk', 'kodenya', 'ganti', 'nomor', 'lain', 'juga', 'sama', 'saja', 'heu']","['tidak', 'mengerti', 'aplikasi', 'tidak', 'login', 'keterangan', 'verifikasi', 'tinggal', 'masukkan', 'kode', 'pakai', 'nomor', 'telpon', 'ditunggu', 'berkali', 'kali', 'tidak', 'masuk', 'kodenya', 'ganti', 'nomor', 'heu']",31,22,9,tidak erti aplikasi tidak login terang verifikasi tinggal masuk kode pakai nomor telpon tunggu kali kali tidak masuk kode ganti nomor heu,22,22
"kenapa sekarang LinkedIn ngk bisa di buka ya , suda masuk sesuai kata sandi suda pilih gambar dengan benar , suda upload KTP tetap TDK bisa di buka , padahal aplikasi paling aku percaya ko sekarang buat kecewa ya",negatif,2023-09-23,2023,kenapa sekarang linkedin ngk bisa di buka ya suda masuk sesuai kata sandi suda pilih gambar dengan benar suda upload ktp tetap tdk bisa di buka padahal aplikasi paling aku percaya ko sekarang buat kecewa ya,39,36,kenapa sekarang linkedin tidak bisa di buka ya suda masuk sesuai kata sandi suda pilih gambar dengan benar suda unggah ktp tetap tidak bisa di buka padahal aplikasi paling aku percaya kok sekarang buat kecewa ya,36,36,"['kenapa', 'sekarang', 'linkedin', 'tidak', 'bisa', 'di', 'buka', 'ya', 'suda', 'masuk', 'sesuai', 'kata', 'sandi', 'suda', 'pilih', 'gambar', 'dengan', 'benar', 'suda', 'unggah', 'ktp', 'tetap', 'tidak', 'bisa', 'di', 'buka', 'padahal', 'aplikasi', 'paling', 'aku', 'percaya', 'kok', 'sekarang', 'buat', 'kecewa', 'ya']","['linkedin', 'tidak', 'buka', 'ya', 'suda', 'masuk', 'sesuai', 'sandi', 'suda', 'pilih', 'gambar', 'suda', 'unggah', 'ktp', 'tidak', 'buka', 'aplikasi', 'percaya', 'kecewa', 'ya']",36,20,16,linkedin tidak buka ya suda masuk sesuai sandi suda pilih gambar suda unggah ktp tidak buka aplikasi percaya kecewa ya,20,20
Kenapa tidak bisa masuk selalu ada tebak gambar buat buktikan kalau bukan robot. Udh benar jawaban malah masih dikasih teka teki lagi,negatif,2024-01-11,2024,kenapa tidak bisa masuk selalu ada tebak gambar buat buktikan kalau bukan robot udh benar jawaban malah masih dikasih teka teki lagi,22,22,kenapa tidak bisa masuk selalu ada tebak gambar buat buktikan kalau bukan robot sudah benar jawaban bahkan masih dikasih teka teki lagi,22,22,"['kenapa', 'tidak', 'bisa', 'masuk', 'selalu', 'ada', 'tebak', 'gambar', 'buat', 'buktikan', 'kalau', 'bukan', 'robot', 'sudah', 'benar', 'jawaban', 'bahkan', 'masih', 'dikasih', 'teka', 'teki', 'lagi']","['tidak', 'masuk', 'tebak', 'gambar', 'buktikan', 'robot', 'dikasih', 'teka', 'teki']",22,9,13,tidak masuk tebak gambar bukti robot kasih teka teki,9,9
"Verifikasi gambar teruus gak bisa masuk2 sangat merepotkan, bagaimana ini tolong diperbaiki",negatif,2023-08-16,2023,verifikasi gambar teruus gak bisa masuk sangat merepotkan bagaimana ini tolong diperbaiki,12,12,verifikasi gambar terus tidak bisa masuk sangat merepotkan bagaimana ini tolong di perbaiki,12,13,"['verifikasi', 'gambar', 'terus', 'tidak', 'bisa', 'masuk', 'sangat', 'merepotkan', 'bagaimana', 'ini', 'tolong', 'di', 'perbaiki']","['verifikasi', 'gambar', 'tidak', 'masuk', 'merepotkan', 'tolong', 'perbaiki']",13,7,6,verifikasi gambar tidak masuk repot tolong baik,7,7
Aplikasi Taiiiiii.. Masuk aja dibikin susah.. Data sudah bener tetap disalahkan.. Dasar aplikasi bangke,negatif,2023-11-26,2023,aplikasi taiiiiii masuk aja dibikin susah data sudah bener tetap disalahkan dasar aplikasi bangke,14,14,aplikasi taiiiiii masuk saja dibikin susah data sudah benar tetap disalahkan dasar aplikasi bangke,14,14,"['aplikasi', 'taiiiiii', 'masuk', 'saja', 'dibikin', 'susah', 'data', 'sudah', 'benar', 'tetap', 'disalahkan', 'dasar', 'aplikasi', 'bangke']","['aplikasi', 'taiiiiii', 'masuk', 'dibikin', 'susah', 'data', 'disalahkan', 'dasar', 'aplikasi', 'bangke']",14,10,4,aplikasi taiiiiii masuk bikin susah data salah dasar aplikasi bangke,10,10
Mines banget. Akun aku barusan kena hack udah coba buat backup password tetep kalah sama hackernya. Rentang banget LinkedIn kena hacker,negatif,2023-11-05,2023,mines banget akun aku barusan kena hack udah coba buat backup password tetep kalah sama hackernya rentang banget linkedin kena hacker,21,21,mines banget akun aku barusan kena hack sudah coba buat backup password tetap kalah sama hackernya rentang banget linkedin kena hacker,21,21,"['mines', 'banget', 'akun', 'aku', 'barusan', 'kena', 'hack', 'sudah', 'coba', 'buat', 'backup', 'password', 'tetap', 'kalah', 'sama', 'hackernya', 'rentang', 'banget', 'linkedin', 'kena', 'hacker']","['mines', 'banget', 'akun', 'barusan', 'kena', 'hack', 'coba', 'backup', 'password', 'kalah', 'hackernya', 'rentang', 'banget', 'linkedin', 'kena', 'hacker']",21,16,5,mes banget akun barusan kena hack coba backup password kalah hackernya rentang banget linkedin kena hacker,16,16
"Syukurlah upgradenya cepat soalnya saya coba buka dgn app pihak ke 3 ribetnya iķlannya sejubel baru bisa buka,finaly linkedin have upgrade very nice ,goodluck 😅😅🤩🤩🤩🤩🤩 thanks LinkedIn",positif,2023-08-23,2023,syukurlah upgradenya cepat soalnya saya coba buka dgn app pihak ke ribetnya iķlannya sejubel baru bisa buka finaly linkedin have upgrade very nice goodluck thanks linkedin,27,26,syukurlah upgradenya cepat soalnya saya coba buka dengan aplikasi pihak ke ribetnya iķlannya sejubel baru bisa buka finaly linkedin have upgrade sangat baik semoga beruntung terima kasih linkedin,26,28,"['syukurlah', 'upgradenya', 'cepat', 'soalnya', 'saya', 'coba', 'buka', 'dengan', 'aplikasi', 'pihak', 'ke', 'ribetnya', 'iķlannya', 'sejubel', 'baru', 'bisa', 'buka', 'finaly', 'linkedin', 'have', 'upgrade', 'sangat', 'baik', 'semoga', 'beruntung', 'terima', 'kasih', 'linkedin']","['syukurlah', 'upgradenya', 'cepat', 'coba', 'buka', 'aplikasi', 'ribetnya', 'iķlannya', 'sejubel', 'buka', 'finaly', 'linkedin', 'have', 'upgrade', 'semoga', 'beruntung', 'terima', 'kasih', 'linkedin']",28,19,9,syukur upgradenya cepat coba buka aplikasi ribetnya i lannya jubel buka finaly linkedin have upgrade moga untung terima kasih linkedin,19,20
"Bisa menambah wawasan, membuka lahan bisnis dan mencari pekerjaan, membangun koneksi dengan seluruh pengguna Linkedln di seluruh dunia. Mantap👍",positif,2023-07-10,2023,bisa menambah wawasan membuka lahan bisnis dan mencari pekerjaan membangun koneksi dengan seluruh pengguna linkedln di seluruh dunia mantap,19,19,bisa menambah wawasan membuka lahan bisnis dan mencari pekerjaan membangun koneksi dengan seluruh pengguna linkedln di seluruh dunia mantap,19,19,"['bisa', 'menambah', 'wawasan', 'membuka', 'lahan', 'bisnis', 'dan', 'mencari', 'pekerjaan', 'membangun', 'koneksi', 'dengan', 'seluruh', 'pengguna', 'linkedln', 'di', 'seluruh', 'dunia', 'mantap']","['menambah', 'wawasan', 'membuka', 'lahan', 'bisnis', 'mencari', 'pekerjaan', 'membangun', 'koneksi', 'pengguna', 'linkedln', 'dunia', 'mantap']",19,13,6,tambah wawas buka lahan bisnis cari kerja bangun koneksi guna linkedln dunia mantap,13,13
"Sangat berguna untuk mencari kerja dan mudah di gunakan, semoga kedepannya lebih berguna",positif,2023-10-21,2023,sangat berguna untuk mencari kerja dan mudah di gunakan semoga kedepannya lebih berguna,13,13,sangat berguna untuk mencari kerja dan mudah di gunakan semoga kedepannya lebih berguna,13,13,"['sangat', 'berguna', 'untuk', 'mencari', 'kerja', 'dan', 'mudah', 'di', 'gunakan', 'semoga', 'kedepannya', 'lebih', 'berguna']","['berguna', 'mencari', 'kerja', 'mudah', 'semoga', 'kedepannya', 'berguna']",13,7,6,guna cari kerja mudah moga depan guna,7,7
Apasih linkedin. Gk bisa terus keluar kode otpnya. Setelah dimasukin nomor hp nya lagi malah gk bisa digunain nomor hpnya.,negatif,2023-12-10,2023,apasih linkedin gk bisa terus keluar kode otpnya setelah dimasukin nomor hp nya lagi malah gk bisa digunain nomor hpnya,20,20,apa sih linkedin tidak bisa terus keluar kode otpnya setelah di masuk in nomor handphone nya lagi bahkan tidak bisa digunain nomor hpnya,20,23,"['apa', 'sih', 'linkedin', 'tidak', 'bisa', 'terus', 'keluar', 'kode', 'otpnya', 'setelah', 'di', 'masuk', 'in', 'nomor', 'handphone', 'nya', 'lagi', 'bahkan', 'tidak', 'bisa', 'digunain', 'nomor', 'hpnya']","['sih', 'linkedin', 'tidak', 'kode', 'otpnya', 'masuk', 'in', 'nomor', 'handphone', 'nya', 'tidak', 'digunain', 'nomor', 'hpnya']",23,14,9,sih linkedin tidak kode otpnya masuk in nomor handphone nya tidak digunain nomor hpnya,14,14
tolong batu aplikasi boss. susah bangat keluar masuk nya. seperti ada yang mengolok-olok aja.,negatif,2023-09-01,2023,tolong batu aplikasi boss susah bangat keluar masuk nya seperti ada yang mengolok olok aja,14,15,tolong batu aplikasi boss susah banget keluar masuk nya seperti ada yang mengolok olok saja,15,15,"['tolong', 'batu', 'aplikasi', 'boss', 'susah', 'banget', 'keluar', 'masuk', 'nya', 'seperti', 'ada', 'yang', 'mengolok', 'olok', 'saja']","['tolong', 'batu', 'aplikasi', 'boss', 'susah', 'banget', 'masuk', 'nya', 'mengolok', 'olok']",15,10,5,tolong batu aplikasi boss susah banget masuk nya olok olok,10,10
"Kirim kode keamanan ga pernah dikirim,gimana ini disend berulang-ulang ga dikirim juga kode keamanannya. Payah dah-_-",negatif,2023-11-28,2023,kirim kode keamanan ga pernah dikirim gimana ini disend berulang ulang ga dikirim juga kode keamanannya payah dah,16,18,kirim kode keamanan tidak pernah dikirim bagaimana ini disend berulang ulang tidak dikirim juga kode keamanannya payah sudah,18,18,"['kirim', 'kode', 'keamanan', 'tidak', 'pernah', 'dikirim', 'bagaimana', 'ini', 'disend', 'berulang', 'ulang', 'tidak', 'dikirim', 'juga', 'kode', 'keamanannya', 'payah', 'sudah']","['kirim', 'kode', 'keamanan', 'tidak', 'dikirim', 'disend', 'berulang', 'ulang', 'tidak', 'dikirim', 'kode', 'keamanannya', 'payah']",18,13,5,kirim kode aman tidak kirim disend ulang ulang tidak kirim kode aman payah,13,13
"akun saya di hack orang trs udah ngajuan buat pemulihan akun malah gada tindak lanjut dari linkedin, apalagi sekaranh harus verifikasi setiap login jdi ribet bgt",negatif,2023-07-29,2023,akun saya di hack orang trs udah ngajuan buat pemulihan akun malah gada tindak lanjut dari linkedin apalagi sekaranh harus verifikasi setiap login jdi ribet bgt,26,26,akun saya di hack orang terus sudah ngajuan buat pemulihan akun bahkan tidak ada tindak lanjut dari linkedin apalagi sekaranh harus verifikasi setiap login jadi rumit banget,26,27,"['akun', 'saya', 'di', 'hack', 'orang', 'terus', 'sudah', 'ngajuan', 'buat', 'pemulihan', 'akun', 'bahkan', 'tidak', 'ada', 'tindak', 'lanjut', 'dari', 'linkedin', 'apalagi', 'sekaranh', 'harus', 'verifikasi', 'setiap', 'login', 'jadi', 'rumit', 'banget']","['akun', 'hack', 'orang', 'ngajuan', 'pemulihan', 'akun', 'tidak', 'tindak', 'linkedin', 'sekaranh', 'verifikasi', 'login', 'rumit', 'banget']",27,14,13,akun hack orang ngajuan pulih akun tidak tindak linkedin sekaranh verifikasi login rumit banget,14,14
"Aplikasinya bagus, tapi kenapa sekarang login sangat susah, berulang-ulang kali mencoba tetap tidak bisa 👎",negatif,2023-07-28,2023,aplikasinya bagus tapi kenapa sekarang login sangat susah berulang ulang kali mencoba tetap tidak bisa,15,15,aplikasi nya bagus tapi kenapa sekarang login sangat susah berulang ulang kali mencoba tetap tidak bisa,15,16,"['aplikasi', 'nya', 'bagus', 'tapi', 'kenapa', 'sekarang', 'login', 'sangat', 'susah', 'berulang', 'ulang', 'kali', 'mencoba', 'tetap', 'tidak', 'bisa']","['aplikasi', 'nya', 'bagus', 'login', 'susah', 'berulang', 'ulang', 'kali', 'mencoba', 'tidak']",16,10,6,aplikasi nya bagus login susah ulang ulang kali coba tidak,10,10
"udah buat akun kedua kalinya tapi dapet security check mulu ni sebelumnya udah pernah ngirim ktp tapi ga diterima profil udah bener, jadi males buat masuk lagi",negatif,2023-12-24,2023,udah buat akun kedua kalinya tapi dapet security check mulu ni sebelumnya udah pernah ngirim ktp tapi ga diterima profil udah bener jadi males buat masuk lagi,27,27,sudah buat akun kedua kalinya tapi dapat security cek mulu ini sebelumnya sudah pernah mengirim ktp tapi tidak diterima profil sudah benar jadi malas buat masuk lagi,27,27,"['sudah', 'buat', 'akun', 'kedua', 'kalinya', 'tapi', 'dapat', 'security', 'cek', 'mulu', 'ini', 'sebelumnya', 'sudah', 'pernah', 'mengirim', 'ktp', 'tapi', 'tidak', 'diterima', 'profil', 'sudah', 'benar', 'jadi', 'malas', 'buat', 'masuk', 'lagi']","['akun', 'kalinya', 'security', 'cek', 'mulu', 'mengirim', 'ktp', 'tidak', 'diterima', 'profil', 'malas', 'masuk']",27,12,15,akun kali security cek mulu kirim ktp tidak terima profil malas masuk,12,12
"Apk masalah terussss, tiba2 logout sendiri. Login susah minta ampun !!!! Apk sampah !!!",negatif,2023-08-02,2023,apk masalah terussss tiba logout sendiri login susah minta ampun apk sampah,14,12,aplikasi masalah terussss tiba logout sendiri login susah minta ampun aplikasi sampah,12,12,"['aplikasi', 'masalah', 'terussss', 'tiba', 'logout', 'sendiri', 'login', 'susah', 'minta', 'ampun', 'aplikasi', 'sampah']","['aplikasi', 'terussss', 'logout', 'login', 'susah', 'ampun', 'aplikasi', 'sampah']",12,8,4,aplikasi terussss logout login susah ampun aplikasi sampah,8,8
"Mohon dapat diperbaiki ketika login, sudah memverifikasi tetap gagal",negatif,2023-07-06,2023,mohon dapat diperbaiki ketika login sudah memverifikasi tetap gagal,9,9,mohon dapat di perbaiki ketika login sudah memverifikasi tetap gagal,9,10,"['mohon', 'dapat', 'di', 'perbaiki', 'ketika', 'login', 'sudah', 'memverifikasi', 'tetap', 'gagal']","['mohon', 'perbaiki', 'login', 'memverifikasi', 'gagal']",10,5,5,mohon baik login verifikasi gagal,5,5
"Setiap login di suruh verifikasi mulu, padahal sudah benar malah ga bisa di login",negatif,2023-07-27,2023,setiap login di suruh verifikasi mulu padahal sudah benar malah ga bisa di login,14,14,setiap login di suruh verifikasi mulu padahal sudah benar bahkan tidak bisa di login,14,14,"['setiap', 'login', 'di', 'suruh', 'verifikasi', 'mulu', 'padahal', 'sudah', 'benar', 'bahkan', 'tidak', 'bisa', 'di', 'login']","['login', 'suruh', 'verifikasi', 'mulu', 'tidak', 'login']",14,6,8,login suruh verifikasi mulu tidak login,6,6
App yang bagus untuk pencari peluang dan ilmu Pokoknya good 👍banyak wawasan pengetuhan dari para profesional,positif,2023-07-03,2023,app yang bagus untuk pencari peluang dan ilmu pokoknya good banyak wawasan pengetuhan dari para profesional,16,16,aplikasi yang bagus untuk pencari peluang dan ilmu pokoknya bagus banyak wawasan pengetuhan dari para profesional,16,16,"['aplikasi', 'yang', 'bagus', 'untuk', 'pencari', 'peluang', 'dan', 'ilmu', 'pokoknya', 'bagus', 'banyak', 'wawasan', 'pengetuhan', 'dari', 'para', 'profesional']","['aplikasi', 'bagus', 'pencari', 'peluang', 'ilmu', 'pokoknya', 'bagus', 'wawasan', 'pengetuhan', 'profesional']",16,10,6,aplikasi bagus cari peluang ilmu pokok bagus wawas tuhan profesional,10,10
"Verifikasi nya ganti lah, susah banget itu buat masuk login/daftar",negatif,2023-07-09,2023,verifikasi nya ganti lah susah banget itu buat masuk login daftar,10,11,verifikasi nya ganti lah susah banget itu buat masuk login daftar,11,11,"['verifikasi', 'nya', 'ganti', 'lah', 'susah', 'banget', 'itu', 'buat', 'masuk', 'login', 'daftar']","['verifikasi', 'nya', 'ganti', 'susah', 'banget', 'masuk', 'login', 'daftar']",11,8,3,verifikasi nya ganti susah banget masuk login daftar,8,8
"Susah login, verifikasi gambar salah semua padahal sudah isi dengan benar",negatif,2024-01-31,2024,susah login verifikasi gambar salah semua padahal sudah isi dengan benar,11,11,susah login verifikasi gambar salah semua padahal sudah isi dengan benar,11,11,"['susah', 'login', 'verifikasi', 'gambar', 'salah', 'semua', 'padahal', 'sudah', 'isi', 'dengan', 'benar']","['susah', 'login', 'verifikasi', 'gambar', 'salah', 'isi']",11,6,5,susah login verifikasi gambar salah isi,6,6
Aplikasi yang sangat kaya dan berguna buat berjejaring dan berinteraksi dengan sesama profesional di industri dari seluruh dunia.,positif,2023-10-29,2023,aplikasi yang sangat kaya dan berguna buat berjejaring dan berinteraksi dengan sesama profesional di industri dari seluruh dunia,18,18,aplikasi yang sangat kayak dan berguna buat berjejaring dan berinteraksi dengan sesama profesional di industri dari seluruh dunia,18,18,"['aplikasi', 'yang', 'sangat', 'kayak', 'dan', 'berguna', 'buat', 'berjejaring', 'dan', 'berinteraksi', 'dengan', 'sesama', 'profesional', 'di', 'industri', 'dari', 'seluruh', 'dunia']","['aplikasi', 'kayak', 'berguna', 'berjejaring', 'berinteraksi', 'profesional', 'industri', 'dunia']",18,8,10,aplikasi kayak guna berjejaring interaksi profesional industri dunia,8,8
"Saya ga bisa login, padahal password ga pernah ganti, ga pernah login tempat lain juga",negatif,2023-06-29,2023,saya ga bisa login padahal password ga pernah ganti ga pernah login tempat lain juga,15,15,saya tidak bisa login padahal password tidak pernah ganti tidak pernah login tempat lain juga,15,15,"['saya', 'tidak', 'bisa', 'login', 'padahal', 'password', 'tidak', 'pernah', 'ganti', 'tidak', 'pernah', 'login', 'tempat', 'lain', 'juga']","['tidak', 'login', 'password', 'tidak', 'ganti', 'tidak', 'login']",15,7,8,tidak login password tidak ganti tidak login,7,7
"Login aja di persulit, pas liat ulasan lain juga pada sama, pada susah login !!!",negatif,2023-07-04,2023,login aja di persulit pas liat ulasan lain juga pada sama pada susah login,15,14,login saja di persulit pas lihat ulasan lain juga pada sama pada susah login,14,14,"['login', 'saja', 'di', 'persulit', 'pas', 'lihat', 'ulasan', 'lain', 'juga', 'pada', 'sama', 'pada', 'susah', 'login']","['login', 'persulit', 'pas', 'lihat', 'ulasan', 'susah', 'login']",14,7,7,login sulit pas lihat ulas susah login,7,7
"Indonesia udah banyak pengangguran, ditambah lagi di tipu ama aplikasi beginian, bukan ngasih solusi, malah nambah beban idup 🥱",negatif,2023-06-27,2023,indonesia udah banyak pengangguran ditambah lagi di tipu ama aplikasi beginian bukan ngasih solusi malah nambah beban idup,19,18,indonesia sudah banyak pengangguran ditambah lagi di tipu sama aplikasi beginian bukan memberikan solusi bahkan nambah beban hidup,18,18,"['indonesia', 'sudah', 'banyak', 'pengangguran', 'ditambah', 'lagi', 'di', 'tipu', 'sama', 'aplikasi', 'beginian', 'bukan', 'memberikan', 'solusi', 'bahkan', 'nambah', 'beban', 'hidup']","['indonesia', 'pengangguran', 'ditambah', 'tipu', 'aplikasi', 'solusi', 'nambah', 'beban', 'hidup']",18,9,9,indonesia anggur tambah tipu aplikasi solusi nambah beban hidup,9,9
Alhamdulillāh salah satu platform yg memberikan bnyk manfaat terutama utk memperluas relasi dan jaringan pekerjaan.,positif,2023-10-02,2023,alhamdulillāh salah satu platform yg memberikan bnyk manfaat terutama utk memperluas relasi dan jaringan pekerjaan,15,15,alhamdulillāh salah satu platform yang memberikan banyak manfaat terutama untuk memperluas relasi dan jaringan pekerjaan,15,15,"['alhamdulillāh', 'salah', 'satu', 'platform', 'yang', 'memberikan', 'banyak', 'manfaat', 'terutama', 'untuk', 'memperluas', 'relasi', 'dan', 'jaringan', 'pekerjaan']","['alhamdulillāh', 'salah', 'platform', 'manfaat', 'memperluas', 'relasi', 'jaringan', 'pekerjaan']",15,8,7,alhamdulill h salah platform manfaat luas relasi jaring kerja,8,9
"Aplikasi gajelas buat verifikasi selalu salah, giliran udah masukin otp sesuai yg diminta juga salah keterangan login gagal emang aplikasi gajelas.",negatif,2024-02-10,2024,aplikasi gajelas buat verifikasi selalu salah giliran udah masukin otp sesuai yg diminta juga salah keterangan login gagal emang aplikasi gajelas,21,21,aplikasi tidak jelas buat verifikasi selalu salah giliran sudah masukkan one time password sesuai yang diminta juga salah keterangan login gagal memang aplikasi tidak jelas,21,25,"['aplikasi', 'tidak', 'jelas', 'buat', 'verifikasi', 'selalu', 'salah', 'giliran', 'sudah', 'masukkan', 'one', 'time', 'password', 'sesuai', 'yang', 'diminta', 'juga', 'salah', 'keterangan', 'login', 'gagal', 'memang', 'aplikasi', 'tidak', 'jelas']","['aplikasi', 'tidak', 'verifikasi', 'salah', 'giliran', 'masukkan', 'one', 'time', 'password', 'sesuai', 'salah', 'keterangan', 'login', 'gagal', 'aplikasi', 'tidak']",25,16,9,aplikasi tidak verifikasi salah gilir masuk one time password sesuai salah terang login gagal aplikasi tidak,16,16
"Mau log in btangkut terus di verifikasi. Di ulang pake beda device ternyata sama saja, ga di ios ga di android sama aja nyangkut di verifikasi",negatif,2023-11-28,2023,mau log in btangkut terus di verifikasi di ulang pake beda device ternyata sama saja ga di ios ga di android sama aja nyangkut di verifikasi,26,26,mau log in btangkut terus di verifikasi di ulang pakai beda device ternyata sama saja tidak di ios tidak di android sama saja nyangkut di verifikasi,26,26,"['mau', 'log', 'in', 'btangkut', 'terus', 'di', 'verifikasi', 'di', 'ulang', 'pakai', 'beda', 'device', 'ternyata', 'sama', 'saja', 'tidak', 'di', 'ios', 'tidak', 'di', 'android', 'sama', 'saja', 'nyangkut', 'di', 'verifikasi']","['log', 'in', 'btangkut', 'verifikasi', 'ulang', 'pakai', 'beda', 'device', 'tidak', 'ios', 'tidak', 'android', 'nyangkut', 'verifikasi']",26,14,12,log in btangkut verifikasi ulang pakai beda device tidak ios tidak android nyangkut verifikasi,14,14
"Aplikasi Profesional paling relevan buat kaum milenial sangat up to date dengan informasi terkini di dunia bisnis,ilmu pengetahuan, dan mancanegara",positif,2024-01-09,2024,aplikasi profesional paling relevan buat kaum milenial sangat up to date dengan informasi terkini di dunia bisnis ilmu pengetahuan dan mancanegara,20,21,aplikasi profesional paling relevan buat kaum milenial sangat up to date dengan informasi terkini di dunia bisnis ilmu pengetahuan dan mancanegara,21,21,"['aplikasi', 'profesional', 'paling', 'relevan', 'buat', 'kaum', 'milenial', 'sangat', 'up', 'to', 'date', 'dengan', 'informasi', 'terkini', 'di', 'dunia', 'bisnis', 'ilmu', 'pengetahuan', 'dan', 'mancanegara']","['aplikasi', 'profesional', 'relevan', 'kaum', 'milenial', 'up', 'to', 'date', 'informasi', 'terkini', 'dunia', 'bisnis', 'ilmu', 'pengetahuan', 'mancanegara']",21,15,6,aplikasi profesional relevan kaum milenial up to date informasi kini dunia bisnis ilmu tahu mancanegara,15,15
"Tolong dibantu, akun saya tidak bisa login. Login pakai email yg sama, tapi malah kyk email kosongan, disuruh buat akun baru",negatif,2023-07-22,2023,tolong dibantu akun saya tidak bisa login login pakai email yg sama tapi malah kyk email kosongan disuruh buat akun baru,21,21,tolong dibantu akun saya tidak bisa login login pakai email yang sama tapi bahkan seperti email kosongan disuruh buat akun baru,21,21,"['tolong', 'dibantu', 'akun', 'saya', 'tidak', 'bisa', 'login', 'login', 'pakai', 'email', 'yang', 'sama', 'tapi', 'bahkan', 'seperti', 'email', 'kosongan', 'disuruh', 'buat', 'akun', 'baru']","['tolong', 'dibantu', 'akun', 'tidak', 'login', 'login', 'pakai', 'email', 'email', 'kosongan', 'disuruh', 'akun']",21,12,9,tolong bantu akun tidak login login pakai email email kosong suruh akun,12,12
"Entah salah saya apa, kenapa akun saya dinonaktifkan, salah saya apa? Saya mencoba memperbaharui selalu tidak bisa. Mohon penjelasannya. Terimakasih. Kalau akun saya bisa diaktifkan seperti semula, saya beri bintang 5. Terimakasih.",negatif,2020-06-03,2020,entah salah saya apa kenapa akun saya dinonaktifkan salah saya apa saya mencoba memperbaharui selalu tidak bisa mohon penjelasannya terimakasih kalau akun saya bisa diaktifkan seperti semula saya beri bintang terimakasih,32,31,entah salah saya apa kenapa akun saya dinonaktifkan salah saya apa saya mencoba memperbaharui selalu tidak bisa mohon penjelasannya terima kasih kalau akun saya bisa diaktifkan seperti semula saya beri bintang terima kasih,31,33,"['entah', 'salah', 'saya', 'apa', 'kenapa', 'akun', 'saya', 'dinonaktifkan', 'salah', 'saya', 'apa', 'saya', 'mencoba', 'memperbaharui', 'selalu', 'tidak', 'bisa', 'mohon', 'penjelasannya', 'terima', 'kasih', 'kalau', 'akun', 'saya', 'bisa', 'diaktifkan', 'seperti', 'semula', 'saya', 'beri', 'bintang', 'terima', 'kasih']","['salah', 'akun', 'dinonaktifkan', 'salah', 'mencoba', 'memperbaharui', 'tidak', 'mohon', 'penjelasannya', 'terima', 'kasih', 'akun', 'diaktifkan', 'bintang', 'terima', 'kasih']",33,16,17,salah akun nonaktif salah coba baharu tidak mohon jelas terima kasih akun aktif bintang terima kasih,16,16
Tidak bisa masuk. Suruh ngirim.ktp.. katanya nunggu. Tapi lama banget g bisa masuknya. Ada apa kah,negatif,2023-09-03,2023,tidak bisa masuk suruh ngirim ktp katanya nunggu tapi lama banget g bisa masuknya ada apa kah,16,17,tidak bisa masuk suruh mengirim ktp katanya tunggu tapi lama banget tidak bisa masuknya ada apa kah,17,17,"['tidak', 'bisa', 'masuk', 'suruh', 'mengirim', 'ktp', 'katanya', 'tunggu', 'tapi', 'lama', 'banget', 'tidak', 'bisa', 'masuknya', 'ada', 'apa', 'kah']","['tidak', 'masuk', 'suruh', 'mengirim', 'ktp', 'tunggu', 'banget', 'tidak', 'masuknya', 'kah']",17,10,7,tidak masuk suruh kirim ktp tunggu banget tidak masuk kah,10,10
"Maaf aplikasi sampah, tidak lebih seperti facebook, isinya cuma HRD yang nyampah tidak jelas setiap hari, aplicant palsu, apk ini sama sekali tidak membantu. Dear perusahaan kalau mau promote lebih baik pakai sosmed lain.",negatif,2024-01-18,2024,maaf aplikasi sampah tidak lebih seperti facebook isinya cuma hrd yang nyampah tidak jelas setiap hari aplicant palsu apk ini sama sekali tidak membantu dear perusahaan kalau mau promote lebih baik pakai sosmed lain,34,34,maaf aplikasi sampah tidak lebih seperti facebook isinya cuma hrd yang nyampah tidak jelas setiap hari aplicant palsu aplikasi ini sama sekali tidak membantu dear perusahaan kalau mau promote lebih baik pakai sosmed lain,34,34,"['maaf', 'aplikasi', 'sampah', 'tidak', 'lebih', 'seperti', 'facebook', 'isinya', 'cuma', 'hrd', 'yang', 'nyampah', 'tidak', 'jelas', 'setiap', 'hari', 'aplicant', 'palsu', 'aplikasi', 'ini', 'sama', 'sekali', 'tidak', 'membantu', 'dear', 'perusahaan', 'kalau', 'mau', 'promote', 'lebih', 'baik', 'pakai', 'sosmed', 'lain']","['maaf', 'aplikasi', 'sampah', 'tidak', 'facebook', 'isinya', 'hrd', 'nyampah', 'tidak', 'aplicant', 'palsu', 'aplikasi', 'tidak', 'membantu', 'dear', 'perusahaan', 'promote', 'pakai', 'sosmed']",34,19,15,maaf aplikasi sampah tidak facebook isi hrd nyampah tidak aplicant palsu aplikasi tidak bantu dear usaha promote pakai sosmed,19,19
Kenapa meminta verifikasi padahal sudah di kirim berkali kali di Gmail tapi dan di kelik di LinkedIn tapi tetap selalu minta verifikasi ke Gmail aneh,negatif,2023-08-30,2023,kenapa meminta verifikasi padahal sudah di kirim berkali kali di gmail tapi dan di kelik di linkedin tapi tetap selalu minta verifikasi ke gmail aneh,25,25,kenapa meminta verifikasi padahal sudah di kirim berkali kali di gmail tapi dan di kelik di linkedin tapi tetap selalu minta verifikasi ke gmail aneh,25,25,"['kenapa', 'meminta', 'verifikasi', 'padahal', 'sudah', 'di', 'kirim', 'berkali', 'kali', 'di', 'gmail', 'tapi', 'dan', 'di', 'kelik', 'di', 'linkedin', 'tapi', 'tetap', 'selalu', 'minta', 'verifikasi', 'ke', 'gmail', 'aneh']","['verifikasi', 'kirim', 'berkali', 'kali', 'gmail', 'kelik', 'linkedin', 'verifikasi', 'gmail', 'aneh']",25,10,15,verifikasi kirim kali kali gmail kelik linkedin verifikasi gmail aneh,10,10
Saya tidak bisa login karena captcha selalu berulang walaupun saya sudah mengisinya dengan benar,negatif,2023-08-20,2023,saya tidak bisa login karena captcha selalu berulang walaupun saya sudah mengisinya dengan benar,14,14,saya tidak bisa login karena captcha selalu berulang walaupun saya sudah mengisinya dengan benar,14,14,"['saya', 'tidak', 'bisa', 'login', 'karena', 'captcha', 'selalu', 'berulang', 'walaupun', 'saya', 'sudah', 'mengisinya', 'dengan', 'benar']","['tidak', 'login', 'captcha', 'berulang', 'mengisinya']",14,5,9,tidak login captcha ulang isi,5,5
"quick security check benar benar mengganggu, relasi saya di linkedin tidak terjamah sejak akun saya tersendat",negatif,2024-01-19,2024,quick security check benar benar mengganggu relasi saya di linkedin tidak terjamah sejak akun saya tersendat,16,16,quick security cek benar benar mengganggu relasi saya di linkedin tidak terjamah sejak akun saya tersendat,16,16,"['quick', 'security', 'cek', 'benar', 'benar', 'mengganggu', 'relasi', 'saya', 'di', 'linkedin', 'tidak', 'terjamah', 'sejak', 'akun', 'saya', 'tersendat']","['quick', 'security', 'cek', 'mengganggu', 'relasi', 'linkedin', 'tidak', 'terjamah', 'akun', 'tersendat']",16,10,6,quick security cek ganggu relasi linkedin tidak jamah akun sendat,10,10
"Gak ngebantu banget buat login nya terlalu susah kalo pakd hp, tolong di perbaiki lagi",negatif,2023-09-07,2023,gak ngebantu banget buat login nya terlalu susah kalo pakd hp tolong di perbaiki lagi,15,15,tidak membantu banget buat login nya terlalu susah kalau pakd handphone tolong di perbaikan lagi,15,15,"['tidak', 'membantu', 'banget', 'buat', 'login', 'nya', 'terlalu', 'susah', 'kalau', 'pakd', 'handphone', 'tolong', 'di', 'perbaikan', 'lagi']","['tidak', 'membantu', 'banget', 'login', 'nya', 'susah', 'pakd', 'handphone', 'tolong', 'perbaikan']",15,10,5,tidak bantu banget login nya susah pakd handphone tolong baik,10,10
Verifikasi paan cok pilih yg menghadap ke atas dh di pilih yg menghadap ke atas semua tpi kayanya salah ah di perbaiki ya,negatif,2024-01-09,2024,verifikasi paan cok pilih yg menghadap ke atas dh di pilih yg menghadap ke atas semua tpi kayanya salah ah di perbaiki ya,23,23,verifikasi paan cok pilih yang menghadap ke atas sudah di pilih yang menghadap ke atas semua tetapi kayaknya salah ah di perbaikan ya,23,23,"['verifikasi', 'paan', 'cok', 'pilih', 'yang', 'menghadap', 'ke', 'atas', 'sudah', 'di', 'pilih', 'yang', 'menghadap', 'ke', 'atas', 'semua', 'tetapi', 'kayaknya', 'salah', 'ah', 'di', 'perbaikan', 'ya']","['verifikasi', 'paan', 'cok', 'pilih', 'menghadap', 'pilih', 'menghadap', 'kayaknya', 'salah', 'ah', 'perbaikan', 'ya']",23,12,11,verifikasi paan cok pilih hadap pilih hadap kayak salah ah baik ya,12,12
Aplikasi jelek mohon untuk orang indonesia tidak mendownload nya akun saya saja di batasi secara permanen oleh pihak linkendin dan gabisa masuk padahal itu bener akun saya,negatif,2023-10-20,2023,aplikasi jelek mohon untuk orang indonesia tidak mendownload nya akun saya saja di batasi secara permanen oleh pihak linkendin dan gabisa masuk padahal itu bener akun saya,27,27,aplikasi jelek mohon untuk orang indonesia tidak mendownload nya akun saya saja di batasi secara permanen oleh pihak linkendin dan tidak bisa masuk padahal itu benar akun saya,27,28,"['aplikasi', 'jelek', 'mohon', 'untuk', 'orang', 'indonesia', 'tidak', 'mendownload', 'nya', 'akun', 'saya', 'saja', 'di', 'batasi', 'secara', 'permanen', 'oleh', 'pihak', 'linkendin', 'dan', 'tidak', 'bisa', 'masuk', 'padahal', 'itu', 'benar', 'akun', 'saya']","['aplikasi', 'jelek', 'mohon', 'orang', 'indonesia', 'tidak', 'mendownload', 'nya', 'akun', 'batasi', 'permanen', 'linkendin', 'tidak', 'masuk', 'akun']",28,15,13,aplikasi jelek mohon orang indonesia tidak mendownload nya akun batas permanen linkendin tidak masuk akun,15,15
kesalahan login seperti: kode verifikasi tidak muncul dan security-nya ga jelas,negatif,2023-12-03,2023,kesalahan login seperti kode verifikasi tidak muncul dan security nya ga jelas,11,12,kesalahan login seperti kode verifikasi tidak muncul dan security nya tidak jelas,12,12,"['kesalahan', 'login', 'seperti', 'kode', 'verifikasi', 'tidak', 'muncul', 'dan', 'security', 'nya', 'tidak', 'jelas']","['kesalahan', 'login', 'kode', 'verifikasi', 'tidak', 'muncul', 'security', 'nya', 'tidak']",12,9,3,salah login kode verifikasi tidak muncul security nya tidak,9,9
"ini kok saya ga bisa login, akun saya di tangguhkan dan diblokir, akun saya di pake sama orang lain, tanggung jawabnya mana ni pihak linkedin?!, keamanannya ga ada buat data pribadi.",negatif,2024-02-06,2024,ini kok saya ga bisa login akun saya di tangguhkan dan diblokir akun saya di pake sama orang lain tanggung jawabnya mana ni pihak linkedin keamanannya ga ada buat data pribadi,31,31,ini kok saya tidak bisa login akun saya di tangguhkan dan diblokir akun saya di pakai sama orang lain tanggung jawabnya mana ini pihak linkedin keamanannya tidak ada buat data pribadi,31,31,"['ini', 'kok', 'saya', 'tidak', 'bisa', 'login', 'akun', 'saya', 'di', 'tangguhkan', 'dan', 'diblokir', 'akun', 'saya', 'di', 'pakai', 'sama', 'orang', 'lain', 'tanggung', 'jawabnya', 'mana', 'ini', 'pihak', 'linkedin', 'keamanannya', 'tidak', 'ada', 'buat', 'data', 'pribadi']","['tidak', 'login', 'akun', 'tangguhkan', 'diblokir', 'akun', 'pakai', 'orang', 'tanggung', 'linkedin', 'keamanannya', 'tidak', 'data', 'pribadi']",31,14,17,tidak login akun tangguh blokir akun pakai orang tanggung linkedin aman tidak data pribadi,14,14
"Akun saya dibatasi, gagal login setelah di-update, saya menggunakan sosmed ini dg wajar. Maaf saya uninstall",negatif,2023-07-12,2023,akun saya dibatasi gagal login setelah di update saya menggunakan sosmed ini dg wajar maaf saya uninstall,16,17,akun saya dibatasi gagal login setelah di diperbarui saya menggunakan sosmed ini dengan wajar maaf saya uninstall,17,17,"['akun', 'saya', 'dibatasi', 'gagal', 'login', 'setelah', 'di', 'diperbarui', 'saya', 'menggunakan', 'sosmed', 'ini', 'dengan', 'wajar', 'maaf', 'saya', 'uninstall']","['akun', 'dibatasi', 'gagal', 'login', 'diperbarui', 'sosmed', 'wajar', 'maaf', 'uninstall']",17,9,8,akun batas gagal login baru sosmed wajar maaf uninstall,9,9
"Aplikasi yg sangat mudah digunakan. Banyak nambah pengetahuan, relasi, kawan, dan wawasan. Terlebih buat yang lain butuh Loker seperti saya.",positif,2022-10-09,2022,aplikasi yg sangat mudah digunakan banyak nambah pengetahuan relasi kawan dan wawasan terlebih buat yang lain butuh loker seperti saya,20,20,aplikasi yang sangat mudah digunakan banyak nambah pengetahuan relasi kawan dan wawasan terlebih buat yang lain butuh loker seperti saya,20,20,"['aplikasi', 'yang', 'sangat', 'mudah', 'digunakan', 'banyak', 'nambah', 'pengetahuan', 'relasi', 'kawan', 'dan', 'wawasan', 'terlebih', 'buat', 'yang', 'lain', 'butuh', 'loker', 'seperti', 'saya']","['aplikasi', 'mudah', 'nambah', 'pengetahuan', 'relasi', 'kawan', 'wawasan', 'butuh', 'loker']",20,9,11,aplikasi mudah nambah tahu relasi kawan wawas butuh loker,9,9
Buang2 kuota..untuk daftar aja malah disuruh memecahkan teka teki.berulang2 masak jawabnnya tidak pernah benar.akhrnya uninstal fix buang2 kuota.,negatif,2023-12-31,2023,buang kuota untuk daftar aja malah disuruh memecahkan teka teki berulang masak jawabnnya tidak pernah benar akhrnya uninstal fix buang kuota,18,21,buang kuota untuk daftar saja bahkan disuruh memecahkan teka teki berulang masak jawabnnya tidak pernah benar akhrnya hapus instalan fix buang kuota,21,22,"['buang', 'kuota', 'untuk', 'daftar', 'saja', 'bahkan', 'disuruh', 'memecahkan', 'teka', 'teki', 'berulang', 'masak', 'jawabnnya', 'tidak', 'pernah', 'benar', 'akhrnya', 'hapus', 'instalan', 'fix', 'buang', 'kuota']","['buang', 'kuota', 'daftar', 'disuruh', 'memecahkan', 'teka', 'teki', 'berulang', 'masak', 'jawabnnya', 'tidak', 'akhrnya', 'hapus', 'instalan', 'fix', 'buang', 'kuota']",22,17,5,buang kuota daftar suruh pecah teka teki ulang masak jawabnnya tidak akhrnya hapus instalan fix buang kuota,17,17
"Terima kasih linkedin, saya bisa terhubung dg orang2 profesional. Alhamdulillah saya mendapat kerja lewat apk ini.",positif,2020-04-07,2020,terima kasih linkedin saya bisa terhubung dg orang profesional alhamdulillah saya mendapat kerja lewat apk ini,16,16,terima kasih linkedin saya bisa terhubung dengan orang profesional alhamdulillah saya mendapat kerja lewat aplikasi ini,16,16,"['terima', 'kasih', 'linkedin', 'saya', 'bisa', 'terhubung', 'dengan', 'orang', 'profesional', 'alhamdulillah', 'saya', 'mendapat', 'kerja', 'lewat', 'aplikasi', 'ini']","['terima', 'kasih', 'linkedin', 'terhubung', 'orang', 'profesional', 'alhamdulillah', 'kerja', 'aplikasi']",16,9,7,terima kasih linkedin hubung orang profesional alhamdulillah kerja aplikasi,9,9
pas mau login kode captcha selalu engga bisa aneh banget padahal sudah benar jawaban nya,negatif,2023-09-06,2023,pas mau login kode captcha selalu engga bisa aneh banget padahal sudah benar jawaban nya,15,15,pas mau login kode captcha selalu tidak bisa aneh banget padahal sudah benar jawaban nya,15,15,"['pas', 'mau', 'login', 'kode', 'captcha', 'selalu', 'tidak', 'bisa', 'aneh', 'banget', 'padahal', 'sudah', 'benar', 'jawaban', 'nya']","['pas', 'login', 'kode', 'captcha', 'tidak', 'aneh', 'banget', 'nya']",15,8,7,pas login kode captcha tidak aneh banget nya,8,8
"Parah anjir ga jelas udah verifikasi dengan benar malah di ulang ulang terus, ga jelas ini apk",negatif,2023-07-14,2023,parah anjir ga jelas udah verifikasi dengan benar malah di ulang ulang terus ga jelas ini apk,17,17,parah anjir tidak jelas sudah verifikasi dengan benar bahkan di ulang ulang terus tidak jelas ini aplikasi,17,17,"['parah', 'anjir', 'tidak', 'jelas', 'sudah', 'verifikasi', 'dengan', 'benar', 'bahkan', 'di', 'ulang', 'ulang', 'terus', 'tidak', 'jelas', 'ini', 'aplikasi']","['parah', 'anjir', 'tidak', 'verifikasi', 'ulang', 'ulang', 'tidak', 'aplikasi']",17,8,9,parah anjir tidak verifikasi ulang ulang tidak aplikasi,8,8
"Saya baru mau daftar, tp verifikasi mulu, abis verifikasi lanjut ke no.telp, trus verifikasi lagi. Kapan nyari kerjanya klo masih ngurusin gambar menghadap ke atas mulu? Heiiiiii",negatif,2022-10-12,2022,saya baru mau daftar tp verifikasi mulu abis verifikasi lanjut ke no telp trus verifikasi lagi kapan nyari kerjanya klo masih ngurusin gambar menghadap ke atas mulu heiiiiii,27,28,saya baru mau daftar tapi verifikasi mulu habis verifikasi lanjut ke nomor telepon terus verifikasi lagi kapan mencari kerjanya kalau masih ngurusin gambar menghadap ke atas mulu heiiiiii,28,28,"['saya', 'baru', 'mau', 'daftar', 'tapi', 'verifikasi', 'mulu', 'habis', 'verifikasi', 'lanjut', 'ke', 'nomor', 'telepon', 'terus', 'verifikasi', 'lagi', 'kapan', 'mencari', 'kerjanya', 'kalau', 'masih', 'ngurusin', 'gambar', 'menghadap', 'ke', 'atas', 'mulu', 'heiiiiii']","['daftar', 'verifikasi', 'mulu', 'habis', 'verifikasi', 'nomor', 'telepon', 'verifikasi', 'mencari', 'kerjanya', 'ngurusin', 'gambar', 'menghadap', 'mulu', 'heiiiiii']",28,15,13,daftar verifikasi mulu habis verifikasi nomor telepon verifikasi cari kerja ngurusin gambar hadap mulu heiiiiii,15,15
Kalau mempromosikan tentang loker tolong perusahaan nya yg benar2 apakah itu perusahaan nya benar atau bukan. Banyak korban setelah mendapatkan panggilan ternyata yg buka loker itu bukan pihak perusahaan terkait melainkan para jasa calo penyalur yg meminta uang mengatasnamakan buat seragam adm dll tapi dapet kerja kagak. Tolong di perhatikan dan lebih selektif lagi supaya tidak banyak korban penipuan.,negatif,2021-11-07,2021,kalau mempromosikan tentang loker tolong perusahaan nya yg benar apakah itu perusahaan nya benar atau bukan banyak korban setelah mendapatkan panggilan ternyata yg buka loker itu bukan pihak perusahaan terkait melainkan para jasa calo penyalur yg meminta uang mengatasnamakan buat seragam adm dll tapi dapet kerja kagak tolong di perhatikan dan lebih selektif lagi supaya tidak banyak korban penipuan,59,59,kalau mempromosikan tentang loker tolong perusahaan nya yang benar apakah itu perusahaan nya benar atau bukan banyak korban setelah mendapatkan panggilan ternyata yang buka loker itu bukan pihak perusahaan terkait melainkan para jasa calo penyalur yang meminta uang mengatasnamakan buat seragam adm dan lain lain tapi dapat kerja tidak tolong di perhatikan dan lebih selektif lagi supaya tidak banyak korban penipuan,59,61,"['kalau', 'mempromosikan', 'tentang', 'loker', 'tolong', 'perusahaan', 'nya', 'yang', 'benar', 'apakah', 'itu', 'perusahaan', 'nya', 'benar', 'atau', 'bukan', 'banyak', 'korban', 'setelah', 'mendapatkan', 'panggilan', 'ternyata', 'yang', 'buka', 'loker', 'itu', 'bukan', 'pihak', 'perusahaan', 'terkait', 'melainkan', 'para', 'jasa', 'calo', 'penyalur', 'yang', 'meminta', 'uang', 'mengatasnamakan', 'buat', 'seragam', 'adm', 'dan', 'lain', 'lain', 'tapi', 'dapat', 'kerja', 'tidak', 'tolong', 'di', 'perhatikan', 'dan', 'lebih', 'selektif', 'lagi', 'supaya', 'tidak', 'banyak', 'korban', 'penipuan']","['mempromosikan', 'loker', 'tolong', 'perusahaan', 'nya', 'perusahaan', 'nya', 'korban', 'panggilan', 'buka', 'loker', 'perusahaan', 'terkait', 'jasa', 'calo', 'penyalur', 'uang', 'mengatasnamakan', 'seragam', 'adm', 'kerja', 'tidak', 'tolong', 'perhatikan', 'selektif', 'tidak', 'korban', 'penipuan']",61,28,33,promosi loker tolong usaha nya usaha nya korban panggil buka loker usaha kait jasa calo salur uang mengatasnamakan seragam adm kerja tidak tolong perhati selektif tidak korban tipu,28,28
"disuruh verifikasi padahal ga ngapa-ngapain coba, bodo banget gini aplikasinya ya kali cmn login keluar aja dapet kasus ga jelas",negatif,2023-08-16,2023,disuruh verifikasi padahal ga ngapa ngapain coba bodo banget gini aplikasinya ya kali cmn login keluar aja dapet kasus ga jelas,20,21,disuruh verifikasi padahal tidak ngapa buat apa coba bodo banget begini aplikasi nya ya kali cuman login keluar saja dapat kasus tidak jelas,21,23,"['disuruh', 'verifikasi', 'padahal', 'tidak', 'ngapa', 'buat', 'apa', 'coba', 'bodo', 'banget', 'begini', 'aplikasi', 'nya', 'ya', 'kali', 'cuman', 'login', 'keluar', 'saja', 'dapat', 'kasus', 'tidak', 'jelas']","['disuruh', 'verifikasi', 'tidak', 'ngapa', 'coba', 'bodo', 'banget', 'aplikasi', 'nya', 'ya', 'kali', 'cuman', 'login', 'tidak']",23,14,9,suruh verifikasi tidak ngapa coba bodo banget aplikasi nya ya kali cuman login tidak,14,14
Manah kata nya Linkedln tuh aplikasi pencari kerja tapi mana gua udah melamar di linkedln belum di terima terima,negatif,2023-11-18,2023,manah kata nya linkedln tuh aplikasi pencari kerja tapi mana gua udah melamar di linkedln belum di terima terima,19,19,manah kata nya linkedln tuh aplikasi pencari kerja tapi mana saya sudah melamar di linkedln belum di terima terima,19,19,"['manah', 'kata', 'nya', 'linkedln', 'tuh', 'aplikasi', 'pencari', 'kerja', 'tapi', 'mana', 'saya', 'sudah', 'melamar', 'di', 'linkedln', 'belum', 'di', 'terima', 'terima']","['manah', 'nya', 'linkedln', 'tuh', 'aplikasi', 'pencari', 'kerja', 'melamar', 'linkedln', 'terima', 'terima']",19,11,8,manah nya linkedln tuh aplikasi cari kerja lamar linkedln terima terima,11,11
"Akun aku gak bisa login sudah beberapa kali, sudah verifikasi juga tetep ajah gak bisa 😭",negatif,2023-07-17,2023,akun aku gak bisa login sudah beberapa kali sudah verifikasi juga tetep ajah gak bisa,16,15,akun aku tidak bisa login sudah beberapa kali sudah verifikasi juga tetap ajah tidak bisa,15,15,"['akun', 'aku', 'tidak', 'bisa', 'login', 'sudah', 'beberapa', 'kali', 'sudah', 'verifikasi', 'juga', 'tetap', 'ajah', 'tidak', 'bisa']","['akun', 'tidak', 'login', 'kali', 'verifikasi', 'ajah', 'tidak']",15,7,8,akun tidak login kali verifikasi ajah tidak,7,7
"Developer tlg diperbaiki apk nya. Idiot betul gak bisa login kembali, teka teki nya selalu salah. Saya yg bukan org atau apk nya yg gagal??. Tks",negatif,2024-02-15,2024,developer tlg diperbaiki apk nya idiot betul gak bisa login kembali teka teki nya selalu salah saya yg bukan org atau apk nya yg gagal tks,26,26,developer tlg di perbaiki aplikasi nya idiot betul tidak bisa login kembali teka teki nya selalu salah saya yang bukan orang atau aplikasi nya yang gagal terima kasih,26,28,"['developer', 'tlg', 'di', 'perbaiki', 'aplikasi', 'nya', 'idiot', 'betul', 'tidak', 'bisa', 'login', 'kembali', 'teka', 'teki', 'nya', 'selalu', 'salah', 'saya', 'yang', 'bukan', 'orang', 'atau', 'aplikasi', 'nya', 'yang', 'gagal', 'terima', 'kasih']","['developer', 'tlg', 'perbaiki', 'aplikasi', 'nya', 'idiot', 'tidak', 'login', 'teka', 'teki', 'nya', 'salah', 'orang', 'aplikasi', 'nya', 'gagal', 'terima', 'kasih']",28,18,10,developer tlg baik aplikasi nya idiot tidak login teka teki nya salah orang aplikasi nya gagal terima kasih,18,18
verifikasi saja lagi ribet bangeet gilaaa dari link masuk verifikasi cepat dari appstore salah terus verifikasi. Aneeeh oooyy bukan alien MANUSIA INI,negatif,2021-01-05,2021,verifikasi saja lagi ribet bangeet gilaaa dari link masuk verifikasi cepat dari appstore salah terus verifikasi aneeeh oooyy bukan alien manusia ini,22,22,verifikasi saja lagi rumit banget gilaaa dari link masuk verifikasi cepat dari appstore salah terus verifikasi aneeeh oooyy bukan alien manusia ini,22,22,"['verifikasi', 'saja', 'lagi', 'rumit', 'banget', 'gilaaa', 'dari', 'link', 'masuk', 'verifikasi', 'cepat', 'dari', 'appstore', 'salah', 'terus', 'verifikasi', 'aneeeh', 'oooyy', 'bukan', 'alien', 'manusia', 'ini']","['verifikasi', 'rumit', 'banget', 'gilaaa', 'link', 'masuk', 'verifikasi', 'cepat', 'appstore', 'salah', 'verifikasi', 'aneeeh', 'oooyy', 'alien', 'manusia']",22,15,7,verifikasi rumit banget gilaaa link masuk verifikasi cepat appstore salah verifikasi aneeeh oooyy alien manusia,15,15
Verifikasi captcha kontoll gabisa masuk padahal udah bener malah harus diulang lagi,negatif,2023-06-27,2023,verifikasi captcha kontoll gabisa masuk padahal udah bener malah harus diulang lagi,12,12,verifikasi captcha kontoll tidak bisa masuk padahal sudah benar bahkan harus diulang lagi,12,13,"['verifikasi', 'captcha', 'kontoll', 'tidak', 'bisa', 'masuk', 'padahal', 'sudah', 'benar', 'bahkan', 'harus', 'diulang', 'lagi']","['verifikasi', 'captcha', 'kontoll', 'tidak', 'masuk', 'diulang']",13,6,7,verifikasi captcha kontoll tidak masuk ulang,6,6
"Saya berharap kedepan nya , info loker linkedIn lebih dimudahkan lagi untuk login , terus ditingkatkan lagi Rating informasi lokasi dan domisili yg sesuai , terus dipertahankan lagi kinerja melamar online via LinkedIn agar terus membantu kandidat anak bangsa hebat berkarir sukses bekerja_#Sandisetiawansenagi@",positif,2020-11-22,2020,saya berharap kedepan nya info loker linkedin lebih dimudahkan lagi untuk login terus ditingkatkan lagi rating informasi lokasi dan domisili yg sesuai terus dipertahankan lagi kinerja melamar online via linkedin agar terus membantu kandidat anak bangsa hebat berkarir sukses bekerja sandisetiawansenagi,43,41,saya berharap kedepan nya informasi loker linkedin lebih dimudahkan lagi untuk login terus ditingkatkan lagi rating informasi lokasi dan domisili yang sesuai terus dipertahankan lagi kinerja melamar daring melalui linkedin agar terus membantu kandidat anak bangsa hebat berkarir sukses bekerja sandisetiawansenagi,41,41,"['saya', 'berharap', 'kedepan', 'nya', 'informasi', 'loker', 'linkedin', 'lebih', 'dimudahkan', 'lagi', 'untuk', 'login', 'terus', 'ditingkatkan', 'lagi', 'rating', 'informasi', 'lokasi', 'dan', 'domisili', 'yang', 'sesuai', 'terus', 'dipertahankan', 'lagi', 'kinerja', 'melamar', 'daring', 'melalui', 'linkedin', 'agar', 'terus', 'membantu', 'kandidat', 'anak', 'bangsa', 'hebat', 'berkarir', 'sukses', 'bekerja', 'sandisetiawansenagi']","['berharap', 'kedepan', 'nya', 'informasi', 'loker', 'linkedin', 'dimudahkan', 'login', 'ditingkatkan', 'rating', 'informasi', 'lokasi', 'domisili', 'sesuai', 'dipertahankan', 'kinerja', 'melamar', 'daring', 'linkedin', 'membantu', 'kandidat', 'anak', 'bangsa', 'hebat', 'berkarir', 'sukses', 'sandisetiawansenagi']",41,27,14,harap depan nya informasi loker linkedin mudah login tingkat rating informasi lokasi domisili sesuai tahan kerja lamar daring linkedin bantu kandidat anak bangsa hebat berkarir sukses sandisetiawansenagi,27,27
Begitu bangga bisa berkecimpung di dunia bisnis dengan media LinkedIn... Terima kasih atas dukungannya semoga menjadi aplikasi terbaik kedepannya... 👍👍👍👍,positif,2021-11-05,2021,begitu bangga bisa berkecimpung di dunia bisnis dengan media linkedin terima kasih atas dukungannya semoga menjadi aplikasi terbaik kedepannya,20,19,begitu bangga bisa berkecimpung di dunia bisnis dengan media linkedin terima kasih atas dukungannya semoga menjadi aplikasi terbaik kedepannya,19,19,"['begitu', 'bangga', 'bisa', 'berkecimpung', 'di', 'dunia', 'bisnis', 'dengan', 'media', 'linkedin', 'terima', 'kasih', 'atas', 'dukungannya', 'semoga', 'menjadi', 'aplikasi', 'terbaik', 'kedepannya']","['bangga', 'berkecimpung', 'dunia', 'bisnis', 'media', 'linkedin', 'terima', 'kasih', 'dukungannya', 'semoga', 'aplikasi', 'terbaik', 'kedepannya']",19,13,6,bangga kecimpung dunia bisnis media linkedin terima kasih dukung moga aplikasi baik depan,13,13
"Setiap mau apply ke perusahaan kenapa selalu di alihkan ke web yg lain, alhasil email saya banyak spam dari web yg udah saya kunjungi.. hssshhh bingung",negatif,2020-12-02,2020,setiap mau apply ke perusahaan kenapa selalu di alihkan ke web yg lain alhasil email saya banyak spam dari web yg udah saya kunjungi hssshhh bingung,26,26,setiap mau apply ke perusahaan kenapa selalu di alihkan ke web yang lain alhasil email saya banyak spam dari web yang sudah saya kunjungi hssshhh bingung,26,26,"['setiap', 'mau', 'apply', 'ke', 'perusahaan', 'kenapa', 'selalu', 'di', 'alihkan', 'ke', 'web', 'yang', 'lain', 'alhasil', 'email', 'saya', 'banyak', 'spam', 'dari', 'web', 'yang', 'sudah', 'saya', 'kunjungi', 'hssshhh', 'bingung']","['apply', 'perusahaan', 'alihkan', 'web', 'alhasil', 'email', 'spam', 'web', 'kunjungi', 'hssshhh', 'bingung']",26,11,15,apply usaha alih web alhasil email spam web kunjung hssshhh bingung,11,11
Buat yang Baru lulus sambil nunggu panggilan prakerja selain JobDB di aplikasi ini Juga sangat Berguna dan Bagus just put extra layer security,positif,2023-02-10,2023,buat yang baru lulus sambil nunggu panggilan prakerja selain jobdb di aplikasi ini juga sangat berguna dan bagus just put extra layer security,23,23,buat yang baru lulus sambil tunggu panggilan prakerja selain jobdb di aplikasi ini juga sangat berguna dan bagus just put extra layer security,23,23,"['buat', 'yang', 'baru', 'lulus', 'sambil', 'tunggu', 'panggilan', 'prakerja', 'selain', 'jobdb', 'di', 'aplikasi', 'ini', 'juga', 'sangat', 'berguna', 'dan', 'bagus', 'just', 'put', 'extra', 'layer', 'security']","['lulus', 'tunggu', 'panggilan', 'prakerja', 'jobdb', 'aplikasi', 'berguna', 'bagus', 'just', 'put', 'extra', 'layer', 'security']",23,13,10,lulus tunggu panggil prakerja jobdb aplikasi guna bagus just put extra layer security,13,13
"masa baru masuk udah ga bisa masuk lagi ""akun anda di nonaktifkan""perasaan ga pernah nonaktikan akun gimana nih pihak pengembang nya jangan bikin ribet pengguna yang pemula",negatif,2020-07-31,2020,masa baru masuk udah ga bisa masuk lagi akun anda di nonaktifkan perasaan ga pernah nonaktikan akun gimana nih pihak pengembang nya jangan bikin ribet pengguna yang pemula,27,28,masa baru masuk sudah tidak bisa masuk lagi akun anda di nonaktifkan perasaan tidak pernah nonaktikan akun bagaimana nih pihak pengembang nya jangan bikin rumit pengguna yang pemula,28,28,"['masa', 'baru', 'masuk', 'sudah', 'tidak', 'bisa', 'masuk', 'lagi', 'akun', 'anda', 'di', 'nonaktifkan', 'perasaan', 'tidak', 'pernah', 'nonaktikan', 'akun', 'bagaimana', 'nih', 'pihak', 'pengembang', 'nya', 'jangan', 'bikin', 'rumit', 'pengguna', 'yang', 'pemula']","['masuk', 'tidak', 'masuk', 'akun', 'nonaktifkan', 'perasaan', 'tidak', 'nonaktikan', 'akun', 'nih', 'pengembang', 'nya', 'bikin', 'rumit', 'pengguna', 'pemula']",28,16,12,masuk tidak masuk akun nonaktif asa tidak nonaktikan akun nih kembang nya bikin rumit guna mula,16,16
Parah klo kaga Mao diperbarui kaga bisa ke buka...inimah setiap Minggu juga klo liat d play sture harus diperbaharui semua ....paksaan ..,negatif,2021-05-20,2021,parah klo kaga mao diperbarui kaga bisa ke buka inimah setiap minggu juga klo liat d play sture harus diperbaharui semua paksaan,22,22,parah kalau tidak mau diperbarui tidak bisa ke buka ini mah setiap minggu juga kalau lihat di play sture harus pembaruan semua paksaan,22,23,"['parah', 'kalau', 'tidak', 'mau', 'diperbarui', 'tidak', 'bisa', 'ke', 'buka', 'ini', 'mah', 'setiap', 'minggu', 'juga', 'kalau', 'lihat', 'di', 'play', 'sture', 'harus', 'pembaruan', 'semua', 'paksaan']","['parah', 'tidak', 'diperbarui', 'tidak', 'buka', 'mah', 'minggu', 'lihat', 'play', 'sture', 'pembaruan', 'paksaan']",23,12,11,parah tidak baru tidak buka mah minggu lihat play sture baru paksa,12,12
Gabisa post dokumen. Sampe ganti ganti device Masih tetep unable to post.,negatif,2024-01-12,2024,gabisa post dokumen sampe ganti ganti device masih tetep unable to post,12,12,tidak bisa post dokumen sampai ganti ganti device masih tetap unable to post,12,13,"['tidak', 'bisa', 'post', 'dokumen', 'sampai', 'ganti', 'ganti', 'device', 'masih', 'tetap', 'unable', 'to', 'post']","['tidak', 'post', 'dokumen', 'ganti', 'ganti', 'device', 'unable', 'to', 'post']",13,9,4,tidak post dokumen ganti ganti device unable to post,9,9
Buruuuukkkk !! Bukannya mempermudah para pencari pekerja malah mempersulitnya gak otak !,negatif,2023-05-20,2023,buruuuukkkk bukannya mempermudah para pencari pekerja malah mempersulitnya gak otak,12,10,buruuuukkkk bukannya mempermudah para pencari yang kerja bahkan mempersulitnya tidak otak,10,11,"['buruuuukkkk', 'bukannya', 'mempermudah', 'para', 'pencari', 'yang', 'kerja', 'bahkan', 'mempersulitnya', 'tidak', 'otak']","['buruuuukkkk', 'mempermudah', 'pencari', 'kerja', 'mempersulitnya', 'tidak', 'otak']",11,7,4,buruuuukkkk mudah cari kerja sulit tidak otak,7,7
Aplikasi babi. Shope gua kesedot sendiri gara2 nih aplikasi. . . . Gak ada pemberitahuan umdate langsung update otomatis mana gede bayar nya 600rb,negatif,2023-06-08,2023,aplikasi babi shope gua kesedot sendiri gara nih aplikasi gak ada pemberitahuan umdate langsung update otomatis mana gede bayar nya rb,24,21,aplikasi babi shope saya kesedot sendiri gara nih aplikasi tidak ada pemberitahuan umdate langsung diperbarui otomatis mana gede bayar nya ribu,21,21,"['aplikasi', 'babi', 'shope', 'saya', 'kesedot', 'sendiri', 'gara', 'nih', 'aplikasi', 'tidak', 'ada', 'pemberitahuan', 'umdate', 'langsung', 'diperbarui', 'otomatis', 'mana', 'gede', 'bayar', 'nya', 'ribu']","['aplikasi', 'babi', 'shope', 'kesedot', 'gara', 'nih', 'aplikasi', 'tidak', 'pemberitahuan', 'umdate', 'langsung', 'diperbarui', 'otomatis', 'gede', 'bayar', 'nya', 'ribu']",21,17,4,aplikasi babi shope sedot gara nih aplikasi tidak pemberitahuan umdate langsung baru otomatis gede bayar nya ribu,17,17
"Sorry nih kasih bintang 1 karena mau buat akun aja susah banget, disuruh cari gambar hadap atas, sudah dicoba berkali2 ttp salah -,-",negatif,2021-10-11,2021,sorry nih kasih bintang karena mau buat akun aja susah banget disuruh cari gambar hadap atas sudah dicoba berkali ttp salah,23,21,sorry nih kasih bintang karena mau buat akun saja susah banget disuruh cari gambar hadap atas sudah dicoba berkali tetap salah,21,21,"['sorry', 'nih', 'kasih', 'bintang', 'karena', 'mau', 'buat', 'akun', 'saja', 'susah', 'banget', 'disuruh', 'cari', 'gambar', 'hadap', 'atas', 'sudah', 'dicoba', 'berkali', 'tetap', 'salah']","['sorry', 'nih', 'kasih', 'bintang', 'akun', 'susah', 'banget', 'disuruh', 'cari', 'gambar', 'hadap', 'dicoba', 'berkali', 'salah']",21,14,7,sorry nih kasih bintang akun susah banget suruh cari gambar hadap coba kali salah,14,14
"Gk genah , mau masuk apk aja verifnya susah bner , klo 1 gambar oke ini suruh 5 salah 1 aja ulang lgi dari awal hahaha apk jembootte ga guna",negatif,2022-08-01,2022,gk genah mau masuk apk aja verifnya susah bner klo gambar oke ini suruh salah aja ulang lgi dari awal hahaha apk jembootte ga guna,30,25,tidak genah mau masuk aplikasi saja verifnya susah bner kalau gambar oke ini suruh salah saja ulang lagi dari awal hahaha aplikasi jembootte tidak guna,25,25,"['tidak', 'genah', 'mau', 'masuk', 'aplikasi', 'saja', 'verifnya', 'susah', 'bner', 'kalau', 'gambar', 'oke', 'ini', 'suruh', 'salah', 'saja', 'ulang', 'lagi', 'dari', 'awal', 'hahaha', 'aplikasi', 'jembootte', 'tidak', 'guna']","['tidak', 'genah', 'masuk', 'aplikasi', 'verifnya', 'susah', 'bner', 'gambar', 'oke', 'suruh', 'salah', 'ulang', 'hahaha', 'aplikasi', 'jembootte', 'tidak']",25,16,9,tidak genah masuk aplikasi verifnya susah bner gambar oke suruh salah ulang hahaha aplikasi jembootte tidak,16,16
"Lumayan bagus lah. Bisa menyusun CV juga dengan fitur yang ada disini. Dan alhamduliLLAh sekarang saya bisa mendapat pekerjaan menjadi wartawan... Keep the Good Job, guys..!!! 💪👊👍",positif,2021-12-20,2021,lumayan bagus lah bisa menyusun cv juga dengan fitur yang ada disini dan alhamdulillah sekarang saya bisa mendapat pekerjaan menjadi wartawan keep the good job guys,27,26,lumayan bagus lah bisa menyusun cv juga dengan fitur yang ada disini dan alhamdulillah sekarang saya bisa mendapat pekerjaan menjadi wartawan keep the bagus kerja guys,26,26,"['lumayan', 'bagus', 'lah', 'bisa', 'menyusun', 'cv', 'juga', 'dengan', 'fitur', 'yang', 'ada', 'disini', 'dan', 'alhamdulillah', 'sekarang', 'saya', 'bisa', 'mendapat', 'pekerjaan', 'menjadi', 'wartawan', 'keep', 'the', 'bagus', 'kerja', 'guys']","['lumayan', 'bagus', 'menyusun', 'cv', 'fitur', 'alhamdulillah', 'pekerjaan', 'wartawan', 'keep', 'the', 'bagus', 'kerja', 'guys']",26,13,13,lumayan bagus susun cv fitur alhamdulillah kerja wartawan keep the bagus kerja guys,13,13
Ini log in ribet amat capca nya ga bisa bisa login ulang susah lama gimana ya pdhal dah punya akun di sini giliran log in lagi gad bisa,negatif,2024-02-02,2024,ini log in ribet amat capca nya ga bisa bisa login ulang susah lama gimana ya pdhal dah punya akun di sini giliran log in lagi gad bisa,28,28,ini log in rumit amat capca nya tidak bisa bisa login ulang susah lama bagaimana ya pdhal sudah punya akun di sini giliran log in lagi gad bisa,28,28,"['ini', 'log', 'in', 'rumit', 'amat', 'capca', 'nya', 'tidak', 'bisa', 'bisa', 'login', 'ulang', 'susah', 'lama', 'bagaimana', 'ya', 'pdhal', 'sudah', 'punya', 'akun', 'di', 'sini', 'giliran', 'log', 'in', 'lagi', 'gad', 'bisa']","['log', 'in', 'rumit', 'capca', 'nya', 'tidak', 'login', 'ulang', 'susah', 'ya', 'pdhal', 'akun', 'giliran', 'log', 'in', 'gad']",28,16,12,log in rumit capca nya tidak login ulang susah ya pdhal akun gilir log in gad,16,16
Tempat para pencari dan pemberi kerja... Seluruh dunia bisa melihat data pencarian dan data perusahaan yang di cari semoga bisa mendapatkan sesuai dengan keinginan,positif,2020-11-03,2020,tempat para pencari dan pemberi kerja seluruh dunia bisa melihat data pencarian dan data perusahaan yang di cari semoga bisa mendapatkan sesuai dengan keinginan,24,24,tempat para pencari dan pemberi kerja seluruh dunia bisa melihat data pencarian dan data perusahaan yang di cari semoga bisa mendapatkan sesuai dengan keinginan,24,24,"['tempat', 'para', 'pencari', 'dan', 'pemberi', 'kerja', 'seluruh', 'dunia', 'bisa', 'melihat', 'data', 'pencarian', 'dan', 'data', 'perusahaan', 'yang', 'di', 'cari', 'semoga', 'bisa', 'mendapatkan', 'sesuai', 'dengan', 'keinginan']","['pencari', 'pemberi', 'kerja', 'dunia', 'data', 'pencarian', 'data', 'perusahaan', 'cari', 'semoga', 'sesuai']",24,11,13,cari beri kerja dunia data cari data usaha cari moga sesuai,11,11
"akun saya terkena hack , dan di cekal sementara oleh pihak linkedin , padahal koneksi saya sudah luas dan miris sekali saya sudah ajukan banding dengan menyerahkan KTP hingga 1 minggu kerja belum ada kepastian dari linkedin",negatif,2023-09-05,2023,akun saya terkena hack dan di cekal sementara oleh pihak linkedin padahal koneksi saya sudah luas dan miris sekali saya sudah ajukan banding dengan menyerahkan ktp hingga minggu kerja belum ada kepastian dari linkedin,37,34,akun saya terkena hack dan di cekal sementara oleh pihak linkedin padahal koneksi saya sudah luas dan miris sekali saya sudah ajukan banding dengan menyerahkan ktp hingga minggu kerja belum ada kepastian dari linkedin,34,34,"['akun', 'saya', 'terkena', 'hack', 'dan', 'di', 'cekal', 'sementara', 'oleh', 'pihak', 'linkedin', 'padahal', 'koneksi', 'saya', 'sudah', 'luas', 'dan', 'miris', 'sekali', 'saya', 'sudah', 'ajukan', 'banding', 'dengan', 'menyerahkan', 'ktp', 'hingga', 'minggu', 'kerja', 'belum', 'ada', 'kepastian', 'dari', 'linkedin']","['akun', 'terkena', 'hack', 'cekal', 'linkedin', 'koneksi', 'luas', 'miris', 'ajukan', 'banding', 'menyerahkan', 'ktp', 'minggu', 'kerja', 'kepastian', 'linkedin']",34,16,18,akun kena hack cekal linkedin koneksi luas miris aju banding serah ktp minggu kerja pasti linkedin,16,16
Aplikasi busuk banget sumpah. Maksudnya apaan suruh nebak gambar ngehadap keatas. Salah terus. Ampun dah.,negatif,2023-02-20,2023,aplikasi busuk banget sumpah maksudnya apaan suruh nebak gambar ngehadap keatas salah terus ampun dah,15,15,aplikasi busuk banget sumpah maksudnya apa suruh nebak gambar ngehadap keatas salah terus ampun sudah,15,15,"['aplikasi', 'busuk', 'banget', 'sumpah', 'maksudnya', 'apa', 'suruh', 'nebak', 'gambar', 'ngehadap', 'keatas', 'salah', 'terus', 'ampun', 'sudah']","['aplikasi', 'busuk', 'banget', 'sumpah', 'maksudnya', 'suruh', 'nebak', 'gambar', 'ngehadap', 'keatas', 'salah', 'ampun']",15,12,3,aplikasi busuk banget sumpah maksud suruh nebak gambar ngehadap atas salah ampun,12,12
"apasih sok asik bener, udh ditungguin kode verifikasi nya masih aja lama, giliran dispam no HP nya gbisa dipake lagi,kudu ganti no yg lain, kocak²",negatif,2023-12-10,2023,apasih sok asik bener udh ditungguin kode verifikasi nya masih aja lama giliran dispam no hp nya gbisa dipake lagi kudu ganti no yg lain kocak²,25,26,apa sih sok asyik benar sudah di tunggu in kode verifikasi nya masih saja lama giliran dispam nomor handphone nya gbisa di pakai lagi kudu ganti nomor yang lain kocak²,26,30,"['apa', 'sih', 'sok', 'asyik', 'benar', 'sudah', 'di', 'tunggu', 'in', 'kode', 'verifikasi', 'nya', 'masih', 'saja', 'lama', 'giliran', 'dispam', 'nomor', 'handphone', 'nya', 'gbisa', 'di', 'pakai', 'lagi', 'kudu', 'ganti', 'nomor', 'yang', 'lain', 'kocak²']","['sih', 'sok', 'asyik', 'tunggu', 'in', 'kode', 'verifikasi', 'nya', 'giliran', 'dispam', 'nomor', 'handphone', 'nya', 'gbisa', 'pakai', 'kudu', 'ganti', 'nomor', 'kocak²']",30,19,11,sih sok asyik tunggu in kode verifikasi nya gilir dispam nomor handphone nya gbisa pakai kudu ganti nomor kocak,19,19
"Sekarang untuk login atau daftar susah, aneh bgt verifikasi suruh pilih gambar yg menghadap ke atas.. Setelah di klik pun tetap salah dan coba lagi sampe kiamat",negatif,2021-10-12,2021,sekarang untuk login atau daftar susah aneh bgt verifikasi suruh pilih gambar yg menghadap ke atas setelah di klik pun tetap salah dan coba lagi sampe kiamat,27,27,sekarang untuk login atau daftar susah aneh banget verifikasi suruh pilih gambar yang menghadap ke atas setelah di klik pun tetap salah dan coba lagi sampai kiamat,27,27,"['sekarang', 'untuk', 'login', 'atau', 'daftar', 'susah', 'aneh', 'banget', 'verifikasi', 'suruh', 'pilih', 'gambar', 'yang', 'menghadap', 'ke', 'atas', 'setelah', 'di', 'klik', 'pun', 'tetap', 'salah', 'dan', 'coba', 'lagi', 'sampai', 'kiamat']","['login', 'daftar', 'susah', 'aneh', 'banget', 'verifikasi', 'suruh', 'pilih', 'gambar', 'menghadap', 'klik', 'salah', 'coba', 'kiamat']",27,14,13,login daftar susah aneh banget verifikasi suruh pilih gambar hadap klik salah coba kiamat,14,14
Di aplikasi liat profil sendiri aja susah ga ada menunya abs di update,negatif,2023-09-07,2023,di aplikasi liat profil sendiri aja susah ga ada menunya abs di update,13,13,di aplikasi lihat profil sendiri saja susah tidak ada menunya abs di diperbarui,13,13,"['di', 'aplikasi', 'lihat', 'profil', 'sendiri', 'saja', 'susah', 'tidak', 'ada', 'menunya', 'abs', 'di', 'diperbarui']","['aplikasi', 'lihat', 'profil', 'susah', 'tidak', 'menunya', 'abs', 'diperbarui']",13,8,5,aplikasi lihat profil susah tidak menu abs baru,8,8
Aplikasi yang sangat bagus dalam mencari loker dan informasi perusahaan besar Terima kasih linkedln,positif,2023-07-13,2023,aplikasi yang sangat bagus dalam mencari loker dan informasi perusahaan besar terima kasih linkedln,14,14,aplikasi yang sangat bagus dalam mencari loker dan informasi perusahaan besar terima kasih linkedln,14,14,"['aplikasi', 'yang', 'sangat', 'bagus', 'dalam', 'mencari', 'loker', 'dan', 'informasi', 'perusahaan', 'besar', 'terima', 'kasih', 'linkedln']","['aplikasi', 'bagus', 'mencari', 'loker', 'informasi', 'perusahaan', 'terima', 'kasih', 'linkedln']",14,9,5,aplikasi bagus cari loker informasi usaha terima kasih linkedln,9,9
Saya sudah verifikasi email. Tapi ketika mau apply lamaran selalu minta verifikasi.,negatif,2023-06-05,2023,saya sudah verifikasi email tapi ketika mau apply lamaran selalu minta verifikasi,12,12,saya sudah verifikasi email tapi ketika mau apply lamaran selalu minta verifikasi,12,12,"['saya', 'sudah', 'verifikasi', 'email', 'tapi', 'ketika', 'mau', 'apply', 'lamaran', 'selalu', 'minta', 'verifikasi']","['verifikasi', 'email', 'apply', 'lamaran', 'verifikasi']",12,5,7,verifikasi email apply lamar verifikasi,5,5
"Buruk sekali,ngak tau apa"" akun Lunkedln dibatasi,disuruh verivikasi,udah 2 minggu sejak verikasi akun masih dibatasi,gak dijelaskan juga spesifik alasan kenapa akun dibatasi",negatif,2023-10-10,2023,buruk sekali ngak tau apa akun lunkedln dibatasi disuruh verivikasi udah minggu sejak verikasi akun masih dibatasi gak dijelaskan juga spesifik alasan kenapa akun dibatasi,22,25,buruk sekali tidak tahu apa akun lunkedln dibatasi disuruh verivikasi sudah minggu sejak verikasi akun masih dibatasi tidak dijelaskan juga spesifik alasan kenapa akun dibatasi,25,25,"['buruk', 'sekali', 'tidak', 'tahu', 'apa', 'akun', 'lunkedln', 'dibatasi', 'disuruh', 'verivikasi', 'sudah', 'minggu', 'sejak', 'verikasi', 'akun', 'masih', 'dibatasi', 'tidak', 'dijelaskan', 'juga', 'spesifik', 'alasan', 'kenapa', 'akun', 'dibatasi']","['buruk', 'tidak', 'akun', 'lunkedln', 'dibatasi', 'disuruh', 'verivikasi', 'minggu', 'verikasi', 'akun', 'dibatasi', 'tidak', 'spesifik', 'alasan', 'akun', 'dibatasi']",25,16,9,buruk tidak akun lunkedln batas suruh verivikasi minggu verikasi akun batas tidak spesifik alas akun batas,16,16
"Udah pake aplikasi ini dari lama utk di Dunia Kerja, semoga bermanfaat & barokah aja.. Tks_Ajkh:) 👍",positif,2020-11-19,2020,udah pake aplikasi ini dari lama utk di dunia kerja semoga bermanfaat barokah aja tks ajkh,17,16,sudah pakai aplikasi ini dari lama untuk di dunia kerja semoga bermanfaat barokah saja terima kasih ajkh,16,17,"['sudah', 'pakai', 'aplikasi', 'ini', 'dari', 'lama', 'untuk', 'di', 'dunia', 'kerja', 'semoga', 'bermanfaat', 'barokah', 'saja', 'terima', 'kasih', 'ajkh']","['pakai', 'aplikasi', 'dunia', 'kerja', 'semoga', 'bermanfaat', 'barokah', 'terima', 'kasih', 'ajkh']",17,10,7,pakai aplikasi dunia kerja moga manfaat barokah terima kasih ajkh,10,10
Verifikasi nomor telpon lama dan ketika masukin verifikasi nya malah disuruh masukin nomor lagi mana kudu nomor lain kagak bisa Pake nomor yang tadi,negatif,2023-03-23,2023,verifikasi nomor telpon lama dan ketika masukin verifikasi nya malah disuruh masukin nomor lagi mana kudu nomor lain kagak bisa pake nomor yang tadi,24,24,verifikasi nomor telpon lama dan ketika masukkan verifikasi nya bahkan disuruh masukkan nomor lagi mana kudu nomor lain tidak bisa pakai nomor yang tadi,24,24,"['verifikasi', 'nomor', 'telpon', 'lama', 'dan', 'ketika', 'masukkan', 'verifikasi', 'nya', 'bahkan', 'disuruh', 'masukkan', 'nomor', 'lagi', 'mana', 'kudu', 'nomor', 'lain', 'tidak', 'bisa', 'pakai', 'nomor', 'yang', 'tadi']","['verifikasi', 'nomor', 'telpon', 'masukkan', 'verifikasi', 'nya', 'disuruh', 'masukkan', 'nomor', 'kudu', 'nomor', 'tidak', 'pakai', 'nomor']",24,14,10,verifikasi nomor telpon masuk verifikasi nya suruh masuk nomor kudu nomor tidak pakai nomor,14,14
Mau buka/daftar ketika nulis spt yg diminta..eeeehh balik ke awal lg & itu berkali2 -____-,negatif,2020-07-06,2020,mau buka daftar ketika nulis spt yg diminta eeeehh balik ke awal lg itu berkali,15,15,mau buka daftar ketika nulis seperti yang diminta eeeehh balik ke awal lagi itu berkali,15,15,"['mau', 'buka', 'daftar', 'ketika', 'nulis', 'seperti', 'yang', 'diminta', 'eeeehh', 'balik', 'ke', 'awal', 'lagi', 'itu', 'berkali']","['buka', 'daftar', 'nulis', 'eeeehh', 'berkali']",15,5,10,buka daftar nulis eeeehh kali,5,5
ajang pamer dan pencitraan. dapet kerjaan kagak...harga diri hilang. loker isinyaa gitu2 aja. ngabisin kuota doang sama space memory.,negatif,2022-03-29,2022,ajang pamer dan pencitraan dapet kerjaan kagak harga diri hilang loker isinyaa gitu aja ngabisin kuota doang sama space memory,19,20,ajang pamer dan pencitraan dapat kerjaan tidak harga diri hilang loker isinyaa begitu saja ngabisin kuota saja sama space memory,20,20,"['ajang', 'pamer', 'dan', 'pencitraan', 'dapat', 'kerjaan', 'tidak', 'harga', 'diri', 'hilang', 'loker', 'isinyaa', 'begitu', 'saja', 'ngabisin', 'kuota', 'saja', 'sama', 'space', 'memory']","['ajang', 'pamer', 'pencitraan', 'kerjaan', 'tidak', 'harga', 'hilang', 'loker', 'isinyaa', 'ngabisin', 'kuota', 'space', 'memory']",20,13,7,ajang pamer citra kerja tidak harga hilang loker isinyaa ngabisin kuota space memory,13,13
"Baru daftar udah susah sungguh buruk diperbaiki sistemnya y pdhl saya pakai WiFi blank aja GK gerak2 loading apa eror nunggu smpe lama masih gtu j ,uninstal j ni",negatif,2022-07-04,2022,baru daftar udah susah sungguh buruk diperbaiki sistemnya y pdhl saya pakai wifi blank aja gk gerak loading apa eror nunggu smpe lama masih gtu j uninstal j ni,29,29,baru daftar sudah susah sungguh buruk di perbaiki sistemnya ya padahal saya pakai wifi blank saja tidak gerak loading apa error tunggu sampai lama masih begitu j hapus instalan j ini,29,31,"['baru', 'daftar', 'sudah', 'susah', 'sungguh', 'buruk', 'di', 'perbaiki', 'sistemnya', 'ya', 'padahal', 'saya', 'pakai', 'wifi', 'blank', 'saja', 'tidak', 'gerak', 'loading', 'apa', 'error', 'tunggu', 'sampai', 'lama', 'masih', 'begitu', 'j', 'hapus', 'instalan', 'j', 'ini']","['daftar', 'susah', 'sungguh', 'buruk', 'perbaiki', 'sistemnya', 'ya', 'pakai', 'wifi', 'blank', 'tidak', 'gerak', 'loading', 'error', 'tunggu', 'j', 'hapus', 'instalan', 'j']",31,19,12,daftar susah sungguh buruk baik sistem ya pakai wifi blank tidak gerak loading error tunggu j hapus instalan j,19,19
Dengan ada nya Aplikasi in bisa membantu saya untuk mendapatkan lowongan pekerjaan trimkasih 🙏🙏🙏🙏🙏,positif,2023-07-18,2023,dengan ada nya aplikasi in bisa membantu saya untuk mendapatkan lowongan pekerjaan trimkasih,14,13,dengan ada nya aplikasi in bisa membantu saya untuk mendapatkan lowongan pekerjaan trimkasih,13,13,"['dengan', 'ada', 'nya', 'aplikasi', 'in', 'bisa', 'membantu', 'saya', 'untuk', 'mendapatkan', 'lowongan', 'pekerjaan', 'trimkasih']","['nya', 'aplikasi', 'in', 'membantu', 'lowongan', 'pekerjaan', 'trimkasih']",13,7,6,nya aplikasi in bantu lowong kerja trimkasih,7,7
Parah benar akun saya tiba tiba diblokir karena penjelasan tidak jelas dan saya ikuti sesuai arahan mereka tapi parah asli sdh hampir seminggu tidak dibuka...saya akan lapor komplain saya ini,negatif,2023-08-19,2023,parah benar akun saya tiba tiba diblokir karena penjelasan tidak jelas dan saya ikuti sesuai arahan mereka tapi parah asli sdh hampir seminggu tidak dibuka saya akan lapor komplain saya ini,30,31,parah benar akun saya tiba tiba diblokir karena penjelasan tidak jelas dan saya ikuti sesuai arahan mereka tapi parah asli sudah hampir seminggu tidak dibuka saya akan lapor komplain saya ini,31,31,"['parah', 'benar', 'akun', 'saya', 'tiba', 'tiba', 'diblokir', 'karena', 'penjelasan', 'tidak', 'jelas', 'dan', 'saya', 'ikuti', 'sesuai', 'arahan', 'mereka', 'tapi', 'parah', 'asli', 'sudah', 'hampir', 'seminggu', 'tidak', 'dibuka', 'saya', 'akan', 'lapor', 'komplain', 'saya', 'ini']","['parah', 'akun', 'diblokir', 'penjelasan', 'tidak', 'ikuti', 'sesuai', 'arahan', 'parah', 'asli', 'seminggu', 'tidak', 'dibuka', 'lapor', 'komplain']",31,15,16,parah akun blokir jelas tidak ikut sesuai arah parah asli minggu tidak buka lapor komplain,15,15
LinkedIn sangat membantu dalam mencari info pekerjaan. Tolong disempurnakan fitur chatnya agar lebih mudah dan atractive. Terimakasih.,positif,2021-02-28,2021,linkedin sangat membantu dalam mencari info pekerjaan tolong disempurnakan fitur chatnya agar lebih mudah dan atractive terimakasih,17,17,linkedin sangat membantu dalam mencari informasi pekerjaan tolong disempurnakan fitur chat nya agar lebih mudah dan atractive terima kasih,17,19,"['linkedin', 'sangat', 'membantu', 'dalam', 'mencari', 'informasi', 'pekerjaan', 'tolong', 'disempurnakan', 'fitur', 'chat', 'nya', 'agar', 'lebih', 'mudah', 'dan', 'atractive', 'terima', 'kasih']","['linkedin', 'membantu', 'mencari', 'informasi', 'pekerjaan', 'tolong', 'disempurnakan', 'fitur', 'chat', 'nya', 'mudah', 'atractive', 'terima', 'kasih']",19,14,5,linkedin bantu cari informasi kerja tolong sempurna fitur chat nya mudah atractive terima kasih,14,14
"gua mau login ulang ke akun gua yg lama..ih gua lupa kata sandinya pas gua tekan lupa kata sandi..malah hanya di arahin masukan pin yg di kirim dll tapi tdk ad 'BUAT KATA SANDI BARU' ehh trus malah hanya di suruh login ulang, kan gua lupa kata sandi gua😭...gak jelas banget ni apk",negatif,2023-12-30,2023,gua mau login ulang ke akun gua yg lama ih gua lupa kata sandinya pas gua tekan lupa kata sandi malah hanya di arahin masukan pin yg di kirim dll tapi tdk ad buat kata sandi baru ehh trus malah hanya di suruh login ulang kan gua lupa kata sandi gua gak jelas banget ni apk,53,56,saya mau login ulang ke akun saya yang lama ih saya lupa kata sandinya pas saya tekan lupa kata sandi bahkan hanya di arahin masukan pin yang di kirim dan lain lain tapi tidak ada buat kata sandi baru eh terus bahkan hanya di suruh login ulang akan saya lupa kata sandi saya tidak jelas banget ini aplikasi,56,58,"['saya', 'mau', 'login', 'ulang', 'ke', 'akun', 'saya', 'yang', 'lama', 'ih', 'saya', 'lupa', 'kata', 'sandinya', 'pas', 'saya', 'tekan', 'lupa', 'kata', 'sandi', 'bahkan', 'hanya', 'di', 'arahin', 'masukan', 'pin', 'yang', 'di', 'kirim', 'dan', 'lain', 'lain', 'tapi', 'tidak', 'ada', 'buat', 'kata', 'sandi', 'baru', 'eh', 'terus', 'bahkan', 'hanya', 'di', 'suruh', 'login', 'ulang', 'akan', 'saya', 'lupa', 'kata', 'sandi', 'saya', 'tidak', 'jelas', 'banget', 'ini', 'aplikasi']","['login', 'ulang', 'akun', 'ih', 'lupa', 'sandinya', 'pas', 'tekan', 'lupa', 'sandi', 'arahin', 'masukan', 'pin', 'kirim', 'tidak', 'sandi', 'eh', 'suruh', 'login', 'ulang', 'lupa', 'sandi', 'tidak', 'banget', 'aplikasi']",58,25,33,login ulang akun ih lupa sandi pas tekan lupa sandi arahin masuk pin kirim tidak sandi eh suruh login ulang lupa sandi tidak banget aplikasi,25,25
Aneh berkali-kali log in ga bisa padahal kata sandi sama user name nya bener,negatif,2024-08-15,2024,aneh berkali kali log in ga bisa padahal kata sandi sama user name nya bener,14,15,aneh berkali kali log in tidak bisa padahal kata sandi sama user name nya benar,15,15,"['aneh', 'berkali', 'kali', 'log', 'in', 'tidak', 'bisa', 'padahal', 'kata', 'sandi', 'sama', 'user', 'name', 'nya', 'benar']","['aneh', 'berkali', 'kali', 'log', 'in', 'tidak', 'sandi', 'user', 'name', 'nya']",15,10,5,aneh kali kali log in tidak sandi user name nya,10,10
"Udah beberapa kali dapet panggilan kerja,, 10 kali lebih ga ada satupun yg asli,, Hoax semua,,masa iya tes PT yg berbeda tapi tempat tes.nya sama,,di ruko"" lgi,,tolong tingkatkan lgi biar loker"" penipu bisa di laporkan,kasian yg baru lulus yg belum pengalaman nanti kena tipu",negatif,2022-07-14,2022,udah beberapa kali dapet panggilan kerja kali lebih ga ada satupun yg asli hoax semua masa iya tes pt yg berbeda tapi tempat tes nya sama di ruko lgi tolong tingkatkan lgi biar loker penipu bisa di laporkan kasian yg baru lulus yg belum pengalaman nanti kena tipu,44,48,sudah beberapa kali dapat panggilan kerja kali lebih tidak ada satupun yang asli isu bohong semua masa iya tes perseroan terbatas yang berbeda tapi tempat tes nya sama di ruko lagi tolong tingkatkan lagi biar loker penipu bisa di laporkan kasian yang baru lulus yang belum pengalaman nanti kena tipu,48,50,"['sudah', 'beberapa', 'kali', 'dapat', 'panggilan', 'kerja', 'kali', 'lebih', 'tidak', 'ada', 'satupun', 'yang', 'asli', 'isu', 'bohong', 'semua', 'masa', 'iya', 'tes', 'perseroan', 'terbatas', 'yang', 'berbeda', 'tapi', 'tempat', 'tes', 'nya', 'sama', 'di', 'ruko', 'lagi', 'tolong', 'tingkatkan', 'lagi', 'biar', 'loker', 'penipu', 'bisa', 'di', 'laporkan', 'kasian', 'yang', 'baru', 'lulus', 'yang', 'belum', 'pengalaman', 'nanti', 'kena', 'tipu']","['kali', 'panggilan', 'kerja', 'kali', 'tidak', 'satupun', 'asli', 'isu', 'bohong', 'iya', 'tes', 'perseroan', 'terbatas', 'berbeda', 'tes', 'nya', 'ruko', 'tolong', 'tingkatkan', 'biar', 'loker', 'penipu', 'laporkan', 'kasian', 'lulus', 'pengalaman', 'kena', 'tipu']",50,28,22,kali panggil kerja kali tidak satu asli isu bohong iya tes persero batas beda tes nya ruko tolong tingkat biar loker tipu lapor kasi lulus alam kena tipu,28,28
"Linkedin aplikasi yang sangat membantu dan memudahkan mencari pekerjaan, dan alhamdulilah sudah beberapa kali dapet pekerjaan , karna dari informasi di linkedin ini",positif,2022-08-28,2022,linkedin aplikasi yang sangat membantu dan memudahkan mencari pekerjaan dan alhamdulilah sudah beberapa kali dapet pekerjaan karna dari informasi di linkedin ini,23,22,linkedin aplikasi yang sangat membantu dan memudahkan mencari pekerjaan dan alhamdulillah sudah beberapa kali dapat pekerjaan karena dari informasi di linkedin ini,22,22,"['linkedin', 'aplikasi', 'yang', 'sangat', 'membantu', 'dan', 'memudahkan', 'mencari', 'pekerjaan', 'dan', 'alhamdulillah', 'sudah', 'beberapa', 'kali', 'dapat', 'pekerjaan', 'karena', 'dari', 'informasi', 'di', 'linkedin', 'ini']","['linkedin', 'aplikasi', 'membantu', 'memudahkan', 'mencari', 'pekerjaan', 'alhamdulillah', 'kali', 'pekerjaan', 'informasi', 'linkedin']",22,11,11,linkedin aplikasi bantu mudah cari kerja alhamdulillah kali kerja informasi linkedin,11,11
"Satu kata buat LinkedIn : TOLOL, sudah lapor ke LinkedIn help Twitter dan email karena akun saya dibajak, tapi sampai sebulan nggak direspon, layanan customer masih kalah dengan Glints, dan Jobstreet, mending tutup aja, nggak bisa kasih solusi baik. (Benerin dulu keamanan data pengguna baik di website dan aplikasi takutnya data akun lu dipake sama Teroris atau dijual ke human traficking, anak perusahaan Microsoft badut semua 🤡 kalau suruh maintenance aplikasi)",negatif,2023-12-16,2023,satu kata buat linkedin tolol sudah lapor ke linkedin help twitter dan email karena akun saya dibajak tapi sampai sebulan nggak direspon layanan customer masih kalah dengan glints dan jobstreet mending tutup aja nggak bisa kasih solusi baik benerin dulu keamanan data pengguna baik di website dan aplikasi takutnya data akun lu dipake sama teroris atau dijual ke human traficking anak perusahaan microsoft badut semua kalau suruh maintenance aplikasi,71,69,satu kata buat linkedin tolol sudah lapor ke linkedin help twitter dan email karena akun saya dibajak tapi sampai sebulan tidak direspons layanan pelanggan masih kalah dengan glints dan jobstreet mending tutup saja tidak bisa kasih solusi baik benerin dahulu keamanan data pengguna baik di website dan aplikasi takutnya data akun lu di pakai sama teroris atau dijual ke human traficking anak perusahaan microsoft badut semua kalau suruh maintenance aplikasi,69,70,"['satu', 'kata', 'buat', 'linkedin', 'tolol', 'sudah', 'lapor', 'ke', 'linkedin', 'help', 'twitter', 'dan', 'email', 'karena', 'akun', 'saya', 'dibajak', 'tapi', 'sampai', 'sebulan', 'tidak', 'direspons', 'layanan', 'pelanggan', 'masih', 'kalah', 'dengan', 'glints', 'dan', 'jobstreet', 'mending', 'tutup', 'saja', 'tidak', 'bisa', 'kasih', 'solusi', 'baik', 'benerin', 'dahulu', 'keamanan', 'data', 'pengguna', 'baik', 'di', 'website', 'dan', 'aplikasi', 'takutnya', 'data', 'akun', 'lu', 'di', 'pakai', 'sama', 'teroris', 'atau', 'dijual', 'ke', 'human', 'traficking', 'anak', 'perusahaan', 'microsoft', 'badut', 'semua', 'kalau', 'suruh', 'maintenance', 'aplikasi']","['linkedin', 'tolol', 'lapor', 'linkedin', 'help', 'twitter', 'email', 'akun', 'dibajak', 'sebulan', 'tidak', 'direspons', 'layanan', 'pelanggan', 'kalah', 'glints', 'jobstreet', 'mending', 'tutup', 'tidak', 'kasih', 'solusi', 'benerin', 'keamanan', 'data', 'pengguna', 'website', 'aplikasi', 'takutnya', 'data', 'akun', 'lu', 'pakai', 'teroris', 'dijual', 'human', 'traficking', 'anak', 'perusahaan', 'microsoft', 'badut', 'suruh', 'maintenance', 'aplikasi']",70,44,26,linkedin tolol lapor linkedin help twitter email akun bajak bulan tidak respons layan langgan kalah glints jobstreet mending tutup tidak kasih solusi benerin aman data guna website aplikasi takut data akun lu pakai teroris jual human traficking anak usaha microsoft badut suruh maintenance aplikasi,44,44
#help. Saya baru sadar dulu sempat membuat akun. Tapi saya lupa menggunakan email & kontak apa & password apa. Bagaimana cara menghapus nya karena saya sudah membuat akun yg baru. Terimakasih. Ditunggu responnya.,negatif,2023-03-09,2023,help saya baru sadar dulu sempat membuat akun tapi saya lupa menggunakan email kontak apa password apa bagaimana cara menghapus nya karena saya sudah membuat akun yg baru terimakasih ditunggu responnya,33,31,help saya baru sadar dahulu sempat membuat akun tapi saya lupa menggunakan email kontak apa password apa bagaimana cara menghapus nya karena saya sudah membuat akun yang baru terima kasih ditunggu responsnya,31,32,"['help', 'saya', 'baru', 'sadar', 'dahulu', 'sempat', 'membuat', 'akun', 'tapi', 'saya', 'lupa', 'menggunakan', 'email', 'kontak', 'apa', 'password', 'apa', 'bagaimana', 'cara', 'menghapus', 'nya', 'karena', 'saya', 'sudah', 'membuat', 'akun', 'yang', 'baru', 'terima', 'kasih', 'ditunggu', 'responsnya']","['help', 'sadar', 'akun', 'lupa', 'email', 'kontak', 'password', 'menghapus', 'nya', 'akun', 'terima', 'kasih', 'ditunggu', 'responsnya']",32,14,18,help sadar akun lupa email kontak password hapus nya akun terima kasih tunggu respons,14,14
"Minta verifikasi, di suruh jawab teka teki,sdh di jawab dengan benar, sdh terceklis, sedang memuat, harap tunggu. Eh yg keluar verifikasi lagi dan lagi. Terus aja sampe quota habis muter² di situ aja.",negatif,2024-03-05,2024,minta verifikasi di suruh jawab teka teki sdh di jawab dengan benar sdh terceklis sedang memuat harap tunggu eh yg keluar verifikasi lagi dan lagi terus aja sampe quota habis muter² di situ aja,33,34,minta verifikasi di suruh jawab teka teki sudah di jawab dengan benar sudah terceklis sedang memuat harap tunggu eh yang keluar verifikasi lagi dan lagi terus saja sampai quota habis muter² di situ saja,34,34,"['minta', 'verifikasi', 'di', 'suruh', 'jawab', 'teka', 'teki', 'sudah', 'di', 'jawab', 'dengan', 'benar', 'sudah', 'terceklis', 'sedang', 'memuat', 'harap', 'tunggu', 'eh', 'yang', 'keluar', 'verifikasi', 'lagi', 'dan', 'lagi', 'terus', 'saja', 'sampai', 'quota', 'habis', 'muter²', 'di', 'situ', 'saja']","['verifikasi', 'suruh', 'teka', 'teki', 'terceklis', 'memuat', 'harap', 'tunggu', 'eh', 'verifikasi', 'quota', 'habis', 'muter²', 'situ']",34,14,20,verifikasi suruh teka teki terceklis muat harap tunggu eh verifikasi quota habis muter situ,14,14
"Udah pernah bikin akun, tapi pas mau login ribet banget dan mau pake gmail yang lain malah sudah terpakai padahal belum, mana buat tugas praktek sekolah lagi,",negatif,2024-03-01,2024,udah pernah bikin akun tapi pas mau login ribet banget dan mau pake gmail yang lain malah sudah terpakai padahal belum mana buat tugas praktek sekolah lagi,27,27,sudah pernah bikin akun tapi pas mau login rumit banget dan mau pakai gmail yang lain bahkan sudah terpakai padahal belum mana buat tugas praktek sekolah lagi,27,27,"['sudah', 'pernah', 'bikin', 'akun', 'tapi', 'pas', 'mau', 'login', 'rumit', 'banget', 'dan', 'mau', 'pakai', 'gmail', 'yang', 'lain', 'bahkan', 'sudah', 'terpakai', 'padahal', 'belum', 'mana', 'buat', 'tugas', 'praktek', 'sekolah', 'lagi']","['bikin', 'akun', 'pas', 'login', 'rumit', 'banget', 'pakai', 'gmail', 'terpakai', 'tugas', 'praktek', 'sekolah']",27,12,15,bikin akun pas login rumit banget pakai gmail pakai tugas praktek sekolah,12,12
"Captcha paling aneh sedunia, udah jelas tulisannya ""anda telah membuktikan bahwa anda manusia"", tapi muncul peringatan no captcha anda tidak valid dan belum terisi. Ini gimana sihhh maunya? Apa perlu ke dokter bawa surat pernyataan kalau saya benar2 makhluk hidup kah? Tolong segera diperbaiki",negatif,2023-06-01,2023,captcha paling aneh sedunia udah jelas tulisannya anda telah membuktikan bahwa anda manusia tapi muncul peringatan no captcha anda tidak valid dan belum terisi ini gimana sihhh maunya apa perlu ke dokter bawa surat pernyataan kalau saya benar makhluk hidup kah tolong segera diperbaiki,44,44,captcha paling aneh sedunia sudah jelas tulisannya anda telah membuktikan bahwa anda manusia tapi muncul peringatan nomor captcha anda tidak valid dan belum terisi ini bagaimana sihhh maunya apa perlu ke dokter bawa surat pernyataan kalau saya benar makhluk hidup kah tolong segera di perbaiki,44,45,"['captcha', 'paling', 'aneh', 'sedunia', 'sudah', 'jelas', 'tulisannya', 'anda', 'telah', 'membuktikan', 'bahwa', 'anda', 'manusia', 'tapi', 'muncul', 'peringatan', 'nomor', 'captcha', 'anda', 'tidak', 'valid', 'dan', 'belum', 'terisi', 'ini', 'bagaimana', 'sihhh', 'maunya', 'apa', 'perlu', 'ke', 'dokter', 'bawa', 'surat', 'pernyataan', 'kalau', 'saya', 'benar', 'makhluk', 'hidup', 'kah', 'tolong', 'segera', 'di', 'perbaiki']","['captcha', 'aneh', 'sedunia', 'tulisannya', 'membuktikan', 'manusia', 'muncul', 'peringatan', 'nomor', 'captcha', 'tidak', 'valid', 'terisi', 'sihhh', 'maunya', 'dokter', 'bawa', 'surat', 'pernyataan', 'makhluk', 'hidup', 'kah', 'tolong', 'perbaiki']",45,24,21,captcha aneh dunia tulis bukti manusia muncul ingat nomor captcha tidak valid isi sihhh mau dokter bawa surat nyata makhluk hidup kah tolong baik,24,24
"mau login aja ribet banget, udh dpt kode verifikasi tp malah minta ulang trus verifikasi terus, udh gitu akun google saya sendiri dibilang dipakai orng lain, jdnya saya gak bisa pake akun emai saya",negatif,2023-08-14,2023,mau login aja ribet banget udh dpt kode verifikasi tp malah minta ulang trus verifikasi terus udh gitu akun google saya sendiri dibilang dipakai orng lain jdnya saya gak bisa pake akun emai saya,34,34,mau login saja rumit banget sudah dapat kode verifikasi tapi bahkan minta ulang terus verifikasi terus sudah begitu akun google saya sendiri dibilang dipakai orang lain jdnya saya tidak bisa pakai akun emai saya,34,34,"['mau', 'login', 'saja', 'rumit', 'banget', 'sudah', 'dapat', 'kode', 'verifikasi', 'tapi', 'bahkan', 'minta', 'ulang', 'terus', 'verifikasi', 'terus', 'sudah', 'begitu', 'akun', 'google', 'saya', 'sendiri', 'dibilang', 'dipakai', 'orang', 'lain', 'jdnya', 'saya', 'tidak', 'bisa', 'pakai', 'akun', 'emai', 'saya']","['login', 'rumit', 'banget', 'kode', 'verifikasi', 'ulang', 'verifikasi', 'akun', 'google', 'dibilang', 'dipakai', 'orang', 'jdnya', 'tidak', 'pakai', 'akun', 'emai']",34,17,17,login rumit banget kode verifikasi ulang verifikasi akun google bilang pakai orang jdnya tidak pakai akun emai,17,17
"Paling buruk!!!!! segala harus teka teki udah sejeman tapi masih sama sampe harus reset password aja harus teka teki juga, kalo mau nyusahin bilang aja",negatif,2022-05-31,2022,paling buruk segala harus teka teki udah sejeman tapi masih sama sampe harus reset password aja harus teka teki juga kalo mau nyusahin bilang aja,25,25,paling buruk segala harus teka teki sudah sejeman tapi masih sama sampai harus reset password saja harus teka teki juga kalau mau nyusahin bilang saja,25,25,"['paling', 'buruk', 'segala', 'harus', 'teka', 'teki', 'sudah', 'sejeman', 'tapi', 'masih', 'sama', 'sampai', 'harus', 'reset', 'password', 'saja', 'harus', 'teka', 'teki', 'juga', 'kalau', 'mau', 'nyusahin', 'bilang', 'saja']","['buruk', 'teka', 'teki', 'sejeman', 'reset', 'password', 'teka', 'teki', 'nyusahin', 'bilang']",25,10,15,buruk teka teki jem reset password teka teki nyusahin bilang,10,10
"Tlong perbaiki lg min knp si stiap sya login sllu g bsa alesan email sya d pkai seorang mlu pdhl udh brkali"" verifikasi gmbr",negatif,2023-07-05,2023,tlong perbaiki lg min knp si stiap sya login sllu g bsa alesan email sya d pkai seorang mlu pdhl udh brkali verifikasi gmbr,24,24,tlong perbaikan lagi minimal kenapa sih setiap saya login selalu tidak bisa alesan email saya di pkai seorang mlu padahal sudah brkali verifikasi gambar,24,24,"['tlong', 'perbaikan', 'lagi', 'minimal', 'kenapa', 'sih', 'setiap', 'saya', 'login', 'selalu', 'tidak', 'bisa', 'alesan', 'email', 'saya', 'di', 'pkai', 'seorang', 'mlu', 'padahal', 'sudah', 'brkali', 'verifikasi', 'gambar']","['tlong', 'perbaikan', 'minimal', 'sih', 'login', 'tidak', 'alesan', 'email', 'pkai', 'mlu', 'brkali', 'verifikasi', 'gambar']",24,13,11,tlong baik minimal sih login tidak alesan email pkai mlu brkali verifikasi gambar,13,13
"Fiture membatalkan premium gak berfungsi, sama aja jadi menjenjebak konsumen harus membayar tagihan. Gimana sih LinkedIn parah.",negatif,2022-09-18,2022,fiture membatalkan premium gak berfungsi sama aja jadi menjenjebak konsumen harus membayar tagihan gimana sih linkedin parah,17,17,fiture membatalkan premium tidak berfungsi sama saja jadi menjenjebak konsumen harus membayar tagihan bagaimana sih linkedin parah,17,17,"['fiture', 'membatalkan', 'premium', 'tidak', 'berfungsi', 'sama', 'saja', 'jadi', 'menjenjebak', 'konsumen', 'harus', 'membayar', 'tagihan', 'bagaimana', 'sih', 'linkedin', 'parah']","['fiture', 'membatalkan', 'premium', 'tidak', 'berfungsi', 'menjenjebak', 'konsumen', 'membayar', 'tagihan', 'sih', 'linkedin', 'parah']",17,12,5,fiture batal premium tidak fungsi menjenjebak konsumen bayar tagih sih linkedin parah,12,12
Apk nya ga jelas udh login pke email trs udh verifikasi pke captcha minta verifikasi pke ktp juga udh msih ga bisa masuk bikin emosi aja respon dong,negatif,2023-04-16,2023,apk nya ga jelas udh login pke email trs udh verifikasi pke captcha minta verifikasi pke ktp juga udh msih ga bisa masuk bikin emosi aja respon dong,28,28,aplikasi nya tidak jelas sudah login pakai email terus sudah verifikasi pakai captcha minta verifikasi pakai ktp juga sudah masih tidak bisa masuk bikin emosi saja respons dong,28,28,"['aplikasi', 'nya', 'tidak', 'jelas', 'sudah', 'login', 'pakai', 'email', 'terus', 'sudah', 'verifikasi', 'pakai', 'captcha', 'minta', 'verifikasi', 'pakai', 'ktp', 'juga', 'sudah', 'masih', 'tidak', 'bisa', 'masuk', 'bikin', 'emosi', 'saja', 'respons', 'dong']","['aplikasi', 'nya', 'tidak', 'login', 'pakai', 'email', 'verifikasi', 'pakai', 'captcha', 'verifikasi', 'pakai', 'ktp', 'tidak', 'masuk', 'bikin', 'emosi', 'respons']",28,17,11,aplikasi nya tidak login pakai email verifikasi pakai captcha verifikasi pakai ktp tidak masuk bikin emosi respons,17,17
"Sudah instal, disuruh cari binantang yg mengarah ke atas... semua benar, tapi robotnya bilang salah... mending hapus...",negatif,2021-04-16,2021,sudah instal disuruh cari binantang yg mengarah ke atas semua benar tapi robotnya bilang salah mending hapus,17,17,sudah memasang disuruh cari binantang yang mengarah ke atas semua benar tapi robotnya bilang salah mending hapus,17,17,"['sudah', 'memasang', 'disuruh', 'cari', 'binantang', 'yang', 'mengarah', 'ke', 'atas', 'semua', 'benar', 'tapi', 'robotnya', 'bilang', 'salah', 'mending', 'hapus']","['memasang', 'disuruh', 'cari', 'binantang', 'mengarah', 'robotnya', 'bilang', 'salah', 'mending', 'hapus']",17,10,7,pasang suruh cari binantang arah robot bilang salah mending hapus,10,10
Tadi coba masuk akun lagi tapi diminta verifikasi terus captchanya nggak muncul kan ngeselin. BYE LINKEDIN!!,negatif,2023-04-15,2023,tadi coba masuk akun lagi tapi diminta verifikasi terus captchanya nggak muncul kan ngeselin bye linkedin,16,16,tadi coba masuk akun lagi tapi diminta verifikasi terus captchanya tidak muncul akan ngeselin bye linkedin,16,16,"['tadi', 'coba', 'masuk', 'akun', 'lagi', 'tapi', 'diminta', 'verifikasi', 'terus', 'captchanya', 'tidak', 'muncul', 'akan', 'ngeselin', 'bye', 'linkedin']","['coba', 'masuk', 'akun', 'verifikasi', 'captchanya', 'tidak', 'muncul', 'ngeselin', 'bye', 'linkedin']",16,10,6,coba masuk akun verifikasi captchanya tidak muncul ngeselin bye linkedin,10,10
"Sangat tepat utk bisnis walau keaslian akun sangat meragukan, karena msh byk scammer berkeliaran di LinkedIn. Kedepan harus di tingkatkan deteksi keaslian profil dan akun di LinkedIn. Krn msh sangat byk fake akun.",positif,2023-08-26,2023,sangat tepat utk bisnis walau keaslian akun sangat meragukan karena msh byk scammer berkeliaran di linkedin kedepan harus di tingkatkan deteksi keaslian profil dan akun di linkedin krn msh sangat byk fake akun,33,33,sangat tepat untuk bisnis walau keaslian akun sangat meragukan karena masih banyak scammer berkeliaran di linkedin kedepan harus di tingkatkan deteksi keaslian profil dan akun di linkedin karena masih sangat banyak fake akun,33,33,"['sangat', 'tepat', 'untuk', 'bisnis', 'walau', 'keaslian', 'akun', 'sangat', 'meragukan', 'karena', 'masih', 'banyak', 'scammer', 'berkeliaran', 'di', 'linkedin', 'kedepan', 'harus', 'di', 'tingkatkan', 'deteksi', 'keaslian', 'profil', 'dan', 'akun', 'di', 'linkedin', 'karena', 'masih', 'sangat', 'banyak', 'fake', 'akun']","['bisnis', 'keaslian', 'akun', 'meragukan', 'scammer', 'berkeliaran', 'linkedin', 'kedepan', 'tingkatkan', 'deteksi', 'keaslian', 'profil', 'akun', 'linkedin', 'fake', 'akun']",33,16,17,bisnis asli akun ragu scammer liar linkedin depan tingkat deteksi asli profil akun linkedin fake akun,16,16
"Tolong kepada pihak aplikasi ini berikan informasi lowongan kerja yang akurat, kebanyak orang yang mengatas namakan perusahan adalah penipuan, 6 kali saya melamar semua penipuan, kepada yang telah mendowload aplikasi ini harap di perhatikan kebenarannya, telah banyak yang dirugikan atas masyarakat dalam mencari pekerjaan. Masyarakat mancarin kerja buat masa depan, jangaj di permainkan",negatif,2020-09-01,2020,tolong kepada pihak aplikasi ini berikan informasi lowongan kerja yang akurat kebanyak orang yang mengatas namakan perusahan adalah penipuan kali saya melamar semua penipuan kepada yang telah mendowload aplikasi ini harap di perhatikan kebenarannya telah banyak yang dirugikan atas masyarakat dalam mencari pekerjaan masyarakat mancarin kerja buat masa depan jangaj di permainkan,53,52,tolong kepada pihak aplikasi ini berikan informasi lowongan kerja yang akurat kebanyak orang yang mengatas namakan perusahan adalah penipuan kali saya melamar semua penipuan kepada yang telah mendowload aplikasi ini harap di perhatikan kebenarannya telah banyak yang dirugikan atas masyarakat dalam mencari pekerjaan masyarakat mancarin kerja buat masa depan jangaj di permainkan,52,52,"['tolong', 'kepada', 'pihak', 'aplikasi', 'ini', 'berikan', 'informasi', 'lowongan', 'kerja', 'yang', 'akurat', 'kebanyak', 'orang', 'yang', 'mengatas', 'namakan', 'perusahan', 'adalah', 'penipuan', 'kali', 'saya', 'melamar', 'semua', 'penipuan', 'kepada', 'yang', 'telah', 'mendowload', 'aplikasi', 'ini', 'harap', 'di', 'perhatikan', 'kebenarannya', 'telah', 'banyak', 'yang', 'dirugikan', 'atas', 'masyarakat', 'dalam', 'mencari', 'pekerjaan', 'masyarakat', 'mancarin', 'kerja', 'buat', 'masa', 'depan', 'jangaj', 'di', 'permainkan']","['tolong', 'aplikasi', 'informasi', 'lowongan', 'kerja', 'akurat', 'kebanyak', 'orang', 'mengatas', 'namakan', 'perusahan', 'penipuan', 'kali', 'melamar', 'penipuan', 'mendowload', 'aplikasi', 'harap', 'perhatikan', 'kebenarannya', 'dirugikan', 'masyarakat', 'mencari', 'pekerjaan', 'masyarakat', 'mancarin', 'kerja', 'jangaj', 'permainkan']",52,29,23,tolong aplikasi informasi lowong kerja akurat banyak orang atas nama usah tipu kali lamar tipu mendowload aplikasi harap perhati benar rugi masyarakat cari kerja masyarakat mancarin kerja jangaj main,29,29
"Busuk kaga bisa log in terus, malah diminta verifikasi make kodok ama keledai mulu, udah ngisi yg bener tapi malah verifikasi berulang terus, yang bener ajalah developernya",negatif,2023-08-18,2023,busuk kaga bisa log in terus malah diminta verifikasi make kodok ama keledai mulu udah ngisi yg bener tapi malah verifikasi berulang terus yang bener ajalah developernya,27,27,busuk tidak bisa log in terus bahkan diminta verifikasi make kodok sama keledai mulu sudah mengisi yang benar tapi bahkan verifikasi berulang terus yang benar ajalah developernya,27,27,"['busuk', 'tidak', 'bisa', 'log', 'in', 'terus', 'bahkan', 'diminta', 'verifikasi', 'make', 'kodok', 'sama', 'keledai', 'mulu', 'sudah', 'mengisi', 'yang', 'benar', 'tapi', 'bahkan', 'verifikasi', 'berulang', 'terus', 'yang', 'benar', 'ajalah', 'developernya']","['busuk', 'tidak', 'log', 'in', 'verifikasi', 'make', 'kodok', 'keledai', 'mulu', 'mengisi', 'verifikasi', 'berulang', 'ajalah', 'developernya']",27,14,13,busuk tidak log in verifikasi make kodok keledai mulu isi verifikasi ulang aja developer,14,14
Kenapa klw pas buat email pake verifikasi segala udah paspun dijawap masih ngk bisa login Buat emosi aja,negatif,2020-09-25,2020,kenapa klw pas buat email pake verifikasi segala udah paspun dijawap masih ngk bisa login buat emosi aja,18,18,kenapa kalau pas buat email pakai verifikasi segala sudah paspun dijawap masih tidak bisa login buat emosi saja,18,18,"['kenapa', 'kalau', 'pas', 'buat', 'email', 'pakai', 'verifikasi', 'segala', 'sudah', 'paspun', 'dijawap', 'masih', 'tidak', 'bisa', 'login', 'buat', 'emosi', 'saja']","['pas', 'email', 'pakai', 'verifikasi', 'paspun', 'dijawap', 'tidak', 'login', 'emosi']",18,9,9,pas email pakai verifikasi pas dijawap tidak login emosi,9,9
"BUKAN MEMBANTU TAPI MENYUSAHKAN. TEBAK GAMBAR, CARA LOG IN TERLALU BERTELE TELE.. APLIKASI YANG SAYA HARAP CEPAT DI HAPUSKAN. PEMBODOHAN PUBLIC.. TEMAN DAN SEMUA KELUARGA SAYA. SAYA TIDAK ANJURKAN MEMILIH APLIKASI INI..",negatif,2022-06-04,2022,bukan membantu tapi menyusahkan tebak gambar cara log in terlalu bertele tele aplikasi yang saya harap cepat di hapuskan pembodohan public teman dan semua keluarga saya saya tidak anjurkan memilih aplikasi ini,32,32,bukan membantu tapi menyusahkan tebak gambar cara log in terlalu bertele tele aplikasi yang saya harap cepat di hapuskan pembodohan public teman dan semua keluarga saya saya tidak anjurkan memilih aplikasi ini,32,32,"['bukan', 'membantu', 'tapi', 'menyusahkan', 'tebak', 'gambar', 'cara', 'log', 'in', 'terlalu', 'bertele', 'tele', 'aplikasi', 'yang', 'saya', 'harap', 'cepat', 'di', 'hapuskan', 'pembodohan', 'public', 'teman', 'dan', 'semua', 'keluarga', 'saya', 'saya', 'tidak', 'anjurkan', 'memilih', 'aplikasi', 'ini']","['membantu', 'menyusahkan', 'tebak', 'gambar', 'log', 'in', 'bertele', 'tele', 'aplikasi', 'harap', 'cepat', 'hapuskan', 'pembodohan', 'public', 'teman', 'keluarga', 'tidak', 'anjurkan', 'memilih', 'aplikasi']",32,20,12,bantu susah tebak gambar log in tele tele aplikasi harap cepat hapus bodoh public teman keluarga tidak anjur pilih aplikasi,20,20
Sorry to say bukannya membantu memudahkan malah meribetkan diri dengan verifikasi itu Lupa password juga ga seribet ini kalik harusnya Ga user friendly,negatif,2023-06-13,2023,sorry to say bukannya membantu memudahkan malah meribetkan diri dengan verifikasi itu lupa password juga ga seribet ini kalik harusnya ga user friendly,23,23,sorry to say bukannya membantu memudahkan bahkan meribetkan diri dengan verifikasi itu lupa password juga tidak seribet ini kalik harusnya tidak user friendly,23,23,"['sorry', 'to', 'say', 'bukannya', 'membantu', 'memudahkan', 'bahkan', 'meribetkan', 'diri', 'dengan', 'verifikasi', 'itu', 'lupa', 'password', 'juga', 'tidak', 'seribet', 'ini', 'kalik', 'harusnya', 'tidak', 'user', 'friendly']","['sorry', 'to', 'say', 'membantu', 'memudahkan', 'meribetkan', 'verifikasi', 'lupa', 'password', 'tidak', 'seribet', 'kalik', 'tidak', 'user', 'friendly']",23,15,8,sorry to say bantu mudah meribetkan verifikasi lupa password tidak seribet kalik tidak user friendly,15,15
Sejauh ini sangat luar biasa akan tetapi mohon untuk developer/admin Linkedin untuk lowongan kerja berkedok hoax atau via adm mohon di klarifikasi kembali agar Jobskeer dapat melamar dengan perusahaan yang mereka inginkan..terima kasih,positif,2022-02-19,2022,sejauh ini sangat luar biasa akan tetapi mohon untuk developer admin linkedin untuk lowongan kerja berkedok hoax atau via adm mohon di klarifikasi kembali agar jobskeer dapat melamar dengan perusahaan yang mereka inginkan terima kasih,33,35,sejauh ini sangat luar biasa akan tetapi mohon untuk developer admin linkedin untuk lowongan kerja berkedok isu bohong atau melalui adm mohon di klarifikasi kembali agar jobskeer dapat melamar dengan perusahaan yang mereka inginkan terima kasih,35,36,"['sejauh', 'ini', 'sangat', 'luar', 'biasa', 'akan', 'tetapi', 'mohon', 'untuk', 'developer', 'admin', 'linkedin', 'untuk', 'lowongan', 'kerja', 'berkedok', 'isu', 'bohong', 'atau', 'melalui', 'adm', 'mohon', 'di', 'klarifikasi', 'kembali', 'agar', 'jobskeer', 'dapat', 'melamar', 'dengan', 'perusahaan', 'yang', 'mereka', 'inginkan', 'terima', 'kasih']","['mohon', 'developer', 'admin', 'linkedin', 'lowongan', 'kerja', 'berkedok', 'isu', 'bohong', 'adm', 'mohon', 'klarifikasi', 'jobskeer', 'melamar', 'perusahaan', 'terima', 'kasih']",36,17,19,mohon developer admin linkedin lowong kerja kedok isu bohong adm mohon klarifikasi jobskeer lamar usaha terima kasih,17,17
Sangat sangat baik pertemanan makin luas dan banyak mendapatkan informasi dari bermacam macam pekerjaan thanks LINKED,positif,2021-11-24,2021,sangat sangat baik pertemanan makin luas dan banyak mendapatkan informasi dari bermacam macam pekerjaan thanks linked,16,16,sangat sangat baik pertemanan makin luas dan banyak mendapatkan informasi dari bermacam macam pekerjaan terima kasih linked,16,17,"['sangat', 'sangat', 'baik', 'pertemanan', 'makin', 'luas', 'dan', 'banyak', 'mendapatkan', 'informasi', 'dari', 'bermacam', 'macam', 'pekerjaan', 'terima', 'kasih', 'linked']","['pertemanan', 'luas', 'informasi', 'pekerjaan', 'terima', 'kasih', 'linked']",17,7,10,teman luas informasi kerja terima kasih linked,7,7
"Aplikasi LinkedIn memudahkan untuk terhubung dengan orang-orang dan hal-hal yang penting untuk kehidupan profesional Anda. Bangun dan kembangkan jaringan profesional Anda, baca berita bisnis dan industri terbaru, dan temukan pekerjaan impian Anda. Semuanya dimulai dengan profil LinkedIn Anda. Di sini tidak hanya sekadar resume profesional Anda — tapi juga menunjukkan siapa diri Anda dan apa yang telah Anda capai dalam karier Anda.",positif,2021-02-15,2021,aplikasi linkedin memudahkan untuk terhubung dengan orang orang dan hal hal yang penting untuk kehidupan profesional anda bangun dan kembangkan jaringan profesional anda baca berita bisnis dan industri terbaru dan temukan pekerjaan impian anda semuanya dimulai dengan profil linkedin anda di sini tidak hanya sekadar resume profesional anda — tapi juga menunjukkan siapa diri anda dan apa yang telah anda capai dalam karier anda,62,64,aplikasi linkedin memudahkan untuk terhubung dengan orang orang dan hal hal yang penting untuk kehidupan profesional anda bangun dan kembangkan jaringan profesional anda baca berita bisnis dan industri terbaru dan temukan pekerjaan impian anda semuanya dimulai dengan profil linkedin anda di sini tidak hanya sekadar resume profesional anda — tapi juga menunjukkan siapa diri anda dan apa yang telah anda capai dalam karier anda,64,64,"['aplikasi', 'linkedin', 'memudahkan', 'untuk', 'terhubung', 'dengan', 'orang', 'orang', 'dan', 'hal', 'hal', 'yang', 'penting', 'untuk', 'kehidupan', 'profesional', 'anda', 'bangun', 'dan', 'kembangkan', 'jaringan', 'profesional', 'anda', 'baca', 'berita', 'bisnis', 'dan', 'industri', 'terbaru', 'dan', 'temukan', 'pekerjaan', 'impian', 'anda', 'semuanya', 'dimulai', 'dengan', 'profil', 'linkedin', 'anda', 'di', 'sini', 'tidak', 'hanya', 'sekadar', 'resume', 'profesional', 'anda', '—', 'tapi', 'juga', 'menunjukkan', 'siapa', 'diri', 'anda', 'dan', 'apa', 'yang', 'telah', 'anda', 'capai', 'dalam', 'karier', 'anda']","['aplikasi', 'linkedin', 'memudahkan', 'terhubung', 'orang', 'orang', 'kehidupan', 'profesional', 'bangun', 'kembangkan', 'jaringan', 'profesional', 'baca', 'berita', 'bisnis', 'industri', 'terbaru', 'temukan', 'pekerjaan', 'impian', 'profil', 'linkedin', 'tidak', 'resume', 'profesional', '—', 'capai', 'karier']",64,28,36,aplikasi linkedin mudah hubung orang orang hidup profesional bangun kembang jaring profesional baca berita bisnis industri baru temu kerja impi profil linkedin tidak resume profesional capai karier,28,27
"Aplikasi konyol ga ngapain² akun saya malah ditangguhkan, perlu verifikasi identitas, waktu yang diperlukan juga lama",negatif,2023-11-07,2023,aplikasi konyol ga ngapain² akun saya malah ditangguhkan perlu verifikasi identitas waktu yang diperlukan juga lama,16,16,aplikasi konyol tidak ngapain² akun saya bahkan ditangguhkan perlu verifikasi identitas waktu yang diperlukan juga lama,16,16,"['aplikasi', 'konyol', 'tidak', 'ngapain²', 'akun', 'saya', 'bahkan', 'ditangguhkan', 'perlu', 'verifikasi', 'identitas', 'waktu', 'yang', 'diperlukan', 'juga', 'lama']","['aplikasi', 'konyol', 'tidak', 'ngapain²', 'akun', 'ditangguhkan', 'verifikasi', 'identitas']",16,8,8,aplikasi konyol tidak ngapain akun tangguh verifikasi identitas,8,8
"Broken, verifikasi udh benar trus disuruh verifikasi berkali kali, aplikasi broken",negatif,2021-09-17,2021,broken verifikasi udh benar trus disuruh verifikasi berkali kali aplikasi broken,11,11,broken verifikasi sudah benar terus disuruh verifikasi berkali kali aplikasi broken,11,11,"['broken', 'verifikasi', 'sudah', 'benar', 'terus', 'disuruh', 'verifikasi', 'berkali', 'kali', 'aplikasi', 'broken']","['broken', 'verifikasi', 'disuruh', 'verifikasi', 'berkali', 'kali', 'aplikasi', 'broken']",11,8,3,broken verifikasi suruh verifikasi kali kali aplikasi broken,8,8
Log in nya sulit dan tidak pernah berhasil. Meminta foto id sudah diikuti dan ketika log in tidak bisa.,negatif,2024-02-25,2024,log in nya sulit dan tidak pernah berhasil meminta foto id sudah diikuti dan ketika log in tidak bisa,19,19,log in nya sulit dan tidak pernah berhasil meminta foto id sudah diikuti dan ketika log in tidak bisa,19,19,"['log', 'in', 'nya', 'sulit', 'dan', 'tidak', 'pernah', 'berhasil', 'meminta', 'foto', 'id', 'sudah', 'diikuti', 'dan', 'ketika', 'log', 'in', 'tidak', 'bisa']","['log', 'in', 'nya', 'sulit', 'tidak', 'berhasil', 'foto', 'id', 'diikuti', 'log', 'in', 'tidak']",19,12,7,log in nya sulit tidak hasil foto id ikut log in tidak,12,12
Terlalu bwt masalah👎 dan juga tidak ada buktinya karena format nya juga tidak jls karena saya sebagai pengguna sdh mrskan klw pemformatnya tidak membuahkn hasil.,negatif,2022-05-09,2022,terlalu bwt masalah dan juga tidak ada buktinya karena format nya juga tidak jls karena saya sebagai pengguna sdh mrskan klw pemformatnya tidak membuahkn hasil,25,25,terlalu buat masalah dan juga tidak ada buktinya karena format nya juga tidak jls karena saya sebagai pengguna sudah mrskan kalau pemformatnya tidak membuahkn hasil,25,25,"['terlalu', 'buat', 'masalah', 'dan', 'juga', 'tidak', 'ada', 'buktinya', 'karena', 'format', 'nya', 'juga', 'tidak', 'jls', 'karena', 'saya', 'sebagai', 'pengguna', 'sudah', 'mrskan', 'kalau', 'pemformatnya', 'tidak', 'membuahkn', 'hasil']","['tidak', 'buktinya', 'format', 'nya', 'tidak', 'jls', 'pengguna', 'mrskan', 'pemformatnya', 'tidak', 'membuahkn', 'hasil']",25,12,13,tidak bukti format nya tidak jls guna mrskan format tidak membuahkn hasil,12,12
"Selalu minta up date seperti buat baru harus mengosongkankan download yg lain , down load ,setiap beberapa bulan",negatif,2022-06-27,2022,selalu minta up date seperti buat baru harus mengosongkankan download yg lain down load setiap beberapa bulan,18,17,selalu minta up date seperti buat baru harus mengosongkankan unduh yang lain down load setiap beberapa bulan,17,17,"['selalu', 'minta', 'up', 'date', 'seperti', 'buat', 'baru', 'harus', 'mengosongkankan', 'unduh', 'yang', 'lain', 'down', 'load', 'setiap', 'beberapa', 'bulan']","['up', 'date', 'mengosongkankan', 'unduh', 'down', 'load']",17,6,11,up date mengosongkankan unduh down load,6,6
"Aplikasi gak jelas dulu enak sekarang gak jelas verifikasi pakai gambar tapi gak jelas memgarah yang atas ,sudah jagan di instal maaf 🙏",negatif,2021-10-06,2021,aplikasi gak jelas dulu enak sekarang gak jelas verifikasi pakai gambar tapi gak jelas memgarah yang atas sudah jagan di instal maaf,23,22,aplikasi tidak jelas dahulu enak sekarang tidak jelas verifikasi pakai gambar tapi tidak jelas memgarah yang atas sudah jagan di memasang maaf,22,22,"['aplikasi', 'tidak', 'jelas', 'dahulu', 'enak', 'sekarang', 'tidak', 'jelas', 'verifikasi', 'pakai', 'gambar', 'tapi', 'tidak', 'jelas', 'memgarah', 'yang', 'atas', 'sudah', 'jagan', 'di', 'memasang', 'maaf']","['aplikasi', 'tidak', 'enak', 'tidak', 'verifikasi', 'pakai', 'gambar', 'tidak', 'memgarah', 'jagan', 'memasang', 'maaf']",22,12,10,aplikasi tidak enak tidak verifikasi pakai gambar tidak memgarah jagan pasang maaf,12,12
"Aplikasi nya jelek, fungsinya sama kayak medsos, mending ganti aja namanya",negatif,2021-02-10,2021,aplikasi nya jelek fungsinya sama kayak medsos mending ganti aja namanya,11,11,aplikasi nya jelek fungsinya sama kayak media sosial mending ganti saja namanya,11,12,"['aplikasi', 'nya', 'jelek', 'fungsinya', 'sama', 'kayak', 'media', 'sosial', 'mending', 'ganti', 'saja', 'namanya']","['aplikasi', 'nya', 'jelek', 'fungsinya', 'kayak', 'media', 'sosial', 'mending', 'ganti', 'namanya']",12,10,2,aplikasi nya jelek fungsi kayak media sosial mending ganti nama,10,10
Apknya ribet. Ga jelas. Enakan pakai jobstreet mudah di pahami dan simpel,negatif,2022-02-20,2022,apknya ribet ga jelas enakan pakai jobstreet mudah di pahami dan simpel,12,12,aplikasinya rumit tidak jelas enakan pakai jobstreet mudah di pahami dan simpel,12,12,"['aplikasinya', 'rumit', 'tidak', 'jelas', 'enakan', 'pakai', 'jobstreet', 'mudah', 'di', 'pahami', 'dan', 'simpel']","['aplikasinya', 'rumit', 'tidak', 'enakan', 'pakai', 'jobstreet', 'mudah', 'pahami', 'simpel']",12,9,3,aplikasi rumit tidak enak pakai jobstreet mudah paham simpel,9,9
"Gk bisa verifikasi, padalan udah bner...udh behari2 masih gak bisa login",negatif,2023-11-24,2023,gk bisa verifikasi padalan udah bner udh behari masih gak bisa login,11,12,tidak bisa verifikasi padalan sudah bner sudah behari masih tidak bisa login,12,12,"['tidak', 'bisa', 'verifikasi', 'padalan', 'sudah', 'bner', 'sudah', 'behari', 'masih', 'tidak', 'bisa', 'login']","['tidak', 'verifikasi', 'padalan', 'bner', 'behari', 'tidak', 'login']",12,7,5,tidak verifikasi padalan bner behari tidak login,7,7
"Apa apaan ini,ga ada pernah install apk nya tapi diminta bayar langganan? Maksud nya gimana ini? Ini mau meras apa gimana? tolong lah",negatif,2024-05-31,2024,apa apaan ini ga ada pernah install apk nya tapi diminta bayar langganan maksud nya gimana ini ini mau meras apa gimana tolong lah,23,24,apa apa ini tidak ada pernah install aplikasi nya tapi diminta bayar langganan maksud nya bagaimana ini ini mau meras apa bagaimana tolong lah,24,24,"['apa', 'apa', 'ini', 'tidak', 'ada', 'pernah', 'install', 'aplikasi', 'nya', 'tapi', 'diminta', 'bayar', 'langganan', 'maksud', 'nya', 'bagaimana', 'ini', 'ini', 'mau', 'meras', 'apa', 'bagaimana', 'tolong', 'lah']","['tidak', 'install', 'aplikasi', 'nya', 'bayar', 'langganan', 'maksud', 'nya', 'meras', 'tolong']",24,10,14,tidak install aplikasi nya bayar langgan maksud nya ras tolong,10,10
Apaan sih akun gw kenapa hilang pas buka kok connect nya kaga ada perasaan udah nyampe 1000 kenapa sekarang jadi 0 aplikasi kaga guna cihhhh,negatif,2023-01-06,2023,apaan sih akun gw kenapa hilang pas buka kok connect nya kaga ada perasaan udah nyampe kenapa sekarang jadi aplikasi kaga guna cihhhh,25,23,apa sih akun saya kenapa hilang pas buka kok connect nya tidak ada perasaan sudah sampai kenapa sekarang jadi aplikasi tidak guna cihhhh,23,23,"['apa', 'sih', 'akun', 'saya', 'kenapa', 'hilang', 'pas', 'buka', 'kok', 'connect', 'nya', 'tidak', 'ada', 'perasaan', 'sudah', 'sampai', 'kenapa', 'sekarang', 'jadi', 'aplikasi', 'tidak', 'guna', 'cihhhh']","['sih', 'akun', 'hilang', 'pas', 'buka', 'connect', 'nya', 'tidak', 'perasaan', 'aplikasi', 'tidak', 'cihhhh']",23,12,11,sih akun hilang pas buka connect nya tidak asa aplikasi tidak cihhhh,12,12
"Mengapa iklan terus bermuculan bos, saya tidak suka, jadi mengganggu aktivitas saya",negatif,2024-06-16,2024,mengapa iklan terus bermuculan bos saya tidak suka jadi mengganggu aktivitas saya,12,12,mengapa iklan terus bermuculan box saya tidak suka jadi mengganggu aktivitas saya,12,12,"['mengapa', 'iklan', 'terus', 'bermuculan', 'box', 'saya', 'tidak', 'suka', 'jadi', 'mengganggu', 'aktivitas', 'saya']","['iklan', 'bermuculan', 'box', 'tidak', 'suka', 'mengganggu', 'aktivitas']",12,7,5,iklan bermuculan box tidak suka ganggu aktivitas,7,7
Saya punya saran untuk aplikasi LinkedIn dari pihak pemilik Amerika Serikat 🇺🇲 kebetulan saya indonesia jadi maaf saya kurang mendukung penggunaan media ini dikarenakan saya kurang cocok terima kasih 🤣🙏🥴🔥,negatif,2022-10-30,2022,saya punya saran untuk aplikasi linkedin dari pihak pemilik amerika serikat kebetulan saya indonesia jadi maaf saya kurang mendukung penggunaan media ini dikarenakan saya kurang cocok terima kasih,30,28,saya punya saran untuk aplikasi linkedin dari pihak pemilik amerika serikat kebetulan saya indonesia jadi maaf saya kurang mendukung penggunaan media ini dikarenakan saya kurang cocok terima kasih,28,28,"['saya', 'punya', 'saran', 'untuk', 'aplikasi', 'linkedin', 'dari', 'pihak', 'pemilik', 'amerika', 'serikat', 'kebetulan', 'saya', 'indonesia', 'jadi', 'maaf', 'saya', 'kurang', 'mendukung', 'penggunaan', 'media', 'ini', 'dikarenakan', 'saya', 'kurang', 'cocok', 'terima', 'kasih']","['saran', 'aplikasi', 'linkedin', 'pemilik', 'amerika', 'serikat', 'indonesia', 'maaf', 'mendukung', 'penggunaan', 'media', 'cocok', 'terima', 'kasih']",28,14,14,saran aplikasi linkedin milik amerika serikat indonesia maaf dukung guna media cocok terima kasih,14,14
Sangat mudah digunakan sebagai upaya untuk kerja penuh waktu ataupun kerja paruh waktu,positif,2020-07-11,2020,sangat mudah digunakan sebagai upaya untuk kerja penuh waktu ataupun kerja paruh waktu,13,13,sangat mudah digunakan sebagai upaya untuk kerja penuh waktu ataupun kerja paruh waktu,13,13,"['sangat', 'mudah', 'digunakan', 'sebagai', 'upaya', 'untuk', 'kerja', 'penuh', 'waktu', 'ataupun', 'kerja', 'paruh', 'waktu']","['mudah', 'upaya', 'kerja', 'penuh', 'kerja', 'paruh']",13,6,7,mudah upaya kerja penuh kerja paruh,6,6
Cuma nyepam di email.. ga ada satupun CV w di terima sampai interview.. nasib..nasib.. 😂,negatif,2020-06-07,2020,cuma nyepam di email ga ada satupun cv w di terima sampai interview nasib nasib,15,15,cuma nyepam di email tidak ada satupun cv w di terima sampai interview nasib nasib,15,15,"['cuma', 'nyepam', 'di', 'email', 'tidak', 'ada', 'satupun', 'cv', 'w', 'di', 'terima', 'sampai', 'interview', 'nasib', 'nasib']","['nyepam', 'email', 'tidak', 'satupun', 'cv', 'w', 'terima', 'interview', 'nasib', 'nasib']",15,10,5,nyepam email tidak satu cv w terima interview nasib nasib,10,10
"Dihalaman utamanya itu bahasanya inggris semua, dan isinya video berita , informasi sebuah perusahaan , kok gak ada lowongan kerjanya ya ? Apa yang saya cari itu gak ketemu ,",negatif,2020-11-14,2020,dihalaman utamanya itu bahasanya inggris semua dan isinya video berita informasi sebuah perusahaan kok gak ada lowongan kerjanya ya apa yang saya cari itu gak ketemu,30,26,dihalaman utamanya itu bahasanya inggris semua dan isinya video berita informasi sebuah perusahaan kok tidak ada lowongan kerjanya ya apa yang saya cari itu tidak ketemu,26,26,"['dihalaman', 'utamanya', 'itu', 'bahasanya', 'inggris', 'semua', 'dan', 'isinya', 'video', 'berita', 'informasi', 'sebuah', 'perusahaan', 'kok', 'tidak', 'ada', 'lowongan', 'kerjanya', 'ya', 'apa', 'yang', 'saya', 'cari', 'itu', 'tidak', 'ketemu']","['dihalaman', 'utamanya', 'bahasanya', 'inggris', 'isinya', 'video', 'berita', 'informasi', 'perusahaan', 'tidak', 'lowongan', 'kerjanya', 'ya', 'cari', 'tidak', 'ketemu']",26,16,10,halaman utama bahasa inggris isi video berita informasi usaha tidak lowong kerja ya cari tidak ketemu,16,16
LinkedIn profesional menjembatani ilmu dan pengalaman-pengalaman baru yang dapat diaplikasikan pada dunia kerja. Dan satu yang terjadi adalah relationship.,positif,2020-08-04,2020,linkedin profesional menjembatani ilmu dan pengalaman pengalaman baru yang dapat diaplikasikan pada dunia kerja dan satu yang terjadi adalah relationship,19,20,linkedin profesional menjembatani ilmu dan pengalaman pengalaman baru yang dapat diaplikasikan pada dunia kerja dan satu yang terjadi adalah relationship,20,20,"['linkedin', 'profesional', 'menjembatani', 'ilmu', 'dan', 'pengalaman', 'pengalaman', 'baru', 'yang', 'dapat', 'diaplikasikan', 'pada', 'dunia', 'kerja', 'dan', 'satu', 'yang', 'terjadi', 'adalah', 'relationship']","['linkedin', 'profesional', 'menjembatani', 'ilmu', 'pengalaman', 'pengalaman', 'diaplikasikan', 'dunia', 'kerja', 'relationship']",20,10,10,linkedin profesional jembatan ilmu alam alam aplikasi dunia kerja relationship,10,10
Aplikasi LinkedIn memudahkan untuk terhubung dengan orang-orang dan hal-hal yang penting untuk kehidupan profe,positif,2023-06-05,2023,aplikasi linkedin memudahkan untuk terhubung dengan orang orang dan hal hal yang penting untuk kehidupan profe,14,16,aplikasi linkedin memudahkan untuk terhubung dengan orang orang dan hal hal yang penting untuk kehidupan profe,16,16,"['aplikasi', 'linkedin', 'memudahkan', 'untuk', 'terhubung', 'dengan', 'orang', 'orang', 'dan', 'hal', 'hal', 'yang', 'penting', 'untuk', 'kehidupan', 'profe']","['aplikasi', 'linkedin', 'memudahkan', 'terhubung', 'orang', 'orang', 'kehidupan', 'profe']",16,8,8,aplikasi linkedin mudah hubung orang orang hidup profe,8,8
Keren aplikasi nya jadi lebih mudah mengakses informasi,positif,2024-08-19,2024,keren aplikasi nya jadi lebih mudah mengakses informasi,8,8,keren aplikasi nya jadi lebih mudah mengakses informasi,8,8,"['keren', 'aplikasi', 'nya', 'jadi', 'lebih', 'mudah', 'mengakses', 'informasi']","['keren', 'aplikasi', 'nya', 'mudah', 'mengakses', 'informasi']",8,6,2,keren aplikasi nya mudah akses informasi,6,6
Jelek bgt gak bisa registrasi verifikasi nya sangat gak support,negatif,2022-06-13,2022,jelek bgt gak bisa registrasi verifikasi nya sangat gak support,10,10,jelek banget tidak bisa registrasi verifikasi nya sangat tidak support,10,10,"['jelek', 'banget', 'tidak', 'bisa', 'registrasi', 'verifikasi', 'nya', 'sangat', 'tidak', 'support']","['jelek', 'banget', 'tidak', 'registrasi', 'verifikasi', 'nya', 'tidak', 'support']",10,8,2,jelek banget tidak registrasi verifikasi nya tidak support,8,8
Saya sangat senang dengan aplikasi linkdĺn karena membantu koneksi jaringan .,positif,2020-10-24,2020,saya sangat senang dengan aplikasi linkdĺn karena membantu koneksi jaringan,11,10,saya sangat senang dengan aplikasi linkdĺn karena membantu koneksi jaringan,10,10,"['saya', 'sangat', 'senang', 'dengan', 'aplikasi', 'linkdĺn', 'karena', 'membantu', 'koneksi', 'jaringan']","['senang', 'aplikasi', 'linkdĺn', 'membantu', 'koneksi', 'jaringan']",10,6,4,senang aplikasi linkd n bantu koneksi jaring,6,7
"Susah bngt login nyeeee, buang2 waktu doang, verifikasi ga kelar2.",negatif,2023-05-18,2023,susah bngt login nyeeee buang waktu doang verifikasi ga kelar,10,10,susah banget login nyeeee buang waktu saja verifikasi tidak kelar,10,10,"['susah', 'banget', 'login', 'nyeeee', 'buang', 'waktu', 'saja', 'verifikasi', 'tidak', 'kelar']","['susah', 'banget', 'login', 'nyeeee', 'buang', 'verifikasi', 'tidak', 'kelar']",10,8,2,susah banget login nyeeee buang verifikasi tidak kelar,8,8
Kenapa setiap Menyimpan data data selalu pengiriman gagal?,negatif,2020-02-28,2020,kenapa setiap menyimpan data data selalu pengiriman gagal,8,8,kenapa setiap menyimpan data data selalu pengiriman gagal,8,8,"['kenapa', 'setiap', 'menyimpan', 'data', 'data', 'selalu', 'pengiriman', 'gagal']","['menyimpan', 'data', 'data', 'pengiriman', 'gagal']",8,5,3,simpan data data kirim gagal,5,5
"Kesel banget sumpah sm Linkedln skrg, tahap verifikasinya gagal trs.. logika aja klo kita bukan manusia melainkan hewan kan gak mungkin bisa login tolol.. tolong perbaiki lg ya.. kecewa akut!",negatif,2022-05-23,2022,kesel banget sumpah sm linkedln skrg tahap verifikasinya gagal trs logika aja klo kita bukan manusia melainkan hewan kan gak mungkin bisa login tolol tolong perbaiki lg ya kecewa akut,30,30,kesel banget sumpah sama linkedln sekarang tahap verifikasinya gagal terus logika saja kalau kita bukan manusia melainkan hewan akan tidak mungkin bisa login tolol tolong perbaikan lagi ya kecewa akut,30,30,"['kesel', 'banget', 'sumpah', 'sama', 'linkedln', 'sekarang', 'tahap', 'verifikasinya', 'gagal', 'terus', 'logika', 'saja', 'kalau', 'kita', 'bukan', 'manusia', 'melainkan', 'hewan', 'akan', 'tidak', 'mungkin', 'bisa', 'login', 'tolol', 'tolong', 'perbaikan', 'lagi', 'ya', 'kecewa', 'akut']","['kesel', 'banget', 'sumpah', 'linkedln', 'tahap', 'verifikasinya', 'gagal', 'logika', 'manusia', 'hewan', 'tidak', 'login', 'tolol', 'tolong', 'perbaikan', 'ya', 'kecewa', 'akut']",30,18,12,kesel banget sumpah linkedln tahap verifikasi gagal logika manusia hewan tidak login tolol tolong baik ya kecewa akut,18,18
"aplikasi menyesatkan tidak akurat, tidak punya akun tapi ada di likedln di pencarian google muncul nama gua, mana tanda tangan ???? hak cipta ???? dalam 24 jam tidak di hapus di pencarian google anda kena pencemaran nama baik #terimakasih",negatif,2023-06-20,2023,aplikasi menyesatkan tidak akurat tidak punya akun tapi ada di likedln di pencarian google muncul nama gua mana tanda tangan hak cipta dalam jam tidak di hapus di pencarian google anda kena pencemaran nama baik terimakasih,39,36,aplikasi menyesatkan tidak akurat tidak punya akun tapi ada di likedln di pencarian google muncul nama saya mana tanda tangan hak cipta dalam jam tidak di hapus di pencarian google anda kena pencemaran nama baik terima kasih,36,37,"['aplikasi', 'menyesatkan', 'tidak', 'akurat', 'tidak', 'punya', 'akun', 'tapi', 'ada', 'di', 'likedln', 'di', 'pencarian', 'google', 'muncul', 'nama', 'saya', 'mana', 'tanda', 'tangan', 'hak', 'cipta', 'dalam', 'jam', 'tidak', 'di', 'hapus', 'di', 'pencarian', 'google', 'anda', 'kena', 'pencemaran', 'nama', 'baik', 'terima', 'kasih']","['aplikasi', 'menyesatkan', 'tidak', 'akurat', 'tidak', 'akun', 'likedln', 'pencarian', 'google', 'muncul', 'nama', 'tanda', 'tangan', 'hak', 'cipta', 'jam', 'tidak', 'hapus', 'pencarian', 'google', 'kena', 'pencemaran', 'nama', 'terima', 'kasih']",37,25,12,aplikasi sesat tidak akurat tidak akun likedln cari google muncul nama tanda tangan hak cipta jam tidak hapus cari google kena cemar nama terima kasih,25,25
Tidak jelas aplikasi nya. Kenapa verifikasi untuk masuk harus nebak gambar hewan.. mending dikasih pertanyaan atau kode captcha deh dari pada nebak gambar,negatif,2022-01-24,2022,tidak jelas aplikasi nya kenapa verifikasi untuk masuk harus nebak gambar hewan mending dikasih pertanyaan atau kode captcha deh dari pada nebak gambar,23,23,tidak jelas aplikasi nya kenapa verifikasi untuk masuk harus nebak gambar hewan mending dikasih pertanyaan atau kode captcha deh dari pada nebak gambar,23,23,"['tidak', 'jelas', 'aplikasi', 'nya', 'kenapa', 'verifikasi', 'untuk', 'masuk', 'harus', 'nebak', 'gambar', 'hewan', 'mending', 'dikasih', 'pertanyaan', 'atau', 'kode', 'captcha', 'deh', 'dari', 'pada', 'nebak', 'gambar']","['tidak', 'aplikasi', 'nya', 'verifikasi', 'masuk', 'nebak', 'gambar', 'hewan', 'mending', 'dikasih', 'kode', 'captcha', 'deh', 'nebak', 'gambar']",23,15,8,tidak aplikasi nya verifikasi masuk nebak gambar hewan mending kasih kode captcha deh nebak gambar,15,15
Asik juga buat usaha,positif,2024-06-19,2024,asik juga buat usaha,4,4,asyik juga buat usaha,4,4,"['asyik', 'juga', 'buat', 'usaha']","['asyik', 'usaha']",4,2,2,asyik usaha,2,2
Subs nya mahal bgt 🫠,negatif,2024-08-31,2024,subs nya mahal bgt,5,4,subs nya mahal banget,4,4,"['subs', 'nya', 'mahal', 'banget']","['subs', 'nya', 'mahal', 'banget']",4,4,0,subs nya mahal banget,4,4
"Aplikasi ini sangat berguna bukan hanya untuk jobseeker atau recruiter, tapi untuk employee juga bermanfaat menambah wawasan dan relasi.",positif,2022-01-15,2022,aplikasi ini sangat berguna bukan hanya untuk jobseeker atau recruiter tapi untuk employee juga bermanfaat menambah wawasan dan relasi,19,19,aplikasi ini sangat berguna bukan hanya untuk jobseeker atau recruiter tapi untuk employee juga bermanfaat menambah wawasan dan relasi,19,19,"['aplikasi', 'ini', 'sangat', 'berguna', 'bukan', 'hanya', 'untuk', 'jobseeker', 'atau', 'recruiter', 'tapi', 'untuk', 'employee', 'juga', 'bermanfaat', 'menambah', 'wawasan', 'dan', 'relasi']","['aplikasi', 'berguna', 'jobseeker', 'recruiter', 'employee', 'bermanfaat', 'menambah', 'wawasan', 'relasi']",19,9,10,aplikasi guna jobseeker recruiter employee manfaat tambah wawas relasi,9,9
"susah verifikasi kode, lama sekali notifnya. dan gambar badak susah buat verif. menyesalllllllll skaliiiii 👎",negatif,2021-10-26,2021,susah verifikasi kode lama sekali notifnya dan gambar badak susah buat verif menyesalllllllll skaliiiii,15,14,susah verifikasi kode lama sekali notifnya dan gambar badak susah buat verif menyesalllllllll skaliiiii,14,14,"['susah', 'verifikasi', 'kode', 'lama', 'sekali', 'notifnya', 'dan', 'gambar', 'badak', 'susah', 'buat', 'verif', 'menyesalllllllll', 'skaliiiii']","['susah', 'verifikasi', 'kode', 'notifnya', 'gambar', 'badak', 'susah', 'verif', 'menyesalllllllll', 'skaliiiii']",14,10,4,susah verifikasi kode notifnya gambar badak susah verif menyesalllllllll skaliiiii,10,10
Mohon maaf untuk login aja verifikasi mulu ga selesai selesai bingung bat ini apk knp sih.. captcah eror mulu,negatif,2023-05-06,2023,mohon maaf untuk login aja verifikasi mulu ga selesai selesai bingung bat ini apk knp sih captcah eror mulu,19,19,mohon maaf untuk login saja verifikasi mulu tidak selesai selesai bingung bat ini aplikasi kenapa sih captcah error mulu,19,19,"['mohon', 'maaf', 'untuk', 'login', 'saja', 'verifikasi', 'mulu', 'tidak', 'selesai', 'selesai', 'bingung', 'bat', 'ini', 'aplikasi', 'kenapa', 'sih', 'captcah', 'error', 'mulu']","['mohon', 'maaf', 'login', 'verifikasi', 'mulu', 'tidak', 'selesai', 'selesai', 'bingung', 'bat', 'aplikasi', 'sih', 'captcah', 'error', 'mulu']",19,15,4,mohon maaf login verifikasi mulu tidak selesai selesai bingung bat aplikasi sih captcah error mulu,15,15
Cuma ferifikasi gambar untuk memastikan bukan robot saja susah betul..males mau pakai aplikasi dari awal.sudah ribet,negatif,2022-02-27,2022,cuma ferifikasi gambar untuk memastikan bukan robot saja susah betul males mau pakai aplikasi dari awal sudah ribet,16,18,cuma ferifikasi gambar untuk memastikan bukan robot saja susah betul malas mau pakai aplikasi dari awal sudah rumit,18,18,"['cuma', 'ferifikasi', 'gambar', 'untuk', 'memastikan', 'bukan', 'robot', 'saja', 'susah', 'betul', 'malas', 'mau', 'pakai', 'aplikasi', 'dari', 'awal', 'sudah', 'rumit']","['ferifikasi', 'gambar', 'robot', 'susah', 'malas', 'pakai', 'aplikasi', 'rumit']",18,8,10,ferifikasi gambar robot susah malas pakai aplikasi rumit,8,8
Aplikasinya selalu nyampah di tiap beli HP baru tp bgtu mo login susah bngd pdhl udh ngisi captcha dengan benar...gk niat banget bkin aplikasi,negatif,2023-09-21,2023,aplikasinya selalu nyampah di tiap beli hp baru tp bgtu mo login susah bngd pdhl udh ngisi captcha dengan benar gk niat banget bkin aplikasi,24,25,aplikasi nya selalu nyampah di tiap beli handphone baru tapi begitu mau login susah bngd padahal sudah mengisi captcha dengan benar tidak niat banget bkin aplikasi,25,26,"['aplikasi', 'nya', 'selalu', 'nyampah', 'di', 'tiap', 'beli', 'handphone', 'baru', 'tapi', 'begitu', 'mau', 'login', 'susah', 'bngd', 'padahal', 'sudah', 'mengisi', 'captcha', 'dengan', 'benar', 'tidak', 'niat', 'banget', 'bkin', 'aplikasi']","['aplikasi', 'nya', 'nyampah', 'beli', 'handphone', 'login', 'susah', 'bngd', 'mengisi', 'captcha', 'tidak', 'niat', 'banget', 'bkin', 'aplikasi']",26,15,11,aplikasi nya nyampah beli handphone login susah bngd isi captcha tidak niat banget bkin aplikasi,15,15
Gak bisa buka terlalu banyak iklan. Capek dech....,negatif,2024-06-13,2024,gak bisa buka terlalu banyak iklan capek dech,8,8,tidak bisa buka terlalu banyak iklan capek deh,8,8,"['tidak', 'bisa', 'buka', 'terlalu', 'banyak', 'iklan', 'capek', 'deh']","['tidak', 'buka', 'iklan', 'capek', 'deh']",8,5,3,tidak buka iklan capek deh,5,5
"untuk para pengembang tolong dong diperbaiki.... mash ada yg tipu"" buat cari pekerjaan.... atau bikin setiap perusahaan yg mau menerbitkan info lowongan pekerjaan tidak asal bikin profil perusahan harus ada dgn jelas dan kasih kolom komentar. masa sebesar linkedln ada info lowongan yg gak jelas atau tipu""",negatif,2020-08-11,2020,untuk para pengembang tolong dong diperbaiki mash ada yg tipu buat cari pekerjaan atau bikin setiap perusahaan yg mau menerbitkan info lowongan pekerjaan tidak asal bikin profil perusahan harus ada dgn jelas dan kasih kolom komentar masa sebesar linkedln ada info lowongan yg gak jelas atau tipu,47,47,untuk para pengembang tolong dong di perbaiki masih ada yang tipu buat cari pekerjaan atau bikin setiap perusahaan yang mau menerbitkan informasi lowongan pekerjaan tidak asal bikin profil perusahan harus ada dengan jelas dan kasih kolom komentar masa sebesar linkedln ada informasi lowongan yang tidak jelas atau tipu,47,48,"['untuk', 'para', 'pengembang', 'tolong', 'dong', 'di', 'perbaiki', 'masih', 'ada', 'yang', 'tipu', 'buat', 'cari', 'pekerjaan', 'atau', 'bikin', 'setiap', 'perusahaan', 'yang', 'mau', 'menerbitkan', 'informasi', 'lowongan', 'pekerjaan', 'tidak', 'asal', 'bikin', 'profil', 'perusahan', 'harus', 'ada', 'dengan', 'jelas', 'dan', 'kasih', 'kolom', 'komentar', 'masa', 'sebesar', 'linkedln', 'ada', 'informasi', 'lowongan', 'yang', 'tidak', 'jelas', 'atau', 'tipu']","['pengembang', 'tolong', 'perbaiki', 'tipu', 'cari', 'pekerjaan', 'bikin', 'perusahaan', 'menerbitkan', 'informasi', 'lowongan', 'pekerjaan', 'tidak', 'bikin', 'profil', 'perusahan', 'kasih', 'kolom', 'komentar', 'linkedln', 'informasi', 'lowongan', 'tidak', 'tipu']",48,24,24,kembang tolong baik tipu cari kerja bikin usaha terbit informasi lowong kerja tidak bikin profil usah kasih kolom komentar linkedln informasi lowong tidak tipu,24,24
INI APAAN GUA DAH VERIFIKASI BOLAK BALIK MASIH AJA GA BISA LOGIN!! VERIFIKASI EMAIL SEMUA MASIH AJA GA BISA. TOLONG DIPERBAIKI!!,negatif,2024-03-14,2024,ini apaan gua dah verifikasi bolak balik masih aja ga bisa login verifikasi email semua masih aja ga bisa tolong diperbaiki,21,21,ini apa saya sudah verifikasi bolak balik masih saja tidak bisa login verifikasi email semua masih saja tidak bisa tolong di perbaiki,21,22,"['ini', 'apa', 'saya', 'sudah', 'verifikasi', 'bolak', 'balik', 'masih', 'saja', 'tidak', 'bisa', 'login', 'verifikasi', 'email', 'semua', 'masih', 'saja', 'tidak', 'bisa', 'tolong', 'di', 'perbaiki']","['verifikasi', 'bolak', 'tidak', 'login', 'verifikasi', 'email', 'tidak', 'tolong', 'perbaiki']",22,9,13,verifikasi bolak tidak login verifikasi email tidak tolong baik,9,9
Ini kenapa ya setiap mau login verifikasi sudah benar tapi minta verifikasi terus berulang ulang.,negatif,2023-09-16,2023,ini kenapa ya setiap mau login verifikasi sudah benar tapi minta verifikasi terus berulang ulang,15,15,ini kenapa ya setiap mau login verifikasi sudah benar tapi minta verifikasi terus berulang ulang,15,15,"['ini', 'kenapa', 'ya', 'setiap', 'mau', 'login', 'verifikasi', 'sudah', 'benar', 'tapi', 'minta', 'verifikasi', 'terus', 'berulang', 'ulang']","['ya', 'login', 'verifikasi', 'verifikasi', 'berulang', 'ulang']",15,6,9,ya login verifikasi verifikasi ulang ulang,6,6
"ga masuk akal, udah verifikasi dengan benar tapi akun saya dibatasi?! mana 2 akun lagii. gimana sih?!",negatif,2024-08-14,2024,ga masuk akal udah verifikasi dengan benar tapi akun saya dibatasi mana akun lagii gimana sih,17,16,tidak masuk akal sudah verifikasi dengan benar tapi akun saya dibatasi mana akun lagi bagaimana sih,16,16,"['tidak', 'masuk', 'akal', 'sudah', 'verifikasi', 'dengan', 'benar', 'tapi', 'akun', 'saya', 'dibatasi', 'mana', 'akun', 'lagi', 'bagaimana', 'sih']","['tidak', 'masuk', 'akal', 'verifikasi', 'akun', 'dibatasi', 'akun', 'sih']",16,8,8,tidak masuk akal verifikasi akun batas akun sih,8,8
Sangat membantu,positif,2024-06-21,2024,sangat membantu,2,2,sangat membantu,2,2,"['sangat', 'membantu']",['membantu'],2,1,1,bantu,1,1
aplikasi memuakkan,negatif,2024-06-23,2024,aplikasi memuakkan,2,2,aplikasi memuakkan,2,2,"['aplikasi', 'memuakkan']","['aplikasi', 'memuakkan']",2,2,0,aplikasi muak,2,2
Notioikasinya terlalu sering numpuk di email menjadi penuh,negatif,2024-06-18,2024,notioikasinya terlalu sering numpuk di email menjadi penuh,8,8,notioikasinya terlalu sering numpuk di email menjadi penuh,8,8,"['notioikasinya', 'terlalu', 'sering', 'numpuk', 'di', 'email', 'menjadi', 'penuh']","['notioikasinya', 'numpuk', 'email', 'penuh']",8,4,4,notioikasinya numpuk email penuh,4,4
"Saya sampai tiap hari buat akun , dinonaktifkan tanpa ada kejelasan ,benci saya saya ,mkanya saya beri bintang 1 ,sampai tidak ada perubahan tidak ada penambahan bintang terimakasih",negatif,2020-04-14,2020,saya sampai tiap hari buat akun dinonaktifkan tanpa ada kejelasan benci saya saya mkanya saya beri bintang sampai tidak ada perubahan tidak ada penambahan bintang terimakasih,28,26,saya sampai tiap hari buat akun dinonaktifkan tanpa ada kejelasan benci saya saya mkanya saya beri bintang sampai tidak ada perubahan tidak ada penambahan bintang terima kasih,26,27,"['saya', 'sampai', 'tiap', 'hari', 'buat', 'akun', 'dinonaktifkan', 'tanpa', 'ada', 'kejelasan', 'benci', 'saya', 'saya', 'mkanya', 'saya', 'beri', 'bintang', 'sampai', 'tidak', 'ada', 'perubahan', 'tidak', 'ada', 'penambahan', 'bintang', 'terima', 'kasih']","['akun', 'dinonaktifkan', 'kejelasan', 'benci', 'mkanya', 'bintang', 'tidak', 'perubahan', 'tidak', 'penambahan', 'bintang', 'terima', 'kasih']",27,13,14,akun nonaktif jelas benci mkanya bintang tidak ubah tidak tambah bintang terima kasih,13,13
Sangat amat membantu bisa mendapatkan informasi pekerjaan sesuai kompetensi kita .Juga bisa bertemu dengan relasi atau kolega yg suitable.,positif,2020-04-27,2020,sangat amat membantu bisa mendapatkan informasi pekerjaan sesuai kompetensi kita juga bisa bertemu dengan relasi atau kolega yg suitable,19,19,sangat amat membantu bisa mendapatkan informasi pekerjaan sesuai kompetensi kita juga bisa bertemu dengan relasi atau kolega yang suitable,19,19,"['sangat', 'amat', 'membantu', 'bisa', 'mendapatkan', 'informasi', 'pekerjaan', 'sesuai', 'kompetensi', 'kita', 'juga', 'bisa', 'bertemu', 'dengan', 'relasi', 'atau', 'kolega', 'yang', 'suitable']","['membantu', 'informasi', 'pekerjaan', 'sesuai', 'kompetensi', 'bertemu', 'relasi', 'kolega', 'suitable']",19,9,10,bantu informasi kerja sesuai kompetensi temu relasi kolega suitable,9,9
"Apk teraneh.... Cuma niat nyari duit haram doang apk ini, dajjal",negatif,2024-05-07,2024,apk teraneh cuma niat nyari duit haram doang apk ini dajjal,11,11,aplikasi teraneh cuma niat mencari uang haram saja aplikasi ini dajjal,11,11,"['aplikasi', 'teraneh', 'cuma', 'niat', 'mencari', 'uang', 'haram', 'saja', 'aplikasi', 'ini', 'dajjal']","['aplikasi', 'teraneh', 'niat', 'mencari', 'uang', 'haram', 'aplikasi', 'dajjal']",11,8,3,aplikasi aneh niat cari uang haram aplikasi dajjal,8,8
Buruk.... Selalu arahin klik kambing arah ke atas selalu salah,negatif,2024-06-12,2024,buruk selalu arahin klik kambing arah ke atas selalu salah,10,10,buruk selalu arahin klik kambing arah ke atas selalu salah,10,10,"['buruk', 'selalu', 'arahin', 'klik', 'kambing', 'arah', 'ke', 'atas', 'selalu', 'salah']","['buruk', 'arahin', 'klik', 'kambing', 'arah', 'salah']",10,6,4,buruk arahin klik kambing arah salah,6,6
Saya kasih bintang***karena ada msalah saya tidak bisa liat fropil dan ampload video.mohon accunt saya bisa d perbaiki,negatif,2020-03-18,2020,saya kasih bintang karena ada msalah saya tidak bisa liat fropil dan ampload video mohon accunt saya bisa d perbaiki,18,20,saya kasih bintang karena ada msalah saya tidak bisa lihat fropil dan ampload video mohon accunt saya bisa di perbaikan,20,20,"['saya', 'kasih', 'bintang', 'karena', 'ada', 'msalah', 'saya', 'tidak', 'bisa', 'lihat', 'fropil', 'dan', 'ampload', 'video', 'mohon', 'accunt', 'saya', 'bisa', 'di', 'perbaikan']","['kasih', 'bintang', 'msalah', 'tidak', 'lihat', 'fropil', 'ampload', 'video', 'mohon', 'accunt', 'perbaikan']",20,11,9,kasih bintang msalah tidak lihat fropil ampload video mohon accunt baik,11,11
"Hei dev, klo buat aplikasi yg bnr ya,,, tolol bngt...!!! Lebih gmpang buat email dan gmail, dripada login di linkedin, dsruh pecahkan tekateki...?!! Situ tolol apa n???!!! Brengsek... Orang download app anda buat cari kerja, bukan untuk bermain teka teki yg gk bermutu boss...!!!",negatif,2021-09-16,2021,hei dev klo buat aplikasi yg bnr ya tolol bngt lebih gmpang buat email dan gmail dripada login di linkedin dsruh pecahkan tekateki situ tolol apa n brengsek orang download app anda buat cari kerja bukan untuk bermain teka teki yg gk bermutu boss,44,44,hei dev kalau buat aplikasi yang benar ya tolol banget lebih gmpang buat email dan gmail dripada login di linkedin dsruh pecahkan tekateki situ tolol apa dan brengsek orang unduh aplikasi anda buat cari kerja bukan untuk bermain teka teki yang tidak bermutu boss,44,44,"['hei', 'dev', 'kalau', 'buat', 'aplikasi', 'yang', 'benar', 'ya', 'tolol', 'banget', 'lebih', 'gmpang', 'buat', 'email', 'dan', 'gmail', 'dripada', 'login', 'di', 'linkedin', 'dsruh', 'pecahkan', 'tekateki', 'situ', 'tolol', 'apa', 'dan', 'brengsek', 'orang', 'unduh', 'aplikasi', 'anda', 'buat', 'cari', 'kerja', 'bukan', 'untuk', 'bermain', 'teka', 'teki', 'yang', 'tidak', 'bermutu', 'boss']","['hei', 'dev', 'aplikasi', 'ya', 'tolol', 'banget', 'gmpang', 'email', 'gmail', 'dripada', 'login', 'linkedin', 'dsruh', 'pecahkan', 'tekateki', 'situ', 'tolol', 'brengsek', 'orang', 'unduh', 'aplikasi', 'cari', 'kerja', 'bermain', 'teka', 'teki', 'tidak', 'bermutu', 'boss']",44,29,15,hei dev aplikasi ya tolol banget gmpang email gmail dripada login linkedin dsruh pecah tekateki situ tolol brengsek orang unduh aplikasi cari kerja main teka teki tidak mutu boss,29,29
"gajelas suruh verifikasi tp gabisa lolos2, alasan nocaptcha ga valid terus, apalah dia apalah",negatif,2024-03-09,2024,gajelas suruh verifikasi tp gabisa lolos alasan nocaptcha ga valid terus apalah dia apalah,14,14,tidak jelas suruh verifikasi tapi tidak bisa lolos alasan nocaptcha tidak valid terus apalah dia apalah,14,16,"['tidak', 'jelas', 'suruh', 'verifikasi', 'tapi', 'tidak', 'bisa', 'lolos', 'alasan', 'nocaptcha', 'tidak', 'valid', 'terus', 'apalah', 'dia', 'apalah']","['tidak', 'suruh', 'verifikasi', 'tidak', 'lolos', 'alasan', 'nocaptcha', 'tidak', 'valid', 'apalah', 'apalah']",16,11,5,tidak suruh verifikasi tidak lolos alas nocaptcha tidak valid apa apa,11,11
"gak di buka2 dan gak yg aneh2...sekali di buka tau tau akun di batasi lalu minta KTP , udah kayak buka aplikasi pinjol.",negatif,2024-03-22,2024,gak di buka dan gak yg aneh sekali di buka tau tau akun di batasi lalu minta ktp udah kayak buka aplikasi pinjol,23,23,tidak di buka dan tidak yang aneh sekali di buka tahu tahu akun di batasi lalu minta ktp sudah kayak buka aplikasi pinjol,23,23,"['tidak', 'di', 'buka', 'dan', 'tidak', 'yang', 'aneh', 'sekali', 'di', 'buka', 'tahu', 'tahu', 'akun', 'di', 'batasi', 'lalu', 'minta', 'ktp', 'sudah', 'kayak', 'buka', 'aplikasi', 'pinjol']","['tidak', 'buka', 'tidak', 'aneh', 'buka', 'akun', 'batasi', 'ktp', 'kayak', 'buka', 'aplikasi', 'pinjol']",23,12,11,tidak buka tidak aneh buka akun batas ktp kayak buka aplikasi pinjol,12,12
"Susah login, verifikasi sudah terkirim malah di coba beberapa hari lagi,",negatif,2024-04-28,2024,susah login verifikasi sudah terkirim malah di coba beberapa hari lagi,11,11,susah login verifikasi sudah terkirim bahkan di coba beberapa hari lagi,11,11,"['susah', 'login', 'verifikasi', 'sudah', 'terkirim', 'bahkan', 'di', 'coba', 'beberapa', 'hari', 'lagi']","['susah', 'login', 'verifikasi', 'terkirim', 'coba']",11,5,6,susah login verifikasi kirim coba,5,5
Terbaik info loker,positif,2024-06-28,2024,terbaik info loker,3,3,terbaik informasi loker,3,3,"['terbaik', 'informasi', 'loker']","['terbaik', 'informasi', 'loker']",3,3,0,baik informasi loker,3,3
"kok gk bisa masuk yah, ada tulisan akun anda dibatasi terus, udah verify identitas kok belum dihubungi hubungi. please tolong lah mau cari kerja buat kuliah ini 🥲",negatif,2022-07-10,2022,kok gk bisa masuk yah ada tulisan akun anda dibatasi terus udah verify identitas kok belum dihubungi hubungi please tolong lah mau cari kerja buat kuliah ini,28,27,kok tidak bisa masuk ya ada tulisan akun anda dibatasi terus sudah verify identitas kok belum menghubungi menghubungi please tolong lah mau cari kerja buat kuliah ini,27,27,"['kok', 'tidak', 'bisa', 'masuk', 'ya', 'ada', 'tulisan', 'akun', 'anda', 'dibatasi', 'terus', 'sudah', 'verify', 'identitas', 'kok', 'belum', 'menghubungi', 'menghubungi', 'please', 'tolong', 'lah', 'mau', 'cari', 'kerja', 'buat', 'kuliah', 'ini']","['tidak', 'masuk', 'ya', 'tulisan', 'akun', 'dibatasi', 'verify', 'identitas', 'menghubungi', 'menghubungi', 'please', 'tolong', 'cari', 'kerja', 'kuliah']",27,15,12,tidak masuk ya tulis akun batas verify identitas hubung hubung please tolong cari kerja kuliah,15,15
susah login! gak jelas banget ini apk. muter2 verifikasi doank..,negatif,2024-03-13,2024,susah login gak jelas banget ini apk muter verifikasi doank,10,10,susah login tidak jelas banget ini aplikasi memutar verifikasi doank,10,10,"['susah', 'login', 'tidak', 'jelas', 'banget', 'ini', 'aplikasi', 'memutar', 'verifikasi', 'doank']","['susah', 'login', 'tidak', 'banget', 'aplikasi', 'memutar', 'verifikasi', 'doank']",10,8,2,susah login tidak banget aplikasi putar verifikasi doank,8,8
"Awalnya sih sangat berharap dengan aplikasi ini tapi baru 2 hari akun sudah dinonaktifkan tolong segera diperbaiki , thanks",negatif,2020-04-13,2020,awalnya sih sangat berharap dengan aplikasi ini tapi baru hari akun sudah dinonaktifkan tolong segera diperbaiki thanks,19,17,awalnya sih sangat berharap dengan aplikasi ini tapi baru hari akun sudah dinonaktifkan tolong segera di perbaiki terima kasih,17,19,"['awalnya', 'sih', 'sangat', 'berharap', 'dengan', 'aplikasi', 'ini', 'tapi', 'baru', 'hari', 'akun', 'sudah', 'dinonaktifkan', 'tolong', 'segera', 'di', 'perbaiki', 'terima', 'kasih']","['sih', 'berharap', 'aplikasi', 'akun', 'dinonaktifkan', 'tolong', 'perbaiki', 'terima', 'kasih']",19,9,10,sih harap aplikasi akun nonaktif tolong baik terima kasih,9,9
Saya sangat suka aplikasi linkkedin.....,positif,2024-06-06,2024,saya sangat suka aplikasi linkkedin,5,5,saya sangat suka aplikasi linkkedin,5,5,"['saya', 'sangat', 'suka', 'aplikasi', 'linkkedin']","['suka', 'aplikasi', 'linkkedin']",5,3,2,suka aplikasi linkkedin,3,3
Sangat Bagus dan Bermanfaat,positif,2024-06-08,2024,sangat bagus dan bermanfaat,4,4,sangat bagus dan bermanfaat,4,4,"['sangat', 'bagus', 'dan', 'bermanfaat']","['bagus', 'bermanfaat']",4,2,2,bagus manfaat,2,2
Benci saya iklanya masuk terus....dalam 10 menit,negatif,2024-06-09,2024,benci saya iklanya masuk terus dalam menit,7,7,benci saya iklanya masuk terus dalam menit,7,7,"['benci', 'saya', 'iklanya', 'masuk', 'terus', 'dalam', 'menit']","['benci', 'iklanya', 'masuk', 'menit']",7,4,3,benci iklanya masuk menit,4,4
Mudah dalam mendapatkan informasi kerja.,positif,2024-06-05,2024,mudah dalam mendapatkan informasi kerja,5,5,mudah dalam mendapatkan informasi kerja,5,5,"['mudah', 'dalam', 'mendapatkan', 'informasi', 'kerja']","['mudah', 'informasi', 'kerja']",5,3,2,mudah informasi kerja,3,3
Menyediakan informasi secara rinci,positif,2024-06-05,2024,menyediakan informasi secara rinci,4,4,menyediakan informasi secara rinci,4,4,"['menyediakan', 'informasi', 'secara', 'rinci']","['menyediakan', 'informasi', 'rinci']",4,3,1,sedia informasi rinci,3,3
"Tiba"" akun dibatasi, selalu dimimta login terus. Kacau nih...",negatif,2023-08-21,2023,tiba akun dibatasi selalu dimimta login terus kacau nih,9,9,tiba akun dibatasi selalu dimimta login terus kacau nih,9,9,"['tiba', 'akun', 'dibatasi', 'selalu', 'dimimta', 'login', 'terus', 'kacau', 'nih']","['akun', 'dibatasi', 'dimimta', 'login', 'kacau', 'nih']",9,6,3,akun batas dimimta login kacau nih,6,6
Sangat baik untuk membangun relasi dan komunikasi antar bagian,negatif,2020-06-10,2020,sangat baik untuk membangun relasi dan komunikasi antar bagian,9,9,sangat baik untuk membangun relasi dan komunikasi antar bagian,9,9,"['sangat', 'baik', 'untuk', 'membangun', 'relasi', 'dan', 'komunikasi', 'antar', 'bagian']","['membangun', 'relasi', 'komunikasi']",9,3,6,bangun relasi komunikasi,3,3
Ini gimana si. Padahal aku ga ngapa-ngapain akun ku malah kek ke banned tolong diperbaiki servernya!,negatif,2023-08-18,2023,ini gimana si padahal aku ga ngapa ngapain akun ku malah kek ke banned tolong diperbaiki servernya,16,17,ini bagaimana sih padahal aku tidak ngapa buat apa akun saya bahkan seperti ke banned tolong di perbaiki server nya,17,20,"['ini', 'bagaimana', 'sih', 'padahal', 'aku', 'tidak', 'ngapa', 'buat', 'apa', 'akun', 'saya', 'bahkan', 'seperti', 'ke', 'banned', 'tolong', 'di', 'perbaiki', 'server', 'nya']","['sih', 'tidak', 'ngapa', 'akun', 'banned', 'tolong', 'perbaiki', 'server', 'nya']",20,9,11,sih tidak ngapa akun banned tolong baik server nya,9,9
Aplikasi aneh gabisa login,negatif,2024-05-06,2024,aplikasi aneh gabisa login,4,4,aplikasi aneh tidak bisa login,4,5,"['aplikasi', 'aneh', 'tidak', 'bisa', 'login']","['aplikasi', 'aneh', 'tidak', 'login']",5,4,1,aplikasi aneh tidak login,4,4
Semua lowongan terlalu meminta standar kebohongan yang luar biasa.. Mereka lowongan pekerjaan tapi tidak untuk merekrut para pencari kerja,negatif,2023-09-10,2023,semua lowongan terlalu meminta standar kebohongan yang luar biasa mereka lowongan pekerjaan tapi tidak untuk merekrut para pencari kerja,19,19,semua lowongan terlalu meminta standar kebohongan yang luar biasa mereka lowongan pekerjaan tapi tidak untuk merekrut para pencari kerja,19,19,"['semua', 'lowongan', 'terlalu', 'meminta', 'standar', 'kebohongan', 'yang', 'luar', 'biasa', 'mereka', 'lowongan', 'pekerjaan', 'tapi', 'tidak', 'untuk', 'merekrut', 'para', 'pencari', 'kerja']","['lowongan', 'standar', 'kebohongan', 'lowongan', 'pekerjaan', 'tidak', 'merekrut', 'pencari', 'kerja']",19,9,10,lowong standar bohong lowong kerja tidak rekrut cari kerja,9,9
Terima kasih...semoga lancar,positif,2024-06-12,2024,terima kasih semoga lancar,3,4,terima kasih semoga lancar,4,4,"['terima', 'kasih', 'semoga', 'lancar']","['terima', 'kasih', 'semoga', 'lancar']",4,4,0,terima kasih moga lancar,4,4
Iklan menggangu,negatif,2024-06-05,2024,iklan menggangu,2,2,iklan menggangu,2,2,"['iklan', 'menggangu']","['iklan', 'menggangu']",2,2,0,iklan menggangu,2,2
Apk gajelas akun tiba2 gabisa di akses dan butuh verifikasi yang ga selesai2 sampe sekarang,negatif,2023-08-21,2023,apk gajelas akun tiba gabisa di akses dan butuh verifikasi yang ga selesai sampe sekarang,15,15,aplikasi tidak jelas akun tiba tidak bisa di akses dan butuh verifikasi yang tidak selesai sampai sekarang,15,17,"['aplikasi', 'tidak', 'jelas', 'akun', 'tiba', 'tidak', 'bisa', 'di', 'akses', 'dan', 'butuh', 'verifikasi', 'yang', 'tidak', 'selesai', 'sampai', 'sekarang']","['aplikasi', 'tidak', 'akun', 'tidak', 'akses', 'butuh', 'verifikasi', 'tidak', 'selesai']",17,9,8,aplikasi tidak akun tidak akses butuh verifikasi tidak selesai,9,9
"Ya Ampun, gw Apply 10 lowongan/hari gk ada yang manggil... Yang manggil malah yang di LinkedIn sm glint. Aneh banget",negatif,2023-12-01,2023,ya ampun gw apply lowongan hari gk ada yang manggil yang manggil malah yang di linkedin sm glint aneh banget,20,20,ya ampun saya apply lowongan hari tidak ada yang panggil yang panggil bahkan yang di linkedin sama glint aneh banget,20,20,"['ya', 'ampun', 'saya', 'apply', 'lowongan', 'hari', 'tidak', 'ada', 'yang', 'panggil', 'yang', 'panggil', 'bahkan', 'yang', 'di', 'linkedin', 'sama', 'glint', 'aneh', 'banget']","['ya', 'ampun', 'apply', 'lowongan', 'tidak', 'panggil', 'panggil', 'linkedin', 'glint', 'aneh', 'banget']",20,11,9,ya ampun apply lowong tidak panggil panggil linkedin glint aneh banget,11,11
"Apk gk jls ribet banget. Mau login aja susah, malah ada akun ke2 yang padahal aku ga pernah bikin akun ke2",negatif,2024-03-09,2024,apk gk jls ribet banget mau login aja susah malah ada akun ke yang padahal aku ga pernah bikin akun ke,21,21,aplikasi tidak jls rumit banget mau login saja susah bahkan ada akun ke yang padahal aku tidak pernah bikin akun ke,21,21,"['aplikasi', 'tidak', 'jls', 'rumit', 'banget', 'mau', 'login', 'saja', 'susah', 'bahkan', 'ada', 'akun', 'ke', 'yang', 'padahal', 'aku', 'tidak', 'pernah', 'bikin', 'akun', 'ke']","['aplikasi', 'tidak', 'jls', 'rumit', 'banget', 'login', 'susah', 'akun', 'tidak', 'bikin', 'akun']",21,11,10,aplikasi tidak jls rumit banget login susah akun tidak bikin akun,11,11
"Gimana mau login, verifikasi nya eror, udah sekian lama gak ada tindak lanjutnya.",negatif,2024-02-22,2024,gimana mau login verifikasi nya eror udah sekian lama gak ada tindak lanjutnya,13,13,bagaimana mau login verifikasi nya error sudah sekian lama tidak ada tindak lanjutnya,13,13,"['bagaimana', 'mau', 'login', 'verifikasi', 'nya', 'error', 'sudah', 'sekian', 'lama', 'tidak', 'ada', 'tindak', 'lanjutnya']","['login', 'verifikasi', 'nya', 'error', 'sekian', 'tidak', 'tindak']",13,7,6,login verifikasi nya error sekian tidak tindak,7,7
Ini kenapa si mau login gak bisa masuk login lama bgt lagih,negatif,2023-06-07,2023,ini kenapa si mau login gak bisa masuk login lama bgt lagih,12,12,ini kenapa sih mau login tidak bisa masuk login lama banget lagih,12,12,"['ini', 'kenapa', 'sih', 'mau', 'login', 'tidak', 'bisa', 'masuk', 'login', 'lama', 'banget', 'lagih']","['sih', 'login', 'tidak', 'masuk', 'login', 'banget', 'lagih']",12,7,5,sih login tidak masuk login banget lagih,7,7
Saya sangat bersyukur sebat saya berharap dari berbagai sumber yang dapat digunakan sebagai alat untuk mencapai tujuan yang sama dengan yang diatas namanya tercantum dalam lampiran ini 😁,positif,2023-10-16,2023,saya sangat bersyukur sebat saya berharap dari berbagai sumber yang dapat digunakan sebagai alat untuk mencapai tujuan yang sama dengan yang diatas namanya tercantum dalam lampiran ini,28,27,saya sangat bersyukur sebat saya berharap dari berbagai sumber yang dapat digunakan sebagai alat untuk mencapai tujuan yang sama dengan yang diatas namanya tercantum dalam lampiran ini,27,27,"['saya', 'sangat', 'bersyukur', 'sebat', 'saya', 'berharap', 'dari', 'berbagai', 'sumber', 'yang', 'dapat', 'digunakan', 'sebagai', 'alat', 'untuk', 'mencapai', 'tujuan', 'yang', 'sama', 'dengan', 'yang', 'diatas', 'namanya', 'tercantum', 'dalam', 'lampiran', 'ini']","['bersyukur', 'sebat', 'berharap', 'sumber', 'alat', 'mencapai', 'tujuan', 'diatas', 'namanya', 'tercantum', 'lampiran']",27,11,16,syukur sebat harap sumber alat capai tuju atas nama cantum lampir,11,11
Setiap buka aplikasi LinkedIn langsung keluar lagi buka lagi aplikasi nya keluar lagi kesel banget,negatif,2023-11-14,2023,setiap buka aplikasi linkedin langsung keluar lagi buka lagi aplikasi nya keluar lagi kesel banget,15,15,setiap buka aplikasi linkedin langsung keluar lagi buka lagi aplikasi nya keluar lagi kesel banget,15,15,"['setiap', 'buka', 'aplikasi', 'linkedin', 'langsung', 'keluar', 'lagi', 'buka', 'lagi', 'aplikasi', 'nya', 'keluar', 'lagi', 'kesel', 'banget']","['buka', 'aplikasi', 'linkedin', 'langsung', 'buka', 'aplikasi', 'nya', 'kesel', 'banget']",15,9,6,buka aplikasi linkedin langsung buka aplikasi nya kesel banget,9,9
"Disuruh mengisi langkah keamanan, sudah selesai diisi malah balik lagi ke langkah keamanan, terus muter² . Ccd",negatif,2022-10-30,2022,disuruh mengisi langkah keamanan sudah selesai diisi malah balik lagi ke langkah keamanan terus muter² ccd,17,16,disuruh mengisi langkah keamanan sudah selesai diisi bahkan balik lagi ke langkah keamanan terus muter² ccd,16,16,"['disuruh', 'mengisi', 'langkah', 'keamanan', 'sudah', 'selesai', 'diisi', 'bahkan', 'balik', 'lagi', 'ke', 'langkah', 'keamanan', 'terus', 'muter²', 'ccd']","['disuruh', 'mengisi', 'langkah', 'keamanan', 'selesai', 'diisi', 'langkah', 'keamanan', 'muter²', 'ccd']",16,10,6,suruh isi langkah aman selesai isi langkah aman muter ccd,10,10
Semoga dengan menggunakan linkedin semua urusan yg membawa saya ke jLan sukses dapat menjadi motivasi kepada orang lain untuk menggunakan aplikasi ini . Terimah kasih,positif,2021-08-01,2021,semoga dengan menggunakan linkedin semua urusan yg membawa saya ke jlan sukses dapat menjadi motivasi kepada orang lain untuk menggunakan aplikasi ini terimah kasih,25,24,semoga dengan menggunakan linkedin semua urusan yang membawa saya ke jlan sukses dapat menjadi motivasi kepada orang lain untuk menggunakan aplikasi ini terimah kasih,24,24,"['semoga', 'dengan', 'menggunakan', 'linkedin', 'semua', 'urusan', 'yang', 'membawa', 'saya', 'ke', 'jlan', 'sukses', 'dapat', 'menjadi', 'motivasi', 'kepada', 'orang', 'lain', 'untuk', 'menggunakan', 'aplikasi', 'ini', 'terimah', 'kasih']","['semoga', 'linkedin', 'urusan', 'membawa', 'jlan', 'sukses', 'motivasi', 'orang', 'aplikasi', 'terimah', 'kasih']",24,11,13,moga linkedin urus bawa jlan sukses motivasi orang aplikasi terimah kasih,11,11
"Karena ganti hp, Login capcha sampai 20x, dan login eror. Tolong admin diperbaiki bug ini.",negatif,2024-01-09,2024,karena ganti hp login capcha sampai x dan login eror tolong admin diperbaiki bug ini,15,15,karena ganti handphone login capcha sampai x dan login error tolong admin di perbaiki bug ini,15,16,"['karena', 'ganti', 'handphone', 'login', 'capcha', 'sampai', 'x', 'dan', 'login', 'error', 'tolong', 'admin', 'di', 'perbaiki', 'bug', 'ini']","['ganti', 'handphone', 'login', 'capcha', 'x', 'login', 'error', 'tolong', 'admin', 'perbaiki', 'bug']",16,11,5,ganti handphone login capcha x login error tolong admin baik bug,11,11
susah bgt mau daftar juga disuruh milih gambar kuda puluhan kali ttep aja salah dipermudah dong jgn jyk gini jadi males,negatif,2023-12-11,2023,susah bgt mau daftar juga disuruh milih gambar kuda puluhan kali ttep aja salah dipermudah dong jgn jyk gini jadi males,21,21,susah banget mau daftar juga disuruh memilih gambar kuda puluhan kali ttep saja salah dipermudah dong jangan jyk begini jadi malas,21,21,"['susah', 'banget', 'mau', 'daftar', 'juga', 'disuruh', 'memilih', 'gambar', 'kuda', 'puluhan', 'kali', 'ttep', 'saja', 'salah', 'dipermudah', 'dong', 'jangan', 'jyk', 'begini', 'jadi', 'malas']","['susah', 'banget', 'daftar', 'disuruh', 'memilih', 'gambar', 'kuda', 'puluhan', 'kali', 'ttep', 'salah', 'dipermudah', 'jyk', 'malas']",21,14,7,susah banget daftar suruh pilih gambar kuda puluh kali ttep salah mudah jyk malas,14,14
susah banget uninstall ... terkesan tidak boleh keluar dari aplikasi linkedln ... hmmmmm,negatif,2021-02-12,2021,susah banget uninstall terkesan tidak boleh keluar dari aplikasi linkedln hmmmmm,13,11,susah banget uninstall terkesan tidak boleh keluar dari aplikasi linkedln hmmmmm,11,11,"['susah', 'banget', 'uninstall', 'terkesan', 'tidak', 'boleh', 'keluar', 'dari', 'aplikasi', 'linkedln', 'hmmmmm']","['susah', 'banget', 'uninstall', 'terkesan', 'tidak', 'aplikasi', 'linkedln', 'hmmmmm']",11,8,3,susah banget uninstall kes tidak aplikasi linkedln hmmmmm,8,8
"Captcha nya nge bug , ke ulang2 di saat benar , di saat salah di tegur , di saat benar ya ulang lagi",negatif,2023-08-16,2023,captcha nya nge bug ke ulang di saat benar di saat salah di tegur di saat benar ya ulang lagi,23,20,captcha nya nge bug ke ulang di saat benar di saat salah di tegur di saat benar ya ulang lagi,20,20,"['captcha', 'nya', 'nge', 'bug', 'ke', 'ulang', 'di', 'saat', 'benar', 'di', 'saat', 'salah', 'di', 'tegur', 'di', 'saat', 'benar', 'ya', 'ulang', 'lagi']","['captcha', 'nya', 'nge', 'bug', 'ulang', 'salah', 'tegur', 'ya', 'ulang']",20,9,11,captcha nya nge bug ulang salah tegur ya ulang,9,9
Agak kurang suka sama linkedin sekarang karena sering dijadikan tempat jualan produk :(,negatif,2022-06-16,2022,agak kurang suka sama linkedin sekarang karena sering dijadikan tempat jualan produk,13,12,agak kurang suka sama linkedin sekarang karena sering dijadikan tempat jualan produk,12,12,"['agak', 'kurang', 'suka', 'sama', 'linkedin', 'sekarang', 'karena', 'sering', 'dijadikan', 'tempat', 'jualan', 'produk']","['suka', 'linkedin', 'dijadikan', 'jualan', 'produk']",12,5,7,suka linkedin jadi jual produk,5,5
Kenapa tidak bisa instal update terbaru? Saya tidak bisa refresh feed di app linkedin yg lama,negatif,2020-12-21,2020,kenapa tidak bisa instal update terbaru saya tidak bisa refresh feed di app linkedin yg lama,16,16,kenapa tidak bisa memasang diperbarui terbaru saya tidak bisa refresh feed di aplikasi linkedin yang lama,16,16,"['kenapa', 'tidak', 'bisa', 'memasang', 'diperbarui', 'terbaru', 'saya', 'tidak', 'bisa', 'refresh', 'feed', 'di', 'aplikasi', 'linkedin', 'yang', 'lama']","['tidak', 'memasang', 'diperbarui', 'terbaru', 'tidak', 'refresh', 'feed', 'aplikasi', 'linkedin']",16,9,7,tidak pasang baru baru tidak refresh feed aplikasi linkedin,9,9
Aplikasi LinkedIn sangat bagus buat yg cari kerja. Terimakasih LinkedIn,positif,2020-11-13,2020,aplikasi linkedin sangat bagus buat yg cari kerja terimakasih linkedin,10,10,aplikasi linkedin sangat bagus buat yang cari kerja terima kasih linkedin,10,11,"['aplikasi', 'linkedin', 'sangat', 'bagus', 'buat', 'yang', 'cari', 'kerja', 'terima', 'kasih', 'linkedin']","['aplikasi', 'linkedin', 'bagus', 'cari', 'kerja', 'terima', 'kasih', 'linkedin']",11,8,3,aplikasi linkedin bagus cari kerja terima kasih linkedin,8,8
"gajelas ni aplikasi , udh kirim lamaran tapi ga pernah ada kejelasan lamaran kita di proses atau tidak oleh perusahaan",negatif,2024-07-26,2024,gajelas ni aplikasi udh kirim lamaran tapi ga pernah ada kejelasan lamaran kita di proses atau tidak oleh perusahaan,20,19,tidak jelas ini aplikasi sudah kirim lamaran tapi tidak pernah ada kejelasan lamaran kita di proses atau tidak oleh perusahaan,19,20,"['tidak', 'jelas', 'ini', 'aplikasi', 'sudah', 'kirim', 'lamaran', 'tapi', 'tidak', 'pernah', 'ada', 'kejelasan', 'lamaran', 'kita', 'di', 'proses', 'atau', 'tidak', 'oleh', 'perusahaan']","['tidak', 'aplikasi', 'kirim', 'lamaran', 'tidak', 'kejelasan', 'lamaran', 'proses', 'tidak', 'perusahaan']",20,10,10,tidak aplikasi kirim lamar tidak jelas lamar proses tidak usaha,10,10
aplikasinya aku uninstal lg soalnya gara2 gambar badak hadap k atas jd susah bgt msuk..,negatif,2022-01-10,2022,aplikasinya aku uninstal lg soalnya gara gambar badak hadap k atas jd susah bgt msuk,15,15,aplikasi nya aku hapus instalan lagi soalnya gara gambar badak hadap ke atas jadi susah banget msuk,15,17,"['aplikasi', 'nya', 'aku', 'hapus', 'instalan', 'lagi', 'soalnya', 'gara', 'gambar', 'badak', 'hadap', 'ke', 'atas', 'jadi', 'susah', 'banget', 'msuk']","['aplikasi', 'nya', 'hapus', 'instalan', 'gara', 'gambar', 'badak', 'hadap', 'susah', 'banget', 'msuk']",17,11,6,aplikasi nya hapus instalan gara gambar badak hadap susah banget msuk,11,11
"Sangat membantu dalam mencari lowongan pekerjaan,mudah digunakan,pertahankan lagi ✨",positif,2023-11-19,2023,sangat membantu dalam mencari lowongan pekerjaan mudah digunakan pertahankan lagi,9,10,sangat membantu dalam mencari lowongan pekerjaan mudah digunakan pertahankan lagi,10,10,"['sangat', 'membantu', 'dalam', 'mencari', 'lowongan', 'pekerjaan', 'mudah', 'digunakan', 'pertahankan', 'lagi']","['membantu', 'mencari', 'lowongan', 'pekerjaan', 'mudah', 'pertahankan']",10,6,4,bantu cari lowong kerja mudah tahan,6,6
"Susah bgt mau login, sudah melakukan verifikasi sesuai arahan tapi tetap saja tidak bisa log in",negatif,2022-11-14,2022,susah bgt mau login sudah melakukan verifikasi sesuai arahan tapi tetap saja tidak bisa log in,16,16,susah banget mau login sudah melakukan verifikasi sesuai arahan tapi tetap saja tidak bisa log in,16,16,"['susah', 'banget', 'mau', 'login', 'sudah', 'melakukan', 'verifikasi', 'sesuai', 'arahan', 'tapi', 'tetap', 'saja', 'tidak', 'bisa', 'log', 'in']","['susah', 'banget', 'login', 'verifikasi', 'sesuai', 'arahan', 'tidak', 'log', 'in']",16,9,7,susah banget login verifikasi sesuai arah tidak log in,9,9
"Habis update malah error, gak bisa di buka. Mohon perbaiki kembali",negatif,2022-01-04,2022,habis update malah error gak bisa di buka mohon perbaiki kembali,11,11,habis diperbarui bahkan error tidak bisa di buka mohon perbaikan kembali,11,11,"['habis', 'diperbarui', 'bahkan', 'error', 'tidak', 'bisa', 'di', 'buka', 'mohon', 'perbaikan', 'kembali']","['habis', 'diperbarui', 'error', 'tidak', 'buka', 'mohon', 'perbaikan']",11,7,4,habis baru error tidak buka mohon baik,7,7
Maaf dengan terpaksa saya uninstal..saya di suruh masukan posisi pekerjaan terbaru..setelah saya masukan..tetap aja tidak bisa masuk..i hate..,negatif,2020-02-23,2020,maaf dengan terpaksa saya uninstal saya di suruh masukan posisi pekerjaan terbaru setelah saya masukan tetap aja tidak bisa masuk i hate,18,22,maaf dengan terpaksa saya hapus instalan saya di suruh masukan posisi pekerjaan terbaru setelah saya masukan tetap saja tidak bisa masuk i hate,22,23,"['maaf', 'dengan', 'terpaksa', 'saya', 'hapus', 'instalan', 'saya', 'di', 'suruh', 'masukan', 'posisi', 'pekerjaan', 'terbaru', 'setelah', 'saya', 'masukan', 'tetap', 'saja', 'tidak', 'bisa', 'masuk', 'i', 'hate']","['maaf', 'terpaksa', 'hapus', 'instalan', 'suruh', 'masukan', 'posisi', 'pekerjaan', 'terbaru', 'masukan', 'tidak', 'masuk', 'i', 'hate']",23,14,9,maaf paksa hapus instalan suruh masuk posisi kerja baru masuk tidak masuk i hate,14,14
"Tolong diperbaiki lagi untuk verifikasinya, selalu tidak bisa dan diulang ulang",negatif,2023-07-28,2023,tolong diperbaiki lagi untuk verifikasinya selalu tidak bisa dan diulang ulang,11,11,tolong di perbaiki lagi untuk verifikasinya selalu tidak bisa dan diulang ulang,11,12,"['tolong', 'di', 'perbaiki', 'lagi', 'untuk', 'verifikasinya', 'selalu', 'tidak', 'bisa', 'dan', 'diulang', 'ulang']","['tolong', 'perbaiki', 'verifikasinya', 'tidak', 'diulang', 'ulang']",12,6,6,tolong baik verifikasi tidak ulang ulang,6,6
Terimakasih Linkedln kita bisa update masalah loker pekerjaan sehingga kita tidak binggung dalam mencari lowongan pekerjaan,positif,2023-05-19,2023,terimakasih linkedln kita bisa update masalah loker pekerjaan sehingga kita tidak binggung dalam mencari lowongan pekerjaan,16,16,terima kasih linkedln kita bisa diperbarui masalah loker pekerjaan sehingga kita tidak binggung dalam mencari lowongan pekerjaan,16,17,"['terima', 'kasih', 'linkedln', 'kita', 'bisa', 'diperbarui', 'masalah', 'loker', 'pekerjaan', 'sehingga', 'kita', 'tidak', 'binggung', 'dalam', 'mencari', 'lowongan', 'pekerjaan']","['terima', 'kasih', 'linkedln', 'diperbarui', 'loker', 'pekerjaan', 'tidak', 'binggung', 'mencari', 'lowongan', 'pekerjaan']",17,11,6,terima kasih linkedln baru loker kerja tidak binggung cari lowong kerja,11,11
"Knp ya gabisa login trs di hp,padahal di browser aman",negatif,2023-06-26,2023,knp ya gabisa login trs di hp padahal di browser aman,10,11,kenapa ya tidak bisa login terus di handphone padahal di browser aman,11,12,"['kenapa', 'ya', 'tidak', 'bisa', 'login', 'terus', 'di', 'handphone', 'padahal', 'di', 'browser', 'aman']","['ya', 'tidak', 'login', 'handphone', 'browser', 'aman']",12,6,6,ya tidak login handphone browser aman,6,6
Wow aplikasi ini sungguh bermanfaat buat kita... Terima kasih,positif,2024-04-30,2024,wow aplikasi ini sungguh bermanfaat buat kita terima kasih,9,9,wow aplikasi ini sungguh bermanfaat buat kita terima kasih,9,9,"['wow', 'aplikasi', 'ini', 'sungguh', 'bermanfaat', 'buat', 'kita', 'terima', 'kasih']","['wow', 'aplikasi', 'sungguh', 'bermanfaat', 'terima', 'kasih']",9,6,3,wow aplikasi sungguh manfaat terima kasih,6,6
Sangat bagus ....bisa kenal dengan banyak orang.,positif,2024-04-25,2024,sangat bagus bisa kenal dengan banyak orang,7,7,sangat bagus bisa kenal dengan banyak orang,7,7,"['sangat', 'bagus', 'bisa', 'kenal', 'dengan', 'banyak', 'orang']","['bagus', 'kenal', 'orang']",7,3,4,bagus kenal orang,3,3
"Informatif, dan mempermudah memperluas jaringan kerja",positif,2020-09-10,2020,informatif dan mempermudah memperluas jaringan kerja,6,6,informatif dan mempermudah memperluas jaringan kerja,6,6,"['informatif', 'dan', 'mempermudah', 'memperluas', 'jaringan', 'kerja']","['informatif', 'mempermudah', 'memperluas', 'jaringan', 'kerja']",6,5,1,informatif mudah luas jaring kerja,5,5
"Ini gmn si, waktu saya mau verifikasi kok malah salah terus, padahal saya jawabnya juga bener. Mana ada jwbn yg sama sama bener lagi",negatif,2022-03-08,2022,ini gmn si waktu saya mau verifikasi kok malah salah terus padahal saya jawabnya juga bener mana ada jwbn yg sama sama bener lagi,24,24,ini bagaimana sih waktu saya mau verifikasi kok bahkan salah terus padahal saya jawabnya juga benar mana ada jwbn yang sama sama benar lagi,24,24,"['ini', 'bagaimana', 'sih', 'waktu', 'saya', 'mau', 'verifikasi', 'kok', 'bahkan', 'salah', 'terus', 'padahal', 'saya', 'jawabnya', 'juga', 'benar', 'mana', 'ada', 'jwbn', 'yang', 'sama', 'sama', 'benar', 'lagi']","['sih', 'verifikasi', 'salah', 'jwbn']",24,4,20,sih verifikasi salah jwbn,4,4
"gabisa login, selalu looping di verifikasi",negatif,2024-03-15,2024,gabisa login selalu looping di verifikasi,6,6,tidak bisa login selalu looping di verifikasi,6,7,"['tidak', 'bisa', 'login', 'selalu', 'looping', 'di', 'verifikasi']","['tidak', 'login', 'looping', 'verifikasi']",7,4,3,tidak login looping verifikasi,4,4
LinkedIn keren dgn updatean baru.. Bisa melihat orang hebat dan banyak lowongan pekerjaan nya,positif,2021-03-03,2021,linkedin keren dgn updatean baru bisa melihat orang hebat dan banyak lowongan pekerjaan nya,14,14,linkedin keren dengan updatean baru bisa melihat orang hebat dan banyak lowongan pekerjaan nya,14,14,"['linkedin', 'keren', 'dengan', 'updatean', 'baru', 'bisa', 'melihat', 'orang', 'hebat', 'dan', 'banyak', 'lowongan', 'pekerjaan', 'nya']","['linkedin', 'keren', 'updatean', 'orang', 'hebat', 'lowongan', 'pekerjaan', 'nya']",14,8,6,linkedin keren updatean orang hebat lowong kerja nya,8,8
"Aplikasih yang mudah di pahami untuk belajar & membantu, serta bergabung mencari peluang2 bisnis di negara sendir, maupun di negara tetangga 👌🏻",positif,2021-03-31,2021,aplikasih yang mudah di pahami untuk belajar membantu serta bergabung mencari peluang bisnis di negara sendir maupun di negara tetangga,22,20,aplikasih yang mudah di pahami untuk belajar membantu serta bergabung mencari peluang bisnis di negara sendir maupun di negara tetangga,20,20,"['aplikasih', 'yang', 'mudah', 'di', 'pahami', 'untuk', 'belajar', 'membantu', 'serta', 'bergabung', 'mencari', 'peluang', 'bisnis', 'di', 'negara', 'sendir', 'maupun', 'di', 'negara', 'tetangga']","['aplikasih', 'mudah', 'pahami', 'belajar', 'membantu', 'bergabung', 'mencari', 'peluang', 'bisnis', 'negara', 'sendir', 'negara', 'tetangga']",20,13,7,aplikasih mudah paham ajar bantu gabung cari peluang bisnis negara sendir negara tetangga,13,13
Sangat berguna untuk mencari pekerjaan yang lebih baik dan menambah teman-teman yang berpengalaman,positif,2020-08-13,2020,sangat berguna untuk mencari pekerjaan yang lebih baik dan menambah teman teman yang berpengalaman,13,14,sangat berguna untuk mencari pekerjaan yang lebih baik dan menambah teman teman yang berpengalaman,14,14,"['sangat', 'berguna', 'untuk', 'mencari', 'pekerjaan', 'yang', 'lebih', 'baik', 'dan', 'menambah', 'teman', 'teman', 'yang', 'berpengalaman']","['berguna', 'mencari', 'pekerjaan', 'menambah', 'teman', 'teman', 'berpengalaman']",14,7,7,guna cari kerja tambah teman teman alam,7,7
Kenapa pas di update malah makin parah ga bisa scroll ke bawa. Mohon di perbaiki,negatif,2021-09-02,2021,kenapa pas di update malah makin parah ga bisa scroll ke bawa mohon di perbaiki,15,15,kenapa pas di diperbarui bahkan makin parah tidak bisa scroll ke bawa mohon di perbaikan,15,15,"['kenapa', 'pas', 'di', 'diperbarui', 'bahkan', 'makin', 'parah', 'tidak', 'bisa', 'scroll', 'ke', 'bawa', 'mohon', 'di', 'perbaikan']","['pas', 'diperbarui', 'parah', 'tidak', 'scroll', 'bawa', 'mohon', 'perbaikan']",15,8,7,pas baru parah tidak scroll bawa mohon baik,8,8
Kenapa setelah saya instal apknya tidak muncul di dekstop/layar utama handphone saya tolong di respon,negatif,2020-09-11,2020,kenapa setelah saya instal apknya tidak muncul di dekstop layar utama handphone saya tolong di respon,15,16,kenapa setelah saya memasang aplikasinya tidak muncul di dekstop layar utama handphone saya tolong di respons,16,16,"['kenapa', 'setelah', 'saya', 'memasang', 'aplikasinya', 'tidak', 'muncul', 'di', 'dekstop', 'layar', 'utama', 'handphone', 'saya', 'tolong', 'di', 'respons']","['memasang', 'aplikasinya', 'tidak', 'muncul', 'dekstop', 'layar', 'utama', 'handphone', 'tolong', 'respons']",16,10,6,pasang aplikasi tidak muncul dekstop layar utama handphone tolong respons,10,10
Apkikasi sangat lucu. Sudah bener arah atas dah di pencet 50 kali ga ana benernya..auto bersihkan jelek,negatif,2024-03-18,2024,apkikasi sangat lucu sudah bener arah atas dah di pencet kali ga ana benernya auto bersihkan jelek,17,17,apkikasi sangat lucu sudah benar arah atas sudah di tekan kali tidak ana benernya otomatis bersihkan jelek,17,17,"['apkikasi', 'sangat', 'lucu', 'sudah', 'benar', 'arah', 'atas', 'sudah', 'di', 'tekan', 'kali', 'tidak', 'ana', 'benernya', 'otomatis', 'bersihkan', 'jelek']","['apkikasi', 'lucu', 'arah', 'tekan', 'kali', 'tidak', 'ana', 'benernya', 'otomatis', 'bersihkan', 'jelek']",17,11,6,apkikasi lucu arah tekan kali tidak ana benernya otomatis sih jelek,11,11
kenapa linkedin sekarang sering error? buat akun malah sering no-captcha? tolong perbaikin,negatif,2024-04-30,2024,kenapa linkedin sekarang sering error buat akun malah sering no captcha tolong perbaikin,12,13,kenapa linkedin sekarang sering error buat akun bahkan sering nomor captcha tolong perbaikin,13,13,"['kenapa', 'linkedin', 'sekarang', 'sering', 'error', 'buat', 'akun', 'bahkan', 'sering', 'nomor', 'captcha', 'tolong', 'perbaikin']","['linkedin', 'error', 'akun', 'nomor', 'captcha', 'tolong', 'perbaikin']",13,7,6,linkedin error akun nomor captcha tolong perbaikin,7,7
Aplikasi yang berguna menambah wawasan dan membantu menciptakan lapangan kerja bagi yang membutuhkan.,positif,2021-10-28,2021,aplikasi yang berguna menambah wawasan dan membantu menciptakan lapangan kerja bagi yang membutuhkan,13,13,aplikasi yang berguna menambah wawasan dan membantu menciptakan lapangan kerja bagi yang membutuhkan,13,13,"['aplikasi', 'yang', 'berguna', 'menambah', 'wawasan', 'dan', 'membantu', 'menciptakan', 'lapangan', 'kerja', 'bagi', 'yang', 'membutuhkan']","['aplikasi', 'berguna', 'menambah', 'wawasan', 'membantu', 'menciptakan', 'lapangan', 'kerja', 'membutuhkan']",13,9,4,aplikasi guna tambah wawas bantu cipta lapang kerja butuh,9,9
"Sangat membantu meskipun saya belum dapet kerja.. Semangat selalu hidup adalah perjuangan. ""Keeps smile and self healthy ...",positif,2020-09-19,2020,sangat membantu meskipun saya belum dapet kerja semangat selalu hidup adalah perjuangan keeps smile and self healthy,18,17,sangat membantu meskipun saya belum dapat kerja semangat selalu hidup adalah perjuangan keeps smile and self sehat,17,17,"['sangat', 'membantu', 'meskipun', 'saya', 'belum', 'dapat', 'kerja', 'semangat', 'selalu', 'hidup', 'adalah', 'perjuangan', 'keeps', 'smile', 'and', 'self', 'sehat']","['membantu', 'kerja', 'semangat', 'hidup', 'perjuangan', 'keeps', 'smile', 'and', 'self', 'sehat']",17,10,7,bantu kerja semangat hidup juang keeps smile and self sehat,10,10
Susah dapat kerja di applikasi ini cuma info info job saja nilai positifnya .,negatif,2020-04-23,2020,susah dapat kerja di applikasi ini cuma info info job saja nilai positifnya,14,13,susah dapat kerja di aplikasi ini cuma informasi informasi kerja saja nilai positifnya,13,13,"['susah', 'dapat', 'kerja', 'di', 'aplikasi', 'ini', 'cuma', 'informasi', 'informasi', 'kerja', 'saja', 'nilai', 'positifnya']","['susah', 'kerja', 'aplikasi', 'informasi', 'informasi', 'kerja', 'nilai', 'positifnya']",13,8,5,susah kerja aplikasi informasi informasi kerja nilai positif,8,8
Terima kasih telah menjadi wadah bagi kami jobseeker dan semoga linkedin tetap profesional.,positif,2021-01-16,2021,terima kasih telah menjadi wadah bagi kami jobseeker dan semoga linkedin tetap profesional,13,13,terima kasih telah menjadi wadah bagi kami jobseeker dan semoga linkedin tetap profesional,13,13,"['terima', 'kasih', 'telah', 'menjadi', 'wadah', 'bagi', 'kami', 'jobseeker', 'dan', 'semoga', 'linkedin', 'tetap', 'profesional']","['terima', 'kasih', 'wadah', 'jobseeker', 'semoga', 'linkedin', 'profesional']",13,7,6,terima kasih wadah jobseeker moga linkedin profesional,7,7
Aplikasi yg memudahkan menemukan atau mencari relasi dalam dunia pekerjaan.,positif,2020-11-21,2020,aplikasi yg memudahkan menemukan atau mencari relasi dalam dunia pekerjaan,10,10,aplikasi yang memudahkan menemukan atau mencari relasi dalam dunia pekerjaan,10,10,"['aplikasi', 'yang', 'memudahkan', 'menemukan', 'atau', 'mencari', 'relasi', 'dalam', 'dunia', 'pekerjaan']","['aplikasi', 'memudahkan', 'menemukan', 'mencari', 'relasi', 'dunia', 'pekerjaan']",10,7,3,aplikasi mudah temu cari relasi dunia kerja,7,7
"Kita cari kerja susah, tolong lah jangan tambah susah! Maksudnya gmn si? Susah banget verifikasi disuruh ""pilih gambar menghadap keatas"" tp gagal terus.",negatif,2022-07-04,2022,kita cari kerja susah tolong lah jangan tambah susah maksudnya gmn si susah banget verifikasi disuruh pilih gambar menghadap keatas tp gagal terus,23,23,kita cari kerja susah tolong lah jangan tambah susah maksudnya bagaimana sih susah banget verifikasi disuruh pilih gambar menghadap keatas tapi gagal terus,23,23,"['kita', 'cari', 'kerja', 'susah', 'tolong', 'lah', 'jangan', 'tambah', 'susah', 'maksudnya', 'bagaimana', 'sih', 'susah', 'banget', 'verifikasi', 'disuruh', 'pilih', 'gambar', 'menghadap', 'keatas', 'tapi', 'gagal', 'terus']","['cari', 'kerja', 'susah', 'tolong', 'susah', 'maksudnya', 'sih', 'susah', 'banget', 'verifikasi', 'disuruh', 'pilih', 'gambar', 'menghadap', 'keatas', 'gagal']",23,16,7,cari kerja susah tolong susah maksud sih susah banget verifikasi suruh pilih gambar hadap atas gagal,16,16
Koneksitas lebih mudah dan eksklusif...good aplikasi.,positif,2023-09-11,2023,koneksitas lebih mudah dan eksklusif good aplikasi,6,7,koneksitas lebih mudah dan eksklusif bagus aplikasi,7,7,"['koneksitas', 'lebih', 'mudah', 'dan', 'eksklusif', 'bagus', 'aplikasi']","['koneksitas', 'mudah', 'eksklusif', 'bagus', 'aplikasi']",7,5,2,koneksitas mudah eksklusif bagus aplikasi,5,5
"Dapat diandalkan memuat, atau menemukan berita menguntungkan lainnya",positif,2020-06-14,2020,dapat diandalkan memuat atau menemukan berita menguntungkan lainnya,8,8,dapat diandalkan memuat atau menemukan berita menguntungkan lainnya,8,8,"['dapat', 'diandalkan', 'memuat', 'atau', 'menemukan', 'berita', 'menguntungkan', 'lainnya']","['diandalkan', 'memuat', 'menemukan', 'berita', 'menguntungkan']",8,5,3,andal muat temu berita untung,5,5
Pada saat sudah mengisi kemanan akun tidak bisa masuk malah kembali ke halaman login,negatif,2021-11-06,2021,pada saat sudah mengisi kemanan akun tidak bisa masuk malah kembali ke halaman login,14,14,pada saat sudah mengisi kemanan akun tidak bisa masuk bahkan kembali ke halaman login,14,14,"['pada', 'saat', 'sudah', 'mengisi', 'kemanan', 'akun', 'tidak', 'bisa', 'masuk', 'bahkan', 'kembali', 'ke', 'halaman', 'login']","['mengisi', 'kemanan', 'akun', 'tidak', 'masuk', 'halaman', 'login']",14,7,7,isi keman akun tidak masuk halaman login,7,7
Kemarin bisa login sekarang kok gak bisa ya login padahal sinyalnya bagus,negatif,2020-12-05,2020,kemarin bisa login sekarang kok gak bisa ya login padahal sinyalnya bagus,12,12,kemarin bisa login sekarang kok tidak bisa ya login padahal sinyalnya bagus,12,12,"['kemarin', 'bisa', 'login', 'sekarang', 'kok', 'tidak', 'bisa', 'ya', 'login', 'padahal', 'sinyalnya', 'bagus']","['kemarin', 'login', 'tidak', 'ya', 'login', 'sinyalnya', 'bagus']",12,7,5,kemarin login tidak ya login sinyal bagus,7,7
Yth LinkedIn tolonglah hapus profil saya di google search. TERIMAKASIH,negatif,2024-04-13,2024,yth linkedin tolonglah hapus profil saya di google search terimakasih,10,10,yang terhormat linkedin tolonglah hapus profil saya di google search terima kasih,10,12,"['yang', 'terhormat', 'linkedin', 'tolonglah', 'hapus', 'profil', 'saya', 'di', 'google', 'search', 'terima', 'kasih']","['terhormat', 'linkedin', 'tolonglah', 'hapus', 'profil', 'google', 'search', 'terima', 'kasih']",12,9,3,hormat linkedin tolong hapus profil google search terima kasih,9,9
"Applikasi rusaak , udah sering coba bikin akun slalu ada aja masalah... perbaiki laah",negatif,2022-07-18,2022,applikasi rusaak udah sering coba bikin akun slalu ada aja masalah perbaiki laah,14,13,aplikasi rusaak sudah sering coba bikin akun selalu ada saja masalah perbaikan lah,13,13,"['aplikasi', 'rusaak', 'sudah', 'sering', 'coba', 'bikin', 'akun', 'selalu', 'ada', 'saja', 'masalah', 'perbaikan', 'lah']","['aplikasi', 'rusaak', 'coba', 'bikin', 'akun', 'perbaikan']",13,6,7,aplikasi rusaak coba bikin akun baik,6,6
"Sarana yang tepat untuk belajar, menjadi professional serta mendapatkan pekerjaan",positif,2020-05-22,2020,sarana yang tepat untuk belajar menjadi professional serta mendapatkan pekerjaan,10,10,sarana yang tepat untuk belajar menjadi professional serta mendapatkan pekerjaan,10,10,"['sarana', 'yang', 'tepat', 'untuk', 'belajar', 'menjadi', 'professional', 'serta', 'mendapatkan', 'pekerjaan']","['sarana', 'belajar', 'professional', 'pekerjaan']",10,4,6,sarana ajar professional kerja,4,4
"Parahh gak bisaa masuk sama sekalii padahal udh di uninstal ulang, tolong diperbaiki",negatif,2021-08-12,2021,parahh gak bisaa masuk sama sekalii padahal udh di uninstal ulang tolong diperbaiki,13,13,parahh tidak bisaa masuk sama sekali padahal sudah di hapus instalan ulang tolong di perbaiki,13,15,"['parahh', 'tidak', 'bisaa', 'masuk', 'sama', 'sekali', 'padahal', 'sudah', 'di', 'hapus', 'instalan', 'ulang', 'tolong', 'di', 'perbaiki']","['parahh', 'tidak', 'bisaa', 'masuk', 'hapus', 'instalan', 'ulang', 'tolong', 'perbaiki']",15,9,6,parahh tidak bisaa masuk hapus instalan ulang tolong baik,9,9
Ampun...sy udh mulai bnr2 gk suka bgt kayak gini. Sampah ! Masa udh masuk login dengan bnr diulang lagi ?!,negatif,2022-09-16,2022,ampun sy udh mulai bnr gk suka bgt kayak gini sampah masa udh masuk login dengan bnr diulang lagi,20,19,ampun saya sudah mulai benar tidak suka banget kayak begini sampah masa sudah masuk login dengan benar diulang lagi,19,19,"['ampun', 'saya', 'sudah', 'mulai', 'benar', 'tidak', 'suka', 'banget', 'kayak', 'begini', 'sampah', 'masa', 'sudah', 'masuk', 'login', 'dengan', 'benar', 'diulang', 'lagi']","['ampun', 'tidak', 'suka', 'banget', 'kayak', 'sampah', 'masuk', 'login', 'diulang']",19,9,10,ampun tidak suka banget kayak sampah masuk login ulang,9,9
"Gajelas, siapa sih programmernya? Captcha error, sugesti industri tak muncul, berat juga aplikasinya",negatif,2023-12-29,2023,gajelas siapa sih programmernya captcha error sugesti industri tak muncul berat juga aplikasinya,13,13,tidak jelas siapa sih programmernya captcha error sugesti industri tidak muncul berat juga aplikasi nya,13,15,"['tidak', 'jelas', 'siapa', 'sih', 'programmernya', 'captcha', 'error', 'sugesti', 'industri', 'tidak', 'muncul', 'berat', 'juga', 'aplikasi', 'nya']","['tidak', 'sih', 'programmernya', 'captcha', 'error', 'sugesti', 'industri', 'tidak', 'muncul', 'berat', 'aplikasi', 'nya']",15,12,3,tidak sih programmernya captcha error sugesti industri tidak muncul berat aplikasi nya,12,12
Kenapa saya selalu gagal download. Padahal jaringan kuat?? Selalu berhenti di 93%,negatif,2020-04-28,2020,kenapa saya selalu gagal download padahal jaringan kuat selalu berhenti di,12,11,kenapa saya selalu gagal unduh padahal jaringan kuat selalu berhenti di,11,11,"['kenapa', 'saya', 'selalu', 'gagal', 'unduh', 'padahal', 'jaringan', 'kuat', 'selalu', 'berhenti', 'di']","['gagal', 'unduh', 'jaringan', 'kuat', 'berhenti']",11,5,6,gagal unduh jaring kuat henti,5,5
"Bagus sekali, banyak peluang dan tawaran untuk memilih, tinggal keberanian saja",positif,2022-05-05,2022,bagus sekali banyak peluang dan tawaran untuk memilih tinggal keberanian saja,11,11,bagus sekali banyak peluang dan tawaran untuk memilih tinggal keberanian saja,11,11,"['bagus', 'sekali', 'banyak', 'peluang', 'dan', 'tawaran', 'untuk', 'memilih', 'tinggal', 'keberanian', 'saja']","['bagus', 'peluang', 'tawaran', 'memilih', 'tinggal', 'keberanian']",11,6,5,bagus peluang tawar pilih tinggal berani,6,6
"Akun saya di batasi tanpa alasan yang jelas, sudah mengirimkan dokumen untuk konfirmasi akun namun sampai sekarng belum ditindak lanjuti,",negatif,2023-07-17,2023,akun saya di batasi tanpa alasan yang jelas sudah mengirimkan dokumen untuk konfirmasi akun namun sampai sekarng belum ditindak lanjuti,20,20,akun saya di batasi tanpa alasan yang jelas sudah mengirimkan dokumen untuk konfirmasi akun namun sampai sekarng belum ditindak lanjuti,20,20,"['akun', 'saya', 'di', 'batasi', 'tanpa', 'alasan', 'yang', 'jelas', 'sudah', 'mengirimkan', 'dokumen', 'untuk', 'konfirmasi', 'akun', 'namun', 'sampai', 'sekarng', 'belum', 'ditindak', 'lanjuti']","['akun', 'batasi', 'alasan', 'mengirimkan', 'dokumen', 'konfirmasi', 'akun', 'sekarng', 'ditindak', 'lanjuti']",20,10,10,akun batas alas kirim dokumen konfirmasi akun sekarng tindak lanjut,10,10
Jelek banyak iklan,negatif,2024-06-10,2024,jelek banyak iklan,3,3,jelek banyak iklan,3,3,"['jelek', 'banyak', 'iklan']","['jelek', 'iklan']",3,2,1,jelek iklan,2,2
"Tidak bisa buat akun, sudah bakai beberapa e-mail berbeda tetep aja ga bisa. Uninstall aja, terimakasih",negatif,2021-10-11,2021,tidak bisa buat akun sudah bakai beberapa e mail berbeda tetep aja ga bisa uninstall aja terimakasih,16,17,tidak bisa buat akun sudah bakai beberapa e mail berbeda tetap saja tidak bisa uninstall saja terima kasih,17,18,"['tidak', 'bisa', 'buat', 'akun', 'sudah', 'bakai', 'beberapa', 'e', 'mail', 'berbeda', 'tetap', 'saja', 'tidak', 'bisa', 'uninstall', 'saja', 'terima', 'kasih']","['tidak', 'akun', 'bakai', 'e', 'mail', 'berbeda', 'tidak', 'uninstall', 'terima', 'kasih']",18,10,8,tidak akun baka e mail beda tidak uninstall terima kasih,10,10
Saya niatnya mau cari pekerjaan ehh malah disuruh main puzzle udah bener saya pilih malah gagal Mulu tolong admin,negatif,2022-03-28,2022,saya niatnya mau cari pekerjaan ehh malah disuruh main puzzle udah bener saya pilih malah gagal mulu tolong admin,19,19,saya niatnya mau cari pekerjaan eh bahkan disuruh main puzzle sudah benar saya pilih bahkan gagal mulu tolong admin,19,19,"['saya', 'niatnya', 'mau', 'cari', 'pekerjaan', 'eh', 'bahkan', 'disuruh', 'main', 'puzzle', 'sudah', 'benar', 'saya', 'pilih', 'bahkan', 'gagal', 'mulu', 'tolong', 'admin']","['niatnya', 'cari', 'pekerjaan', 'eh', 'disuruh', 'main', 'puzzle', 'pilih', 'gagal', 'mulu', 'tolong', 'admin']",19,12,7,niat cari kerja eh suruh main puzzle pilih gagal mulu tolong admin,12,12
saya sangat terbanntu dgn adanya aplikasi ini,positif,2024-05-25,2024,saya sangat terbanntu dgn adanya aplikasi ini,7,7,saya sangat terbanntu dengan adanya aplikasi ini,7,7,"['saya', 'sangat', 'terbanntu', 'dengan', 'adanya', 'aplikasi', 'ini']","['terbanntu', 'aplikasi']",7,2,5,terbanntu aplikasi,2,2
"Udah seminggu lebih gabisa akses, padahal udah versi terbaru, udah hapus cache tetap gabisa",negatif,2022-02-23,2022,udah seminggu lebih gabisa akses padahal udah versi terbaru udah hapus cache tetap gabisa,14,14,sudah seminggu lebih tidak bisa akses padahal sudah versi terbaru sudah hapus cache tetap tidak bisa,14,16,"['sudah', 'seminggu', 'lebih', 'tidak', 'bisa', 'akses', 'padahal', 'sudah', 'versi', 'terbaru', 'sudah', 'hapus', 'cache', 'tetap', 'tidak', 'bisa']","['seminggu', 'tidak', 'akses', 'versi', 'terbaru', 'hapus', 'cache', 'tidak']",16,8,8,minggu tidak akses versi baru hapus cache tidak,8,8
Security check nya ga jelas. Pilih gambar yang melihat ke atas tapi udah dipilih salah mulu. GA JELAS CHECK BOT NYA,negatif,2024-02-08,2024,security check nya ga jelas pilih gambar yang melihat ke atas tapi udah dipilih salah mulu ga jelas check bot nya,21,21,security cek nya tidak jelas pilih gambar yang melihat ke atas tapi sudah dipilih salah mulu tidak jelas cek bot nya,21,21,"['security', 'cek', 'nya', 'tidak', 'jelas', 'pilih', 'gambar', 'yang', 'melihat', 'ke', 'atas', 'tapi', 'sudah', 'dipilih', 'salah', 'mulu', 'tidak', 'jelas', 'cek', 'bot', 'nya']","['security', 'cek', 'nya', 'tidak', 'pilih', 'gambar', 'dipilih', 'salah', 'mulu', 'tidak', 'cek', 'bot', 'nya']",21,13,8,security cek nya tidak pilih gambar pilih salah mulu tidak cek bot nya,13,13
Bagus dan membantu mempermudah hubungan antara pemberi dan pencari kerja,positif,2024-04-02,2024,bagus dan membantu mempermudah hubungan antara pemberi dan pencari kerja,10,10,bagus dan membantu mempermudah hubungan antara pemberi dan pencari kerja,10,10,"['bagus', 'dan', 'membantu', 'mempermudah', 'hubungan', 'antara', 'pemberi', 'dan', 'pencari', 'kerja']","['bagus', 'membantu', 'mempermudah', 'hubungan', 'pemberi', 'pencari', 'kerja']",10,7,3,bagus bantu mudah hubung beri cari kerja,7,7
Gabisa login karena security check. Jelas² jawaban udah bener sesuai instruksi. Makin aneh ini aplikasi,negatif,2024-02-21,2024,gabisa login karena security check jelas² jawaban udah bener sesuai instruksi makin aneh ini aplikasi,15,15,tidak bisa login karena security cek jelas² jawaban sudah benar sesuai instruksi makin aneh ini aplikasi,15,16,"['tidak', 'bisa', 'login', 'karena', 'security', 'cek', 'jelas²', 'jawaban', 'sudah', 'benar', 'sesuai', 'instruksi', 'makin', 'aneh', 'ini', 'aplikasi']","['tidak', 'login', 'security', 'cek', 'jelas²', 'sesuai', 'instruksi', 'aneh', 'aplikasi']",16,9,7,tidak login security cek jelas sesuai instruksi aneh aplikasi,9,9
"Knapa aplikasi ini tidak bisa di uninstal.. bahaya ini aplikasi.. jngan"" nge hack",negatif,2020-01-11,2020,knapa aplikasi ini tidak bisa di uninstal bahaya ini aplikasi jngan nge hack,13,13,kenapa aplikasi ini tidak bisa di hapus instalan bahaya ini aplikasi jangan nge hack,13,14,"['kenapa', 'aplikasi', 'ini', 'tidak', 'bisa', 'di', 'hapus', 'instalan', 'bahaya', 'ini', 'aplikasi', 'jangan', 'nge', 'hack']","['aplikasi', 'tidak', 'hapus', 'instalan', 'bahaya', 'aplikasi', 'nge', 'hack']",14,8,6,aplikasi tidak hapus instalan bahaya aplikasi nge hack,8,8
gw praktisi IT aja bingung pakai linkedin. semua tombol gw pencet ga nemu kolom page company,negatif,2023-02-22,2023,gw praktisi it aja bingung pakai linkedin semua tombol gw pencet ga nemu kolom page company,16,16,saya praktisi it saja bingung pakai linkedin semua tombol saya tekan tidak ketemu kolom page perusahaan,16,16,"['saya', 'praktisi', 'it', 'saja', 'bingung', 'pakai', 'linkedin', 'semua', 'tombol', 'saya', 'tekan', 'tidak', 'ketemu', 'kolom', 'page', 'perusahaan']","['praktisi', 'it', 'bingung', 'pakai', 'linkedin', 'tombol', 'tekan', 'tidak', 'ketemu', 'kolom', 'page', 'perusahaan']",16,12,4,praktisi it bingung pakai linkedin tombol tekan tidak ketemu kolom page usaha,12,12
Mau login dipersulit makin aneh ini aplikasi linkedin,negatif,2024-08-30,2024,mau login dipersulit makin aneh ini aplikasi linkedin,8,8,mau login dipersulit makin aneh ini aplikasi linkedin,8,8,"['mau', 'login', 'dipersulit', 'makin', 'aneh', 'ini', 'aplikasi', 'linkedin']","['login', 'dipersulit', 'aneh', 'aplikasi', 'linkedin']",8,5,3,login sulit aneh aplikasi linkedin,5,5
Stelah di upgrade jadi keren tampilan nya dan mudah utk dapat pekerjaan,positif,2023-05-31,2023,stelah di upgrade jadi keren tampilan nya dan mudah utk dapat pekerjaan,12,12,setelah di upgrade jadi keren tampilan nya dan mudah untuk dapat pekerjaan,12,12,"['setelah', 'di', 'upgrade', 'jadi', 'keren', 'tampilan', 'nya', 'dan', 'mudah', 'untuk', 'dapat', 'pekerjaan']","['upgrade', 'keren', 'tampilan', 'nya', 'mudah', 'pekerjaan']",12,6,6,upgrade keren tampil nya mudah kerja,6,6
Sangat bermanfaat n membantu untuk mencari lowongan pekerjaan yg baik n bagus,positif,2021-01-31,2021,sangat bermanfaat n membantu untuk mencari lowongan pekerjaan yg baik n bagus,12,12,sangat bermanfaat dan membantu untuk mencari lowongan pekerjaan yang baik dan bagus,12,12,"['sangat', 'bermanfaat', 'dan', 'membantu', 'untuk', 'mencari', 'lowongan', 'pekerjaan', 'yang', 'baik', 'dan', 'bagus']","['bermanfaat', 'membantu', 'mencari', 'lowongan', 'pekerjaan', 'bagus']",12,6,6,manfaat bantu cari lowong kerja bagus,6,6
gua udah pakai aplikasi ini bagus banget media nya,positif,2024-08-21,2024,gua udah pakai aplikasi ini bagus banget media nya,9,9,saya sudah pakai aplikasi ini bagus banget media nya,9,9,"['saya', 'sudah', 'pakai', 'aplikasi', 'ini', 'bagus', 'banget', 'media', 'nya']","['pakai', 'aplikasi', 'bagus', 'banget', 'media', 'nya']",9,6,3,pakai aplikasi bagus banget media nya,6,6
"Kebanyakan verifikasi sulit bgt untuk masuk jgn ribet""",negatif,2024-08-17,2024,kebanyakan verifikasi sulit bgt untuk masuk jgn ribet,8,8,kebanyakan verifikasi sulit banget untuk masuk jangan rumit,8,8,"['kebanyakan', 'verifikasi', 'sulit', 'banget', 'untuk', 'masuk', 'jangan', 'rumit']","['kebanyakan', 'verifikasi', 'sulit', 'banget', 'masuk', 'rumit']",8,6,2,banyak verifikasi sulit banget masuk rumit,6,6
Respon lambat untuk verifikasi data. Kotak masuk email gak ada. Spam gak ada. Kurang CANGGIH server kalian,negatif,2024-01-15,2024,respon lambat untuk verifikasi data kotak masuk email gak ada spam gak ada kurang canggih server kalian,17,17,respons lambat untuk verifikasi data kotak masuk email tidak ada spam tidak ada kurang canggih server kalian,17,17,"['respons', 'lambat', 'untuk', 'verifikasi', 'data', 'kotak', 'masuk', 'email', 'tidak', 'ada', 'spam', 'tidak', 'ada', 'kurang', 'canggih', 'server', 'kalian']","['respons', 'lambat', 'verifikasi', 'data', 'kotak', 'masuk', 'email', 'tidak', 'spam', 'tidak', 'canggih', 'server']",17,12,5,respons lambat verifikasi data kotak masuk email tidak spam tidak canggih server,12,12
"Gabisa daftar baru ataupun login, gimana mau ngasih rating bagus",negatif,2021-06-30,2021,gabisa daftar baru ataupun login gimana mau ngasih rating bagus,10,10,tidak bisa daftar baru ataupun login bagaimana mau memberikan rating bagus,10,11,"['tidak', 'bisa', 'daftar', 'baru', 'ataupun', 'login', 'bagaimana', 'mau', 'memberikan', 'rating', 'bagus']","['tidak', 'daftar', 'login', 'rating', 'bagus']",11,5,6,tidak daftar login rating bagus,5,5
"Aplikasi sering crash, postingan tidak relevan dan amburadul",negatif,2023-10-15,2023,aplikasi sering crash postingan tidak relevan dan amburadul,8,8,aplikasi sering crash postingan tidak relevan dan amburadul,8,8,"['aplikasi', 'sering', 'crash', 'postingan', 'tidak', 'relevan', 'dan', 'amburadul']","['aplikasi', 'crash', 'postingan', 'tidak', 'relevan', 'amburadul']",8,6,2,aplikasi crash postingan tidak relevan amburadul,6,6
Masih bingung pengoperasiannya.terbiasa di app KitaLulus dan jobstreet... Lulusan SMA kok susah ya nyari loker di PT besar,negatif,2023-10-18,2023,masih bingung pengoperasiannya terbiasa di app kitalulus dan jobstreet lulusan sma kok susah ya nyari loker di pt besar,18,19,masih bingung pengoperasiannya terbiasa di aplikasi kitalulus dan jobstreet lulusan sama kok susah ya mencari loker di perseroan terbatas besar,19,20,"['masih', 'bingung', 'pengoperasiannya', 'terbiasa', 'di', 'aplikasi', 'kitalulus', 'dan', 'jobstreet', 'lulusan', 'sama', 'kok', 'susah', 'ya', 'mencari', 'loker', 'di', 'perseroan', 'terbatas', 'besar']","['bingung', 'pengoperasiannya', 'terbiasa', 'aplikasi', 'kitalulus', 'jobstreet', 'lulusan', 'susah', 'ya', 'mencari', 'loker', 'perseroan', 'terbatas']",20,13,7,bingung operasi biasa aplikasi kitalulus jobstreet lulus susah ya cari loker persero batas,13,13
Tiba-tiba tidak bisa log in. Dan menyatakan bahwa akun saya dinonaktifkan. Mohon penjelasannya,negatif,2020-03-01,2020,tiba tiba tidak bisa log in dan menyatakan bahwa akun saya dinonaktifkan mohon penjelasannya,13,14,tiba tiba tidak bisa log in dan menyatakan bahwa akun saya dinonaktifkan mohon penjelasannya,14,14,"['tiba', 'tiba', 'tidak', 'bisa', 'log', 'in', 'dan', 'menyatakan', 'bahwa', 'akun', 'saya', 'dinonaktifkan', 'mohon', 'penjelasannya']","['tidak', 'log', 'in', 'akun', 'dinonaktifkan', 'mohon', 'penjelasannya']",14,7,7,tidak log in akun nonaktif mohon jelas,7,7
"Akun saya kena hack dan menggunakan verifikasi 2 kali akun saya, sekarang saya tidak bisa membuka akun dan hacker telah membeli akun premium yang saya tidak bisa bayar",negatif,2023-08-24,2023,akun saya kena hack dan menggunakan verifikasi kali akun saya sekarang saya tidak bisa membuka akun dan hacker telah membeli akun premium yang saya tidak bisa bayar,28,27,akun saya kena hack dan menggunakan verifikasi kali akun saya sekarang saya tidak bisa membuka akun dan hacker telah membeli akun premium yang saya tidak bisa bayar,27,27,"['akun', 'saya', 'kena', 'hack', 'dan', 'menggunakan', 'verifikasi', 'kali', 'akun', 'saya', 'sekarang', 'saya', 'tidak', 'bisa', 'membuka', 'akun', 'dan', 'hacker', 'telah', 'membeli', 'akun', 'premium', 'yang', 'saya', 'tidak', 'bisa', 'bayar']","['akun', 'kena', 'hack', 'verifikasi', 'kali', 'akun', 'tidak', 'membuka', 'akun', 'hacker', 'membeli', 'akun', 'premium', 'tidak', 'bayar']",27,15,12,akun kena hack verifikasi kali akun tidak buka akun hacker beli akun premium tidak bayar,15,15
"Tidak hanya mencari pekerjaan, menemukan teman lama, mencari koneksi baru, namun membagi inspirasi",positif,2020-12-09,2020,tidak hanya mencari pekerjaan menemukan teman lama mencari koneksi baru namun membagi inspirasi,13,13,tidak hanya mencari pekerjaan menemukan teman lama mencari koneksi baru namun membagi inspirasi,13,13,"['tidak', 'hanya', 'mencari', 'pekerjaan', 'menemukan', 'teman', 'lama', 'mencari', 'koneksi', 'baru', 'namun', 'membagi', 'inspirasi']","['tidak', 'mencari', 'pekerjaan', 'menemukan', 'teman', 'mencari', 'koneksi', 'membagi', 'inspirasi']",13,9,4,tidak cari kerja temu teman cari koneksi bagi inspirasi,9,9
Dengan LinkedIn saya banyak terkoneksi dengan relasi/klien bisnis lama sy yg sudah hilang kontak.. Thanks LinkedIn !,positif,2020-12-06,2020,dengan linkedin saya banyak terkoneksi dengan relasi klien bisnis lama sy yg sudah hilang kontak thanks linkedin,17,17,dengan linkedin saya banyak terkoneksi dengan relasi klien bisnis lama saya yang sudah hilang kontak terima kasih linkedin,17,18,"['dengan', 'linkedin', 'saya', 'banyak', 'terkoneksi', 'dengan', 'relasi', 'klien', 'bisnis', 'lama', 'saya', 'yang', 'sudah', 'hilang', 'kontak', 'terima', 'kasih', 'linkedin']","['linkedin', 'terkoneksi', 'relasi', 'klien', 'bisnis', 'hilang', 'kontak', 'terima', 'kasih', 'linkedin']",18,10,8,linkedin koneksi relasi klien bisnis hilang kontak terima kasih linkedin,10,10
Login verfikasi gambar error berkali kali tolong diperbaiki,negatif,2024-01-14,2024,login verfikasi gambar error berkali kali tolong diperbaiki,8,8,login verfikasi gambar error berkali kali tolong di perbaiki,8,9,"['login', 'verfikasi', 'gambar', 'error', 'berkali', 'kali', 'tolong', 'di', 'perbaiki']","['login', 'verfikasi', 'gambar', 'error', 'berkali', 'kali', 'tolong', 'perbaiki']",9,8,1,login verfikasi gambar error kali kali tolong baik,8,8
saran untuk penempatan CV tolong tidak usa banyak2 tapi cukup bisa di perbaharui aja dan yang lama dengan outomatis terhapus,negatif,2022-01-17,2022,saran untuk penempatan cv tolong tidak usa banyak tapi cukup bisa di perbaharui aja dan yang lama dengan outomatis terhapus,20,20,saran untuk penempatan cv tolong tidak usah banyak tapi cukup bisa di perbaharui saja dan yang lama dengan outomatis terhapus,20,20,"['saran', 'untuk', 'penempatan', 'cv', 'tolong', 'tidak', 'usah', 'banyak', 'tapi', 'cukup', 'bisa', 'di', 'perbaharui', 'saja', 'dan', 'yang', 'lama', 'dengan', 'outomatis', 'terhapus']","['saran', 'penempatan', 'cv', 'tolong', 'tidak', 'perbaharui', 'outomatis', 'terhapus']",20,8,12,saran tempat cv tolong tidak baharu outomatis hapus,8,8
Sangat efektif untuk cari informasi pekerjaan dan informasi baru untuk tambah wawasan,positif,2020-10-11,2020,sangat efektif untuk cari informasi pekerjaan dan informasi baru untuk tambah wawasan,12,12,sangat efektif untuk cari informasi pekerjaan dan informasi baru untuk tambah wawasan,12,12,"['sangat', 'efektif', 'untuk', 'cari', 'informasi', 'pekerjaan', 'dan', 'informasi', 'baru', 'untuk', 'tambah', 'wawasan']","['efektif', 'cari', 'informasi', 'pekerjaan', 'informasi', 'wawasan']",12,6,6,efektif cari informasi kerja informasi wawas,6,6
"Captcha invalid, tetapi verifikasi security check succes, jadi tidak bisa login",negatif,2023-11-20,2023,captcha invalid tetapi verifikasi security check succes jadi tidak bisa login,11,11,captcha invalid tetapi verifikasi security cek success jadi tidak bisa login,11,11,"['captcha', 'invalid', 'tetapi', 'verifikasi', 'security', 'cek', 'success', 'jadi', 'tidak', 'bisa', 'login']","['captcha', 'invalid', 'verifikasi', 'security', 'cek', 'success', 'tidak', 'login']",11,8,3,captcha invalid verifikasi security cek success tidak login,8,8
Bagus jadi bisa ketemuan lewat LinkedIn Aman Nyaman... Luar biasa!!!,positif,2021-03-10,2021,bagus jadi bisa ketemuan lewat linkedin aman nyaman luar biasa,10,10,bagus jadi bisa ketemuan lewat linkedin aman nyaman luar biasa,10,10,"['bagus', 'jadi', 'bisa', 'ketemuan', 'lewat', 'linkedin', 'aman', 'nyaman', 'luar', 'biasa']","['bagus', 'ketemuan', 'linkedin', 'aman', 'nyaman']",10,5,5,bagus ketemu linkedin aman nyaman,5,5
aplikasi minta update pas di klik tetep aja ga bisa di buka tolong di fix problem nya min.,negatif,2020-08-13,2020,aplikasi minta update pas di klik tetep aja ga bisa di buka tolong di fix problem nya min,18,18,aplikasi minta diperbarui pas di klik tetap saja tidak bisa di buka tolong di fix masalah nya minimal,18,18,"['aplikasi', 'minta', 'diperbarui', 'pas', 'di', 'klik', 'tetap', 'saja', 'tidak', 'bisa', 'di', 'buka', 'tolong', 'di', 'fix', 'masalah', 'nya', 'minimal']","['aplikasi', 'diperbarui', 'pas', 'klik', 'tidak', 'buka', 'tolong', 'fix', 'nya', 'minimal']",18,10,8,aplikasi baru pas klik tidak buka tolong fix nya minimal,10,10
Sangat panjang dan bertele-tele dalam sign apply.. Harus buat akun di setiap web perusahaan ini itu hanya untuk melamar.,negatif,2021-03-23,2021,sangat panjang dan bertele tele dalam sign apply harus buat akun di setiap web perusahaan ini itu hanya untuk melamar,19,20,sangat panjang dan bertele tele dalam sign apply harus buat akun di setiap web perusahaan ini itu hanya untuk melamar,20,20,"['sangat', 'panjang', 'dan', 'bertele', 'tele', 'dalam', 'sign', 'apply', 'harus', 'buat', 'akun', 'di', 'setiap', 'web', 'perusahaan', 'ini', 'itu', 'hanya', 'untuk', 'melamar']","['bertele', 'tele', 'sign', 'apply', 'akun', 'web', 'perusahaan', 'melamar']",20,8,12,tele tele sign apply akun web usaha lamar,8,8
Tingkatkan terus performa agar lebih cepat dari biasanya 🥰 makasih atas info kerja nya kak 😍,positif,2023-08-28,2023,tingkatkan terus performa agar lebih cepat dari biasanya makasih atas info kerja nya kak,16,14,tingkatkan terus performa agar lebih cepat dari biasanya terima kasih atas informasi kerja nya kak,14,15,"['tingkatkan', 'terus', 'performa', 'agar', 'lebih', 'cepat', 'dari', 'biasanya', 'terima', 'kasih', 'atas', 'informasi', 'kerja', 'nya', 'kak']","['tingkatkan', 'performa', 'cepat', 'terima', 'kasih', 'informasi', 'kerja', 'nya', 'kak']",15,9,6,tingkat performa cepat terima kasih informasi kerja nya kak,9,9
"Telah mengajar bahasa Inggris lebih dari 30 tahun di Perhotelan dan kapal pesiar. Juga mengajar related hotel and cruise ship lessons. Assessor di LSP CKPNI untuk Kapal Pesiar, Kapsl Niaga dan Hotel sejak 2017 Bekerja di Holland America Line dari Nov 1978 - April 1986 sebagai Dinibgroom Steward Bekerja di beberapa hotel dan restoran di Jakarta sebelum join kapal HAL",positif,2024-07-24,2024,telah mengajar bahasa inggris lebih dari tahun di perhotelan dan kapal pesiar juga mengajar related hotel and cruise ship lessons assessor di lsp ckpni untuk kapal pesiar kapsl niaga dan hotel sejak bekerja di holland america line dari nov april sebagai dinibgroom steward bekerja di beberapa hotel dan restoran di jakarta sebelum join kapal hal,60,55,telah mengajar bahasa inggris lebih dari tahun di perhotelan dan kapal pesiar juga mengajar related hotel and cruise ship lessons assessor di lsp ckpni untuk kapal pesiar kapsl niaga dan hotel sejak bekerja di holland america line dari nov april sebagai dinibgroom steward bekerja di beberapa hotel dan restoran di jakarta sebelum join kapal hal,55,55,"['telah', 'mengajar', 'bahasa', 'inggris', 'lebih', 'dari', 'tahun', 'di', 'perhotelan', 'dan', 'kapal', 'pesiar', 'juga', 'mengajar', 'related', 'hotel', 'and', 'cruise', 'ship', 'lessons', 'assessor', 'di', 'lsp', 'ckpni', 'untuk', 'kapal', 'pesiar', 'kapsl', 'niaga', 'dan', 'hotel', 'sejak', 'bekerja', 'di', 'holland', 'america', 'line', 'dari', 'nov', 'april', 'sebagai', 'dinibgroom', 'steward', 'bekerja', 'di', 'beberapa', 'hotel', 'dan', 'restoran', 'di', 'jakarta', 'sebelum', 'join', 'kapal', 'hal']","['mengajar', 'bahasa', 'inggris', 'perhotelan', 'kapal', 'pesiar', 'mengajar', 'related', 'hotel', 'and', 'cruise', 'ship', 'lessons', 'assessor', 'lsp', 'ckpni', 'kapal', 'pesiar', 'kapsl', 'niaga', 'hotel', 'holland', 'america', 'line', 'nov', 'april', 'dinibgroom', 'steward', 'hotel', 'restoran', 'jakarta', 'join', 'kapal']",55,33,22,ajar bahasa inggris hotel kapal pesiar ajar related hotel and cruise ship lessons assessor lsp ckpni kapal pesiar kapsl niaga hotel holland america line nov april dinibgroom steward hotel restoran jakarta join kapal,33,33
"Nice..... recomend bngettttt buat semua pengguna, pasti bisa mengoprasikannya...",positif,2021-06-11,2021,nice recomend bngettttt buat semua pengguna pasti bisa mengoprasikannya,9,9,baik rekomendasi bngettttt buat semua pengguna pasti bisa mengoprasikannya,9,9,"['baik', 'rekomendasi', 'bngettttt', 'buat', 'semua', 'pengguna', 'pasti', 'bisa', 'mengoprasikannya']","['rekomendasi', 'bngettttt', 'pengguna', 'mengoprasikannya']",9,4,5,rekomendasi bngettttt guna mengoprasikannya,4,4
Itu verifikasi ampe selusin kenapa ga bisa kedetect juga. Capek verifikasi manusianya anjir.,negatif,2023-05-29,2023,itu verifikasi ampe selusin kenapa ga bisa kedetect juga capek verifikasi manusianya anjir,13,13,itu verifikasi sampai selusin kenapa tidak bisa kedetect juga capek verifikasi manusianya anjir,13,13,"['itu', 'verifikasi', 'sampai', 'selusin', 'kenapa', 'tidak', 'bisa', 'kedetect', 'juga', 'capek', 'verifikasi', 'manusianya', 'anjir']","['verifikasi', 'selusin', 'tidak', 'kedetect', 'capek', 'verifikasi', 'manusianya', 'anjir']",13,8,5,verifikasi lusin tidak kedetect capek verifikasi manusia anjir,8,8
Mengecewakan! Gak bisa masuk cuman klik gambar gak jelas terus sampai sukses!,negatif,2021-01-31,2021,mengecewakan gak bisa masuk cuman klik gambar gak jelas terus sampai sukses,12,12,mengecewakan tidak bisa masuk cuman klik gambar tidak jelas terus sampai sukses,12,12,"['mengecewakan', 'tidak', 'bisa', 'masuk', 'cuman', 'klik', 'gambar', 'tidak', 'jelas', 'terus', 'sampai', 'sukses']","['mengecewakan', 'tidak', 'masuk', 'cuman', 'klik', 'gambar', 'tidak', 'sukses']",12,8,4,kecewa tidak masuk cuman klik gambar tidak sukses,8,8
"verifikasi untuk daftar pengguna baru sangat sulit, saya udah coba berulang kali tetep jawaban saya salah. maaf saya bintang 1 ya, makasih.",negatif,2021-10-27,2021,verifikasi untuk daftar pengguna baru sangat sulit saya udah coba berulang kali tetep jawaban saya salah maaf saya bintang ya makasih,22,21,verifikasi untuk daftar pengguna baru sangat sulit saya sudah coba berulang kali tetap jawaban saya salah maaf saya bintang ya terima kasih,21,22,"['verifikasi', 'untuk', 'daftar', 'pengguna', 'baru', 'sangat', 'sulit', 'saya', 'sudah', 'coba', 'berulang', 'kali', 'tetap', 'jawaban', 'saya', 'salah', 'maaf', 'saya', 'bintang', 'ya', 'terima', 'kasih']","['verifikasi', 'daftar', 'pengguna', 'sulit', 'coba', 'berulang', 'kali', 'salah', 'maaf', 'bintang', 'ya', 'terima', 'kasih']",22,13,9,verifikasi daftar guna sulit coba ulang kali salah maaf bintang ya terima kasih,13,13
Kenapa Aplikasi saya gak bisa di buka. Keterangannya kesalahan jaringan. Aneh banget,negatif,2022-11-23,2022,kenapa aplikasi saya gak bisa di buka keterangannya kesalahan jaringan aneh banget,12,12,kenapa aplikasi saya tidak bisa di buka keterangannya kesalahan jaringan aneh banget,12,12,"['kenapa', 'aplikasi', 'saya', 'tidak', 'bisa', 'di', 'buka', 'keterangannya', 'kesalahan', 'jaringan', 'aneh', 'banget']","['aplikasi', 'tidak', 'buka', 'keterangannya', 'kesalahan', 'jaringan', 'aneh', 'banget']",12,8,4,aplikasi tidak buka terang salah jaring aneh banget,8,8
Susah banget login nya Tebak gambar sedangkan gambarnya sndiri ga jelas.kaya aplikasinya ga jelas banget awokwok,negatif,2023-08-05,2023,susah banget login nya tebak gambar sedangkan gambarnya sndiri ga jelas kaya aplikasinya ga jelas banget awokwok,16,17,susah banget login nya tebak gambar sedangkan gambarnya sendiri tidak jelas kayak aplikasi nya tidak jelas banget awokwok,17,18,"['susah', 'banget', 'login', 'nya', 'tebak', 'gambar', 'sedangkan', 'gambarnya', 'sendiri', 'tidak', 'jelas', 'kayak', 'aplikasi', 'nya', 'tidak', 'jelas', 'banget', 'awokwok']","['susah', 'banget', 'login', 'nya', 'tebak', 'gambar', 'gambarnya', 'tidak', 'kayak', 'aplikasi', 'nya', 'tidak', 'banget', 'awokwok']",18,14,4,susah banget login nya tebak gambar gambar tidak kayak aplikasi nya tidak banget awokwok,14,14
"Akun dibatasi, alasan kebijakan. Yang lain posting ok ok aja sy lihat. Ga pake LinkedIn jg no problem",negatif,2024-05-22,2024,akun dibatasi alasan kebijakan yang lain posting ok ok aja sy lihat ga pake linkedin jg no problem,18,18,akun dibatasi alasan kebijakan yang lain posting oke oke saja saya lihat tidak pakai linkedin juga nomor masalah,18,18,"['akun', 'dibatasi', 'alasan', 'kebijakan', 'yang', 'lain', 'posting', 'oke', 'oke', 'saja', 'saya', 'lihat', 'tidak', 'pakai', 'linkedin', 'juga', 'nomor', 'masalah']","['akun', 'dibatasi', 'alasan', 'kebijakan', 'posting', 'oke', 'oke', 'lihat', 'tidak', 'pakai', 'linkedin', 'nomor']",18,12,6,akun batas alas bijak posting oke oke lihat tidak pakai linkedin nomor,12,12
Kenapa saya instal di Android tab A8 dengan sistem Lolipop tidak bisa ... atau memang Linkedin sudah tidak support lolipop,negatif,2020-08-23,2020,kenapa saya instal di android tab a dengan sistem lolipop tidak bisa atau memang linkedin sudah tidak support lolipop,20,19,kenapa saya memasang di android tab a dengan sistem lolipop tidak bisa atau memang linkedin sudah tidak support lolipop,19,19,"['kenapa', 'saya', 'memasang', 'di', 'android', 'tab', 'a', 'dengan', 'sistem', 'lolipop', 'tidak', 'bisa', 'atau', 'memang', 'linkedin', 'sudah', 'tidak', 'support', 'lolipop']","['memasang', 'android', 'tab', 'a', 'sistem', 'lolipop', 'tidak', 'linkedin', 'tidak', 'support', 'lolipop']",19,11,8,pasang android tab a sistem lolipop tidak linkedin tidak support lolipop,11,11
"Ini recapta yg bener aja anjir, emosi bgt diulang2 terus 30 menit tetep blm masuk masuk. Jadi males buka",negatif,2024-01-03,2024,ini recapta yg bener aja anjir emosi bgt diulang terus menit tetep blm masuk masuk jadi males buka,19,18,ini recapta yang benar saja anjir emosi banget diulang terus menit tetap belum masuk masuk jadi malas buka,18,18,"['ini', 'recapta', 'yang', 'benar', 'saja', 'anjir', 'emosi', 'banget', 'diulang', 'terus', 'menit', 'tetap', 'belum', 'masuk', 'masuk', 'jadi', 'malas', 'buka']","['recapta', 'anjir', 'emosi', 'banget', 'diulang', 'menit', 'masuk', 'masuk', 'malas', 'buka']",18,10,8,recapta anjir emosi banget ulang menit masuk masuk malas buka,10,10
Semangat ..luar biasa dg aplikasi ini sangat mbantu support untuk saya dan semuanya,positif,2022-07-25,2022,semangat luar biasa dg aplikasi ini sangat mbantu support untuk saya dan semuanya,13,13,semangat luar biasa dengan aplikasi ini sangat mbantu support untuk saya dan semuanya,13,13,"['semangat', 'luar', 'biasa', 'dengan', 'aplikasi', 'ini', 'sangat', 'mbantu', 'support', 'untuk', 'saya', 'dan', 'semuanya']","['semangat', 'aplikasi', 'mbantu', 'support']",13,4,9,semangat aplikasi mbantu support,4,4
Dasar aplikasi aneh mau masuk di persulit sama verifikasi nya sendiri,negatif,2023-04-25,2023,dasar aplikasi aneh mau masuk di persulit sama verifikasi nya sendiri,11,11,dasar aplikasi aneh mau masuk di persulit sama verifikasi nya sendiri,11,11,"['dasar', 'aplikasi', 'aneh', 'mau', 'masuk', 'di', 'persulit', 'sama', 'verifikasi', 'nya', 'sendiri']","['dasar', 'aplikasi', 'aneh', 'masuk', 'persulit', 'verifikasi', 'nya']",11,7,4,dasar aplikasi aneh masuk sulit verifikasi nya,7,7
"Terimakasih linkedin sudah memudahkan para pengguna dalam mencari informasi, sukses selalu 🥰",positif,2023-10-06,2023,terimakasih linkedin sudah memudahkan para pengguna dalam mencari informasi sukses selalu,12,11,terima kasih linkedin sudah memudahkan para pengguna dalam mencari informasi sukses selalu,11,12,"['terima', 'kasih', 'linkedin', 'sudah', 'memudahkan', 'para', 'pengguna', 'dalam', 'mencari', 'informasi', 'sukses', 'selalu']","['terima', 'kasih', 'linkedin', 'memudahkan', 'pengguna', 'mencari', 'informasi', 'sukses']",12,8,4,terima kasih linkedin mudah guna cari informasi sukses,8,8
"Verifikasi capcha nya error terus, padahal udah benar ngisinya",negatif,2023-05-20,2023,verifikasi capcha nya error terus padahal udah benar ngisinya,9,9,verifikasi capcha nya error terus padahal sudah benar ngisinya,9,9,"['verifikasi', 'capcha', 'nya', 'error', 'terus', 'padahal', 'sudah', 'benar', 'ngisinya']","['verifikasi', 'capcha', 'nya', 'error', 'ngisinya']",9,5,4,verifikasi capcha nya error ngisinya,5,5
"Tidak bisa masuk, stak di teka-teki.. Padahal sudah jawab bener tapi balik lagi",negatif,2023-08-22,2023,tidak bisa masuk stak di teka teki padahal sudah jawab bener tapi balik lagi,13,14,tidak bisa masuk stak di teka teki padahal sudah jawab benar tapi balik lagi,14,14,"['tidak', 'bisa', 'masuk', 'stak', 'di', 'teka', 'teki', 'padahal', 'sudah', 'jawab', 'benar', 'tapi', 'balik', 'lagi']","['tidak', 'masuk', 'stak', 'teka', 'teki']",14,5,9,tidak masuk stak teka teki,5,5
Sangat membantu dalam mencari pekerjaan dan menambah relasi,positif,2024-01-16,2024,sangat membantu dalam mencari pekerjaan dan menambah relasi,8,8,sangat membantu dalam mencari pekerjaan dan menambah relasi,8,8,"['sangat', 'membantu', 'dalam', 'mencari', 'pekerjaan', 'dan', 'menambah', 'relasi']","['membantu', 'mencari', 'pekerjaan', 'menambah', 'relasi']",8,5,3,bantu cari kerja tambah relasi,5,5
Aplikasi yang bagus dan sangat nermanfaat untuk menjalin hubungan pertemanan dibidang pekerjaan maupun lainnya,positif,2020-10-11,2020,aplikasi yang bagus dan sangat nermanfaat untuk menjalin hubungan pertemanan dibidang pekerjaan maupun lainnya,14,14,aplikasi yang bagus dan sangat nermanfaat untuk menjalin hubungan pertemanan dibidang pekerjaan maupun lainnya,14,14,"['aplikasi', 'yang', 'bagus', 'dan', 'sangat', 'nermanfaat', 'untuk', 'menjalin', 'hubungan', 'pertemanan', 'dibidang', 'pekerjaan', 'maupun', 'lainnya']","['aplikasi', 'bagus', 'nermanfaat', 'menjalin', 'hubungan', 'pertemanan', 'dibidang', 'pekerjaan']",14,8,6,aplikasi bagus nermanfaat jalin hubung teman bidang kerja,8,8
Aplikasi bagus buat para pekerja menjalin relasi dan mendapatkan pekerjaan.,positif,2022-07-18,2022,aplikasi bagus buat para pekerja menjalin relasi dan mendapatkan pekerjaan,10,10,aplikasi bagus buat para yang kerja menjalin relasi dan mendapatkan pekerjaan,10,11,"['aplikasi', 'bagus', 'buat', 'para', 'yang', 'kerja', 'menjalin', 'relasi', 'dan', 'mendapatkan', 'pekerjaan']","['aplikasi', 'bagus', 'kerja', 'menjalin', 'relasi', 'pekerjaan']",11,6,5,aplikasi bagus kerja jalin relasi kerja,6,6
"aplikasi ga gunaa, mau login aja di persulitt pake teka teki ga jelasss, aplikasi ini bukan nya ngebantu malah nambah beban oranggg",negatif,2024-05-13,2024,aplikasi ga gunaa mau login aja di persulitt pake teka teki ga jelasss aplikasi ini bukan nya ngebantu malah nambah beban oranggg,22,22,aplikasi tidak gunaa mau login saja di persulitt pakai teka teki tidak jelasss aplikasi ini bukan nya membantu bahkan nambah beban oranggg,22,22,"['aplikasi', 'tidak', 'gunaa', 'mau', 'login', 'saja', 'di', 'persulitt', 'pakai', 'teka', 'teki', 'tidak', 'jelasss', 'aplikasi', 'ini', 'bukan', 'nya', 'membantu', 'bahkan', 'nambah', 'beban', 'oranggg']","['aplikasi', 'tidak', 'gunaa', 'login', 'persulitt', 'pakai', 'teka', 'teki', 'tidak', 'jelasss', 'aplikasi', 'nya', 'membantu', 'nambah', 'beban', 'oranggg']",22,16,6,aplikasi tidak gunaa login persulitt pakai teka teki tidak jelasss aplikasi nya bantu nambah beban oranggg,16,16
Aplikasi yang bagus kita bisa berteman dengan orang orang kantoran sekaligus mencari lowongan kerja kalau kita memebutuhkannya,positif,2023-08-13,2023,aplikasi yang bagus kita bisa berteman dengan orang orang kantoran sekaligus mencari lowongan kerja kalau kita memebutuhkannya,17,17,aplikasi yang bagus kita bisa berteman dengan orang orang kantoran sekaligus mencari lowongan kerja kalau kita memebutuhkannya,17,17,"['aplikasi', 'yang', 'bagus', 'kita', 'bisa', 'berteman', 'dengan', 'orang', 'orang', 'kantoran', 'sekaligus', 'mencari', 'lowongan', 'kerja', 'kalau', 'kita', 'memebutuhkannya']","['aplikasi', 'bagus', 'berteman', 'orang', 'orang', 'kantoran', 'mencari', 'lowongan', 'kerja', 'memebutuhkannya']",17,10,7,aplikasi bagus teman orang orang kantor cari lowong kerja butuh,10,10
"Terimakasih untuk platform LinkedIn yang telah membantu saya dalam memperoleh work experience, knowledge and relation.",positif,2023-09-24,2023,terimakasih untuk platform linkedin yang telah membantu saya dalam memperoleh work experience knowledge and relation,15,15,terima kasih untuk platform linkedin yang telah membantu saya dalam memperoleh work experience knowledge and relation,15,16,"['terima', 'kasih', 'untuk', 'platform', 'linkedin', 'yang', 'telah', 'membantu', 'saya', 'dalam', 'memperoleh', 'work', 'experience', 'knowledge', 'and', 'relation']","['terima', 'kasih', 'platform', 'linkedin', 'membantu', 'memperoleh', 'work', 'experience', 'knowledge', 'and', 'relation']",16,11,5,terima kasih platform linkedin bantu oleh work experience knowledge and relation,11,11
Verifikasi login udah bner tp suruh ngulang trs. Aplikasi gak jelas ini. Gk prnh diurus sama developernya,negatif,2023-08-15,2023,verifikasi login udah bner tp suruh ngulang trs aplikasi gak jelas ini gk prnh diurus sama developernya,17,17,verifikasi login sudah bner tapi suruh mengulang terus aplikasi tidak jelas ini tidak pernah diurus sama developernya,17,17,"['verifikasi', 'login', 'sudah', 'bner', 'tapi', 'suruh', 'mengulang', 'terus', 'aplikasi', 'tidak', 'jelas', 'ini', 'tidak', 'pernah', 'diurus', 'sama', 'developernya']","['verifikasi', 'login', 'bner', 'suruh', 'mengulang', 'aplikasi', 'tidak', 'tidak', 'diurus', 'developernya']",17,10,7,verifikasi login bner suruh ulang aplikasi tidak tidak urus developer,10,10
"Untuk log in susah sekali, verifikasi yang terus berulang-ulang",negatif,2023-09-29,2023,untuk log in susah sekali verifikasi yang terus berulang ulang,9,10,untuk log in susah sekali verifikasi yang terus berulang ulang,10,10,"['untuk', 'log', 'in', 'susah', 'sekali', 'verifikasi', 'yang', 'terus', 'berulang', 'ulang']","['log', 'in', 'susah', 'verifikasi', 'berulang', 'ulang']",10,6,4,log in susah verifikasi ulang ulang,6,6
"Aplikasi makin gak jelas , Verifikasi lawak .. lucu asli ini aplikasi makin aneh",negatif,2023-08-10,2023,aplikasi makin gak jelas verifikasi lawak lucu asli ini aplikasi makin aneh,14,12,aplikasi makin tidak jelas verifikasi lawak lucu asli ini aplikasi makin aneh,12,12,"['aplikasi', 'makin', 'tidak', 'jelas', 'verifikasi', 'lawak', 'lucu', 'asli', 'ini', 'aplikasi', 'makin', 'aneh']","['aplikasi', 'tidak', 'verifikasi', 'lawak', 'lucu', 'asli', 'aplikasi', 'aneh']",12,8,4,aplikasi tidak verifikasi lawak lucu asli aplikasi aneh,8,8
Apk nie sangat membantu yg ingin mencari pekerjaan nya apa lagi skrg cari kerja susah,positif,2021-12-11,2021,apk nie sangat membantu yg ingin mencari pekerjaan nya apa lagi skrg cari kerja susah,15,15,aplikasi nie sangat membantu yang ingin mencari pekerjaan nya apa lagi sekarang cari kerja susah,15,15,"['aplikasi', 'nie', 'sangat', 'membantu', 'yang', 'ingin', 'mencari', 'pekerjaan', 'nya', 'apa', 'lagi', 'sekarang', 'cari', 'kerja', 'susah']","['aplikasi', 'nie', 'membantu', 'mencari', 'pekerjaan', 'nya', 'cari', 'kerja', 'susah']",15,9,6,aplikasi nie bantu cari kerja nya cari kerja susah,9,9
Sangat sulit untuk masuk log in . Selalu kembali ke menu utama,negatif,2024-01-15,2024,sangat sulit untuk masuk log in selalu kembali ke menu utama,12,11,sangat sulit untuk masuk log in selalu kembali ke menu utama,11,11,"['sangat', 'sulit', 'untuk', 'masuk', 'log', 'in', 'selalu', 'kembali', 'ke', 'menu', 'utama']","['sulit', 'masuk', 'log', 'in', 'menu', 'utama']",11,6,5,sulit masuk log in menu utama,6,6
aplikasi ini sanggat bagus dan aplikasi ini mempermudah untuk mendapatkan informasi tentang lowongan pekerjaan,positif,2023-07-20,2023,aplikasi ini sanggat bagus dan aplikasi ini mempermudah untuk mendapatkan informasi tentang lowongan pekerjaan,14,14,aplikasi ini sanggat bagus dan aplikasi ini mempermudah untuk mendapatkan informasi tentang lowongan pekerjaan,14,14,"['aplikasi', 'ini', 'sanggat', 'bagus', 'dan', 'aplikasi', 'ini', 'mempermudah', 'untuk', 'mendapatkan', 'informasi', 'tentang', 'lowongan', 'pekerjaan']","['aplikasi', 'sanggat', 'bagus', 'aplikasi', 'mempermudah', 'informasi', 'lowongan', 'pekerjaan']",14,8,6,aplikasi sanggat bagus aplikasi mudah informasi lowong kerja,8,8
"Hadeeeeeh, LinkedIn masalah terooooss.. gk bisa update newsfeed... huuuuuu...",negatif,2021-01-07,2021,hadeeeeeh linkedin masalah terooooss gk bisa update newsfeed huuuuuu,9,9,hadeeeeeh linkedin masalah terooooss tidak bisa diperbarui newsfeed huuuuuu,9,9,"['hadeeeeeh', 'linkedin', 'masalah', 'terooooss', 'tidak', 'bisa', 'diperbarui', 'newsfeed', 'huuuuuu']","['hadeeeeeh', 'linkedin', 'terooooss', 'tidak', 'diperbarui', 'newsfeed', 'huuuuuu']",9,7,2,hadeeeeeh linkedin terooooss tidak baru newsfeed huuuuuu,7,7
"Mau log in kok susah amat siiih.. bolak balik terus gagal terus, heran deh.",negatif,2021-09-22,2021,mau log in kok susah amat siiih bolak balik terus gagal terus heran deh,14,14,mau log in kok susah amat siiih bolak balik terus gagal terus heran deh,14,14,"['mau', 'log', 'in', 'kok', 'susah', 'amat', 'siiih', 'bolak', 'balik', 'terus', 'gagal', 'terus', 'heran', 'deh']","['log', 'in', 'susah', 'siiih', 'bolak', 'gagal', 'heran', 'deh']",14,8,6,log in susah siiih bolak gagal heran deh,8,8
"Ingin hapus download selalu gagal, ada yang bisa bantu hapus aplikasi ini dari perangkat hp saya. Tolong..🙏",negatif,2023-05-24,2023,ingin hapus download selalu gagal ada yang bisa bantu hapus aplikasi ini dari perangkat hp saya tolong,17,17,ingin hapus unduh selalu gagal ada yang bisa bantu hapus aplikasi ini dari perangkat handphone saya tolong,17,17,"['ingin', 'hapus', 'unduh', 'selalu', 'gagal', 'ada', 'yang', 'bisa', 'bantu', 'hapus', 'aplikasi', 'ini', 'dari', 'perangkat', 'handphone', 'saya', 'tolong']","['hapus', 'unduh', 'gagal', 'bantu', 'hapus', 'aplikasi', 'perangkat', 'handphone', 'tolong']",17,9,8,hapus unduh gagal bantu hapus aplikasi perangkat handphone tolong,9,9
Sudah bagus sekali. Tapi jangan lupa ada loker yang cocok buat yang cita-citanya menjadi penulis seperti saya.,positif,2021-03-12,2021,sudah bagus sekali tapi jangan lupa ada loker yang cocok buat yang cita citanya menjadi penulis seperti saya,17,18,sudah bagus sekali tapi jangan lupa ada loker yang cocok buat yang cita citanya menjadi penulis seperti saya,18,18,"['sudah', 'bagus', 'sekali', 'tapi', 'jangan', 'lupa', 'ada', 'loker', 'yang', 'cocok', 'buat', 'yang', 'cita', 'citanya', 'menjadi', 'penulis', 'seperti', 'saya']","['bagus', 'lupa', 'loker', 'cocok', 'cita', 'citanya', 'penulis']",18,7,11,bagus lupa loker cocok cita cita tulis,7,7
Aplikasi terbaik bagi pencari pekerjaan serta berbagiinformasi tentang pekerjaan.,positif,2021-12-27,2021,aplikasi terbaik bagi pencari pekerjaan serta berbagiinformasi tentang pekerjaan,9,9,aplikasi terbaik bagi pencari pekerjaan serta berbagiinformasi tentang pekerjaan,9,9,"['aplikasi', 'terbaik', 'bagi', 'pencari', 'pekerjaan', 'serta', 'berbagiinformasi', 'tentang', 'pekerjaan']","['aplikasi', 'terbaik', 'pencari', 'pekerjaan', 'berbagiinformasi', 'pekerjaan']",9,6,3,aplikasi baik cari kerja berbagiinformasi kerja,6,6
Masa kemarin lancar-lancar aja besok nya di suruh login dengan metode yang rumit banget!!!,negatif,2023-10-26,2023,masa kemarin lancar lancar aja besok nya di suruh login dengan metode yang rumit banget,14,15,masa kemarin lancar lancar saja besok nya di suruh login dengan metode yang rumit banget,15,15,"['masa', 'kemarin', 'lancar', 'lancar', 'saja', 'besok', 'nya', 'di', 'suruh', 'login', 'dengan', 'metode', 'yang', 'rumit', 'banget']","['kemarin', 'lancar', 'lancar', 'besok', 'nya', 'suruh', 'login', 'metode', 'rumit', 'banget']",15,10,5,kemarin lancar lancar besok nya suruh login metode rumit banget,10,10
"Begitulah, ribet sebenarnya ada benyak perekrut di sini, kode OTP tidak begitu berfungsi",negatif,2023-08-10,2023,begitulah ribet sebenarnya ada benyak perekrut di sini kode otp tidak begitu berfungsi,13,13,begitulah rumit sebenarnya ada benyak perekrut di sini kode one time password tidak begitu berfungsi,13,15,"['begitulah', 'rumit', 'sebenarnya', 'ada', 'benyak', 'perekrut', 'di', 'sini', 'kode', 'one', 'time', 'password', 'tidak', 'begitu', 'berfungsi']","['rumit', 'benyak', 'perekrut', 'kode', 'one', 'time', 'password', 'tidak', 'berfungsi']",15,9,6,rumit benyak rekrut kode one time password tidak fungsi,9,9
Apk ini sangat baik dan bermanfaat sekali,positif,2024-04-13,2024,apk ini sangat baik dan bermanfaat sekali,7,7,aplikasi ini sangat baik dan bermanfaat sekali,7,7,"['aplikasi', 'ini', 'sangat', 'baik', 'dan', 'bermanfaat', 'sekali']","['aplikasi', 'bermanfaat']",7,2,5,aplikasi manfaat,2,2
semoga nanti pas uda kerja linkedln nya bisa kayak orang² yang inspiratif,positif,2024-06-01,2024,semoga nanti pas uda kerja linkedln nya bisa kayak orang² yang inspiratif,12,12,semoga nanti pas sudah kerja linkedln nya bisa kayak orang² yang inspiratif,12,12,"['semoga', 'nanti', 'pas', 'sudah', 'kerja', 'linkedln', 'nya', 'bisa', 'kayak', 'orang²', 'yang', 'inspiratif']","['semoga', 'pas', 'kerja', 'linkedln', 'nya', 'kayak', 'orang²', 'inspiratif']",12,8,4,moga pas kerja linkedln nya kayak orang inspiratif,8,8
LinkedIn selalu memberikan informasi,positif,2024-04-28,2024,linkedin selalu memberikan informasi,4,4,linkedin selalu memberikan informasi,4,4,"['linkedin', 'selalu', 'memberikan', 'informasi']","['linkedin', 'informasi']",4,2,2,linkedin informasi,2,2
Good Saran aja kalau verifikasi ke mode suara saja lebih mudah dari pada gambar,positif,2022-01-15,2022,good saran aja kalau verifikasi ke mode suara saja lebih mudah dari pada gambar,14,14,bagus saran saja kalau verifikasi ke mode suara saja lebih mudah dari pada gambar,14,14,"['bagus', 'saran', 'saja', 'kalau', 'verifikasi', 'ke', 'mode', 'suara', 'saja', 'lebih', 'mudah', 'dari', 'pada', 'gambar']","['bagus', 'saran', 'verifikasi', 'mode', 'suara', 'mudah', 'gambar']",14,7,7,bagus saran verifikasi mode suara mudah gambar,7,7
"Alhamdulillah, nice app, terimakasih banyak. Semoga berkah",positif,2024-04-18,2024,alhamdulillah nice app terimakasih banyak semoga berkah,7,7,alhamdulillah baik aplikasi terima kasih banyak semoga berkah,7,8,"['alhamdulillah', 'baik', 'aplikasi', 'terima', 'kasih', 'banyak', 'semoga', 'berkah']","['alhamdulillah', 'aplikasi', 'terima', 'kasih', 'semoga', 'berkah']",8,6,2,alhamdulillah aplikasi terima kasih moga berkah,6,6
Tidak bisa login,negatif,2024-05-17,2024,tidak bisa login,3,3,tidak bisa login,3,3,"['tidak', 'bisa', 'login']","['tidak', 'login']",3,2,1,tidak login,2,2
LinkedIn Aplikasi Terbaik 💯,positif,2024-05-12,2024,linkedin aplikasi terbaik,4,3,linkedin aplikasi terbaik,3,3,"['linkedin', 'aplikasi', 'terbaik']","['linkedin', 'aplikasi', 'terbaik']",3,3,0,linkedin aplikasi baik,3,3
"Verifikasi nya ngaco, milih udh bener tetep salah. Milih yg salah malah bener",negatif,2024-04-19,2024,verifikasi nya ngaco milih udh bener tetep salah milih yg salah malah bener,13,13,verifikasi nya ngaco memilih sudah benar tetap salah memilih yang salah bahkan benar,13,13,"['verifikasi', 'nya', 'ngaco', 'memilih', 'sudah', 'benar', 'tetap', 'salah', 'memilih', 'yang', 'salah', 'bahkan', 'benar']","['verifikasi', 'nya', 'ngaco', 'memilih', 'salah', 'memilih', 'salah']",13,7,6,verifikasi nya ngaco pilih salah pilih salah,7,7
Apk gak jelas mau login aja dicek scurity apa lah ribetin,negatif,2024-03-24,2024,apk gak jelas mau login aja dicek scurity apa lah ribetin,11,11,aplikasi tidak jelas mau login saja dicek scurity apa lah ribetin,11,11,"['aplikasi', 'tidak', 'jelas', 'mau', 'login', 'saja', 'dicek', 'scurity', 'apa', 'lah', 'ribetin']","['aplikasi', 'tidak', 'login', 'dicek', 'scurity', 'ribetin']",11,6,5,aplikasi tidak login cek scurity ribetin,6,6
"Mantap,buat cari kerja👍",positif,2024-04-24,2024,mantap buat cari kerja,3,4,mantap buat cari kerja,4,4,"['mantap', 'buat', 'cari', 'kerja']","['mantap', 'cari', 'kerja']",4,3,1,mantap cari kerja,3,3
"Aplikasi kurang kerjaan,, bukan aplikasi lowongan pekerjaan.....",negatif,2021-02-18,2021,aplikasi kurang kerjaan bukan aplikasi lowongan pekerjaan,7,7,aplikasi kurang kerjaan bukan aplikasi lowongan pekerjaan,7,7,"['aplikasi', 'kurang', 'kerjaan', 'bukan', 'aplikasi', 'lowongan', 'pekerjaan']","['aplikasi', 'kerjaan', 'aplikasi', 'lowongan', 'pekerjaan']",7,5,2,aplikasi kerja aplikasi lowong kerja,5,5
Diupdate malah gak bisa lamar,negatif,2024-05-12,2024,diupdate malah gak bisa lamar,5,5,di perbarui bahkan tidak bisa lamar,5,6,"['di', 'perbarui', 'bahkan', 'tidak', 'bisa', 'lamar']","['perbarui', 'tidak', 'lamar']",6,3,3,baru tidak lamar,3,3
Susah bangett masuk ke aplikasi,negatif,2024-04-26,2024,susah bangett masuk ke aplikasi,5,5,susah banget masuk ke aplikasi,5,5,"['susah', 'banget', 'masuk', 'ke', 'aplikasi']","['susah', 'banget', 'masuk', 'aplikasi']",5,4,1,susah banget masuk aplikasi,4,4
"Enak nich aplikasi ,sangat membantu",positif,2024-05-09,2024,enak nich aplikasi sangat membantu,5,5,enak nich aplikasi sangat membantu,5,5,"['enak', 'nich', 'aplikasi', 'sangat', 'membantu']","['enak', 'nich', 'aplikasi', 'membantu']",5,4,1,enak nich aplikasi bantu,4,4
Agar saya coba akun demo tapi cuma ada nomor hape ini molai dari nol posting tetap,negatif,2024-06-04,2024,agar saya coba akun demo tapi cuma ada nomor hape ini molai dari nol posting tetap,16,16,agar saya coba akun demo tapi cuma ada nomor hape ini molai dari nol posting tetap,16,16,"['agar', 'saya', 'coba', 'akun', 'demo', 'tapi', 'cuma', 'ada', 'nomor', 'hape', 'ini', 'molai', 'dari', 'nol', 'posting', 'tetap']","['coba', 'akun', 'demo', 'nomor', 'hape', 'molai', 'nol', 'posting']",16,8,8,coba akun demo nomor hape mola nol posting,8,8
SUMPAH KALO BISA KASIH RATE 0 BINTANG BAKALAN KU KASIH NOL. DARI DULU TIAP LOGIN SUSAH BANGET VERIFIKASINYA NGULANG MULU. TERUS PAS UDAH LOGIN BEBERAPA HARI KEMUDIAN TIBA2 AKUNKU DI BATASI.,negatif,2024-04-14,2024,sumpah kalo bisa kasih rate bintang bakalan ku kasih nol dari dulu tiap login susah banget verifikasinya ngulang mulu terus pas udah login beberapa hari kemudian tiba akunku di batasi,31,30,sumpah kalau bisa kasih rate bintang bakalan saya kasih nol dari dahulu tiap login susah banget verifikasinya mengulang mulu terus pas sudah login beberapa hari kemudian tiba akunku di batasi,30,30,"['sumpah', 'kalau', 'bisa', 'kasih', 'rate', 'bintang', 'bakalan', 'saya', 'kasih', 'nol', 'dari', 'dahulu', 'tiap', 'login', 'susah', 'banget', 'verifikasinya', 'mengulang', 'mulu', 'terus', 'pas', 'sudah', 'login', 'beberapa', 'hari', 'kemudian', 'tiba', 'akunku', 'di', 'batasi']","['sumpah', 'kasih', 'rate', 'bintang', 'kasih', 'nol', 'login', 'susah', 'banget', 'verifikasinya', 'mengulang', 'mulu', 'pas', 'login', 'akunku', 'batasi']",30,16,14,sumpah kasih rate bintang kasih nol login susah banget verifikasi ulang mulu pas login akun batas,16,16
aplikasi ini berguna banget buat aku soalnya waktu ujian aku butuh banget aplikasi ini 5 bintang buatbaplikasi iniii,positif,2020-11-28,2020,aplikasi ini berguna banget buat aku soalnya waktu ujian aku butuh banget aplikasi ini bintang buatbaplikasi iniii,18,17,aplikasi ini berguna banget buat aku soalnya waktu ujian aku butuh banget aplikasi ini bintang buatbaplikasi iniii,17,17,"['aplikasi', 'ini', 'berguna', 'banget', 'buat', 'aku', 'soalnya', 'waktu', 'ujian', 'aku', 'butuh', 'banget', 'aplikasi', 'ini', 'bintang', 'buatbaplikasi', 'iniii']","['aplikasi', 'berguna', 'banget', 'ujian', 'butuh', 'banget', 'aplikasi', 'bintang', 'buatbaplikasi', 'iniii']",17,10,7,aplikasi guna banget uji butuh banget aplikasi bintang buatbaplikasi iniii,10,10
Trima kasih.... saya bergabung sudah lebih dari 5 tahun,positif,2024-03-25,2024,trima kasih saya bergabung sudah lebih dari tahun,9,8,terima kasih saya bergabung sudah lebih dari tahun,8,8,"['terima', 'kasih', 'saya', 'bergabung', 'sudah', 'lebih', 'dari', 'tahun']","['terima', 'kasih', 'bergabung']",8,3,5,terima kasih gabung,3,3
"Gaa bisa daftar, ga bisa pervikasinya, pas di bagi code trus di kirim ga masuk masuk ke akun nya di coba beberapa kali malah jadi nomor tidak valid, are you okay,dude?",negatif,2023-01-06,2023,gaa bisa daftar ga bisa pervikasinya pas di bagi code trus di kirim ga masuk masuk ke akun nya di coba beberapa kali malah jadi nomor tidak valid are you okay dude,31,32,tidak bisa daftar tidak bisa pervikasinya pas di bagi code terus di kirim tidak masuk masuk ke akun nya di coba beberapa kali bahkan jadi nomor tidak valid are you okay dude,32,32,"['tidak', 'bisa', 'daftar', 'tidak', 'bisa', 'pervikasinya', 'pas', 'di', 'bagi', 'code', 'terus', 'di', 'kirim', 'tidak', 'masuk', 'masuk', 'ke', 'akun', 'nya', 'di', 'coba', 'beberapa', 'kali', 'bahkan', 'jadi', 'nomor', 'tidak', 'valid', 'are', 'you', 'okay', 'dude']","['tidak', 'daftar', 'tidak', 'pervikasinya', 'pas', 'code', 'kirim', 'tidak', 'masuk', 'masuk', 'akun', 'nya', 'coba', 'kali', 'nomor', 'tidak', 'valid', 'are', 'you', 'okay', 'dude']",32,21,11,tidak daftar tidak pervikasinya pas code kirim tidak masuk masuk akun nya coba kali nomor tidak valid are you okay dude,21,21
Membantu Saya Mendapat Pekerjaan Dan Relasi,positif,2024-04-13,2024,membantu saya mendapat pekerjaan dan relasi,6,6,membantu saya mendapat pekerjaan dan relasi,6,6,"['membantu', 'saya', 'mendapat', 'pekerjaan', 'dan', 'relasi']","['membantu', 'pekerjaan', 'relasi']",6,3,3,bantu kerja relasi,3,3
masuk saldo sah saya jangan ditahan,positif,2024-04-26,2024,masuk saldo sah saya jangan ditahan,6,6,masuk saldo sah saya jangan ditahan,6,6,"['masuk', 'saldo', 'sah', 'saya', 'jangan', 'ditahan']","['masuk', 'saldo', 'sah', 'ditahan']",6,4,2,masuk saldo sah tahan,4,4
Data saya tersebar karena aplikasi ini,negatif,2024-04-03,2024,data saya tersebar karena aplikasi ini,6,6,data saya tersebar karena aplikasi ini,6,6,"['data', 'saya', 'tersebar', 'karena', 'aplikasi', 'ini']","['data', 'tersebar', 'aplikasi']",6,3,3,data sebar aplikasi,3,3
"Tidak berfungsi seringnya gagal masuk padahal hp mulus sinyal bagus,",negatif,2023-12-05,2023,tidak berfungsi seringnya gagal masuk padahal hp mulus sinyal bagus,10,10,tidak berfungsi seringnya gagal masuk padahal handphone mulus sinyal bagus,10,10,"['tidak', 'berfungsi', 'seringnya', 'gagal', 'masuk', 'padahal', 'handphone', 'mulus', 'sinyal', 'bagus']","['tidak', 'berfungsi', 'gagal', 'masuk', 'handphone', 'mulus', 'sinyal', 'bagus']",10,8,2,tidak fungsi gagal masuk handphone mulus sinyal bagus,8,8
"Verifikasi macam apa ini cuk, salah muluuuu !!!!",negatif,2024-05-07,2024,verifikasi macam apa ini cuk salah muluuuu,8,7,verifikasi macam apa ini cuk salah muluuuu,7,7,"['verifikasi', 'macam', 'apa', 'ini', 'cuk', 'salah', 'muluuuu']","['verifikasi', 'cuk', 'salah', 'muluuuu']",7,4,3,verifikasi cuk salah muluuuu,4,4
Bagus untuk menjadi portofolio,positif,2024-04-01,2024,bagus untuk menjadi portofolio,4,4,bagus untuk menjadi portofolio,4,4,"['bagus', 'untuk', 'menjadi', 'portofolio']","['bagus', 'portofolio']",4,2,2,bagus portofolio,2,2
Jelek kenapa harus verifikasi id takut d salah gunain,negatif,2024-03-22,2024,jelek kenapa harus verifikasi id takut d salah gunain,9,9,jelek kenapa harus verifikasi id takut di salah guna in,9,10,"['jelek', 'kenapa', 'harus', 'verifikasi', 'id', 'takut', 'di', 'salah', 'guna', 'in']","['jelek', 'verifikasi', 'id', 'takut', 'salah', 'in']",10,6,4,jelek verifikasi id takut salah in,6,6
Sangat membatu jika tahu caranus,positif,2024-04-18,2024,sangat membatu jika tahu caranus,5,5,sangat membantu jika tahu caranus,5,5,"['sangat', 'membantu', 'jika', 'tahu', 'caranus']","['membantu', 'caranus']",5,2,3,bantu caranus,2,2
"Verifikasi buruk, kirim kode gak di kirim2 giliran mencoba lagi ""nomor anda tidak dpt di gunakan"" gak jelas banget ini aplikasi",negatif,2023-07-05,2023,verifikasi buruk kirim kode gak di kirim giliran mencoba lagi nomor anda tidak dpt di gunakan gak jelas banget ini aplikasi,21,21,verifikasi buruk kirim kode tidak di kirim giliran mencoba lagi nomor anda tidak dapat di gunakan tidak jelas banget ini aplikasi,21,21,"['verifikasi', 'buruk', 'kirim', 'kode', 'tidak', 'di', 'kirim', 'giliran', 'mencoba', 'lagi', 'nomor', 'anda', 'tidak', 'dapat', 'di', 'gunakan', 'tidak', 'jelas', 'banget', 'ini', 'aplikasi']","['verifikasi', 'buruk', 'kirim', 'kode', 'tidak', 'kirim', 'giliran', 'mencoba', 'nomor', 'tidak', 'tidak', 'banget', 'aplikasi']",21,13,8,verifikasi buruk kirim kode tidak kirim gilir coba nomor tidak tidak banget aplikasi,13,13
Lowongan banyak tp satu ndk ada yg d respon bsa juga ya supaya ada postingan modus,negatif,2021-06-13,2021,lowongan banyak tp satu ndk ada yg d respon bsa juga ya supaya ada postingan modus,16,16,lowongan banyak tapi satu ndk ada yang di respons bisa juga ya supaya ada postingan modus,16,16,"['lowongan', 'banyak', 'tapi', 'satu', 'ndk', 'ada', 'yang', 'di', 'respons', 'bisa', 'juga', 'ya', 'supaya', 'ada', 'postingan', 'modus']","['lowongan', 'ndk', 'respons', 'ya', 'postingan', 'modus']",16,6,10,lowong ndk respons ya postingan modus,6,6
"Mohon untuk LinkedIn bisa terhubung dengan wa, instagram, Facebook, Dan bekerja sama dengan indeed, jobstreet dan layanan akun kerja lainnya supaya saya ga daftar2 lgi",negatif,2023-12-02,2023,mohon untuk linkedin bisa terhubung dengan wa instagram facebook dan bekerja sama dengan indeed jobstreet dan layanan akun kerja lainnya supaya saya ga daftar lgi,25,25,mohon untuk linkedin bisa terhubung dengan whatsapp instagram facebook dan bekerja sama dengan indeed jobstreet dan layanan akun kerja lainnya supaya saya tidak daftar lagi,25,25,"['mohon', 'untuk', 'linkedin', 'bisa', 'terhubung', 'dengan', 'whatsapp', 'instagram', 'facebook', 'dan', 'bekerja', 'sama', 'dengan', 'indeed', 'jobstreet', 'dan', 'layanan', 'akun', 'kerja', 'lainnya', 'supaya', 'saya', 'tidak', 'daftar', 'lagi']","['mohon', 'linkedin', 'terhubung', 'whatsapp', 'instagram', 'facebook', 'indeed', 'jobstreet', 'layanan', 'akun', 'kerja', 'tidak', 'daftar']",25,13,12,mohon linkedin hubung whatsapp instagram facebook indeed jobstreet layan akun kerja tidak daftar,13,13
Sangat membantu dlam mencari relasi untuk ruang lingkup di dunia kerja,positif,2020-07-11,2020,sangat membantu dlam mencari relasi untuk ruang lingkup di dunia kerja,11,11,sangat membantu dalam mencari relasi untuk ruang lingkup di dunia kerja,11,11,"['sangat', 'membantu', 'dalam', 'mencari', 'relasi', 'untuk', 'ruang', 'lingkup', 'di', 'dunia', 'kerja']","['membantu', 'mencari', 'relasi', 'ruang', 'lingkup', 'dunia', 'kerja']",11,7,4,bantu cari relasi ruang lingkup dunia kerja,7,7
Programnya bagus,positif,2024-05-31,2024,programnya bagus,2,2,programnya bagus,2,2,"['programnya', 'bagus']","['programnya', 'bagus']",2,2,0,program bagus,2,2
"Sumpah ya ngerasa ditipu sama percobaan premium nya. Udah batalin premium,tapi ternyata gak bisa ke approve. Saldo gue ilang 1,1jt",negatif,2023-03-03,2023,sumpah ya ngerasa ditipu sama percobaan premium nya udah batalin premium tapi ternyata gak bisa ke approve saldo gue ilang jt,20,21,sumpah ya merasa ditipu sama percobaan premium nya sudah membatalkan premium tapi ternyata tidak bisa ke approve saldo saya hilang jt,21,21,"['sumpah', 'ya', 'merasa', 'ditipu', 'sama', 'percobaan', 'premium', 'nya', 'sudah', 'membatalkan', 'premium', 'tapi', 'ternyata', 'tidak', 'bisa', 'ke', 'approve', 'saldo', 'saya', 'hilang', 'jt']","['sumpah', 'ya', 'ditipu', 'percobaan', 'premium', 'nya', 'membatalkan', 'premium', 'tidak', 'approve', 'saldo', 'hilang', 'jt']",21,13,8,sumpah ya tipu coba premium nya batal premium tidak approve saldo hilang jt,13,13
"Saya berterima kasih kepada Linkedin. Berkat Linkedin, saya dipertemukan dengan pekerjaan yang pernah menghidupi saya selama 1 tahun.",positif,2023-07-01,2023,saya berterima kasih kepada linkedin berkat linkedin saya dipertemukan dengan pekerjaan yang pernah menghidupi saya selama tahun,18,17,saya berterima kasih kepada linkedin berkat linkedin saya dipertemukan dengan pekerjaan yang pernah menghidupi saya selama tahun,17,17,"['saya', 'berterima', 'kasih', 'kepada', 'linkedin', 'berkat', 'linkedin', 'saya', 'dipertemukan', 'dengan', 'pekerjaan', 'yang', 'pernah', 'menghidupi', 'saya', 'selama', 'tahun']","['berterima', 'kasih', 'linkedin', 'berkat', 'linkedin', 'dipertemukan', 'pekerjaan', 'menghidupi']",17,8,9,terima kasih linkedin berkat linkedin temu kerja hidup,8,8
gkjls aplikasi tolol verifikasi nyusahin,negatif,2024-04-24,2024,gkjls aplikasi tolol verifikasi nyusahin,5,5,gkjls aplikasi tolol verifikasi nyusahin,5,5,"['gkjls', 'aplikasi', 'tolol', 'verifikasi', 'nyusahin']","['gkjls', 'aplikasi', 'tolol', 'verifikasi', 'nyusahin']",5,5,0,gkjls aplikasi tolol verifikasi nyusahin,5,5
Ini kenapa verifikasi kok ngga bisa terus ya Tolong dong di perbaiki,negatif,2023-12-17,2023,ini kenapa verifikasi kok ngga bisa terus ya tolong dong di perbaiki,12,12,ini kenapa verifikasi kok tidak bisa terus ya tolong dong di perbaikan,12,12,"['ini', 'kenapa', 'verifikasi', 'kok', 'tidak', 'bisa', 'terus', 'ya', 'tolong', 'dong', 'di', 'perbaikan']","['verifikasi', 'tidak', 'ya', 'tolong', 'perbaikan']",12,5,7,verifikasi tidak ya tolong baik,5,5
Apaan ini aplikasi baru make beberapa hari udah di ban cuman gara-gara kebanyakan connect. Gw mau pake buat menuhin tugas juga.,negatif,2023-08-05,2023,apaan ini aplikasi baru make beberapa hari udah di ban cuman gara gara kebanyakan connect gw mau pake buat menuhin tugas juga,21,22,apa ini aplikasi baru make beberapa hari sudah di ban cuman gara gara kebanyakan connect saya mau pakai buat memenuhi tugas juga,22,22,"['apa', 'ini', 'aplikasi', 'baru', 'make', 'beberapa', 'hari', 'sudah', 'di', 'ban', 'cuman', 'gara', 'gara', 'kebanyakan', 'connect', 'saya', 'mau', 'pakai', 'buat', 'memenuhi', 'tugas', 'juga']","['aplikasi', 'make', 'ban', 'cuman', 'gara', 'gara', 'kebanyakan', 'connect', 'pakai', 'memenuhi', 'tugas']",22,11,11,aplikasi make ban cuman gara gara banyak connect pakai penuh tugas,11,11
"Sangat baik untuk saling tukar informasi pekerjaan, jesempatan dan prngetahuan",positif,2023-03-03,2023,sangat baik untuk saling tukar informasi pekerjaan jesempatan dan prngetahuan,10,10,sangat baik untuk saling tukar informasi pekerjaan jesempatan dan prngetahuan,10,10,"['sangat', 'baik', 'untuk', 'saling', 'tukar', 'informasi', 'pekerjaan', 'jesempatan', 'dan', 'prngetahuan']","['tukar', 'informasi', 'pekerjaan', 'jesempatan', 'prngetahuan']",10,5,5,tukar informasi kerja jesempatan prngetahuan,5,5
"Admin kerjanya ngapain aja bukannya di benerin ini sistemnya cuman plonga plongo. gw mau login akun jadi gk bisa cuman karna verifikasi doang?? coba minimal ditanggapi komen yg lain biar kami juga ada kepastian, udah digaji kerja gk becus",negatif,2024-02-27,2024,admin kerjanya ngapain aja bukannya di benerin ini sistemnya cuman plonga plongo gw mau login akun jadi gk bisa cuman karna verifikasi doang coba minimal ditanggapi komen yg lain biar kami juga ada kepastian udah digaji kerja gk becus,39,39,admin kerjanya buat apa saja bukannya di benerin ini sistemnya cuman plonga plongo saya mau login akun jadi tidak bisa cuman karena verifikasi saja coba minimal ditanggapi komen yang lain biar kami juga ada kepastian sudah digaji kerja tidak becus,39,40,"['admin', 'kerjanya', 'buat', 'apa', 'saja', 'bukannya', 'di', 'benerin', 'ini', 'sistemnya', 'cuman', 'plonga', 'plongo', 'saya', 'mau', 'login', 'akun', 'jadi', 'tidak', 'bisa', 'cuman', 'karena', 'verifikasi', 'saja', 'coba', 'minimal', 'ditanggapi', 'komen', 'yang', 'lain', 'biar', 'kami', 'juga', 'ada', 'kepastian', 'sudah', 'digaji', 'kerja', 'tidak', 'becus']","['admin', 'kerjanya', 'benerin', 'sistemnya', 'cuman', 'plonga', 'plongo', 'login', 'akun', 'tidak', 'cuman', 'verifikasi', 'coba', 'minimal', 'ditanggapi', 'komen', 'biar', 'kepastian', 'digaji', 'kerja', 'tidak', 'becus']",40,22,18,admin kerja benerin sistem cuman plonga plongo login akun tidak cuman verifikasi coba minimal tanggap komen biar pasti gaji kerja tidak becus,22,22
"Berbeda dengan versi lama, hanya bisa buka 6 postingan..",negatif,2021-08-13,2021,berbeda dengan versi lama hanya bisa buka postingan,9,8,berbeda dengan versi lama hanya bisa buka postingan,8,8,"['berbeda', 'dengan', 'versi', 'lama', 'hanya', 'bisa', 'buka', 'postingan']","['berbeda', 'versi', 'buka', 'postingan']",8,4,4,beda versi buka postingan,4,4
Selamat datang kembali untuk permainan Semuanya yang terbaik dan benar,positif,2024-07-02,2024,selamat datang kembali untuk permainan semuanya yang terbaik dan benar,10,10,selamat datang kembali untuk permainan semuanya yang terbaik dan benar,10,10,"['selamat', 'datang', 'kembali', 'untuk', 'permainan', 'semuanya', 'yang', 'terbaik', 'dan', 'benar']","['selamat', 'permainan', 'terbaik']",10,3,7,selamat main baik,3,3
"login disuruh nyelesain captcha padahal udah bener tapi disuruh ulang terus sampe berkali""pun sama",negatif,2023-12-13,2023,login disuruh nyelesain captcha padahal udah bener tapi disuruh ulang terus sampe berkali pun sama,14,15,login disuruh nyelesain captcha padahal sudah benar tapi disuruh ulang terus sampai berkali pun sama,15,15,"['login', 'disuruh', 'nyelesain', 'captcha', 'padahal', 'sudah', 'benar', 'tapi', 'disuruh', 'ulang', 'terus', 'sampai', 'berkali', 'pun', 'sama']","['login', 'disuruh', 'nyelesain', 'captcha', 'disuruh', 'ulang', 'berkali']",15,7,8,login suruh nyelesain captcha suruh ulang kali,7,7
Aplikasi yg mantap ... Bisa dapat menyampaikan perkembangan bisnis serta info loker,positif,2023-07-27,2023,aplikasi yg mantap bisa dapat menyampaikan perkembangan bisnis serta info loker,12,11,aplikasi yang mantap bisa dapat menyampaikan perkembangan bisnis serta informasi loker,11,11,"['aplikasi', 'yang', 'mantap', 'bisa', 'dapat', 'menyampaikan', 'perkembangan', 'bisnis', 'serta', 'informasi', 'loker']","['aplikasi', 'mantap', 'perkembangan', 'bisnis', 'informasi', 'loker']",11,6,5,aplikasi mantap kembang bisnis informasi loker,6,6
"Kenapa saya daftar tidak dapat SMS verifikasi, saya ulang² sampai nomor saya tidak bisa di gunakan karena terlalu banyak spam",negatif,2023-02-11,2023,kenapa saya daftar tidak dapat sms verifikasi saya ulang² sampai nomor saya tidak bisa di gunakan karena terlalu banyak spam,20,20,kenapa saya daftar tidak dapat sms verifikasi saya ulang² sampai nomor saya tidak bisa di gunakan karena terlalu banyak spam,20,20,"['kenapa', 'saya', 'daftar', 'tidak', 'dapat', 'sms', 'verifikasi', 'saya', 'ulang²', 'sampai', 'nomor', 'saya', 'tidak', 'bisa', 'di', 'gunakan', 'karena', 'terlalu', 'banyak', 'spam']","['daftar', 'tidak', 'sms', 'verifikasi', 'ulang²', 'nomor', 'tidak', 'spam']",20,8,12,daftar tidak sms verifikasi ulang nomor tidak spam,8,8
Ini kenapa saat melengkapi profil selalu gangguan.... Gak bisa... Tolong di perbaiki donk,negatif,2022-09-12,2022,ini kenapa saat melengkapi profil selalu gangguan gak bisa tolong di perbaiki donk,13,13,ini kenapa saat melengkapi profil selalu gangguan tidak bisa tolong di perbaikan dong,13,13,"['ini', 'kenapa', 'saat', 'melengkapi', 'profil', 'selalu', 'gangguan', 'tidak', 'bisa', 'tolong', 'di', 'perbaikan', 'dong']","['melengkapi', 'profil', 'gangguan', 'tidak', 'tolong', 'perbaikan']",13,6,7,lengkap profil ganggu tidak tolong baik,6,6
"Sudah semakin baik dapat memberikan kemudahan baik komunikasi atau menyeleksi yang gabung di Linkedln , terus update agar konsumer dapat mencapai tujuannya.",positif,2021-01-31,2021,sudah semakin baik dapat memberikan kemudahan baik komunikasi atau menyeleksi yang gabung di linkedln terus update agar konsumer dapat mencapai tujuannya,22,21,sudah semakin baik dapat memberikan kemudahan baik komunikasi atau menyeleksi yang gabung di linkedln terus diperbarui agar konsumer dapat mencapai tujuannya,21,21,"['sudah', 'semakin', 'baik', 'dapat', 'memberikan', 'kemudahan', 'baik', 'komunikasi', 'atau', 'menyeleksi', 'yang', 'gabung', 'di', 'linkedln', 'terus', 'diperbarui', 'agar', 'konsumer', 'dapat', 'mencapai', 'tujuannya']","['kemudahan', 'komunikasi', 'menyeleksi', 'gabung', 'linkedln', 'diperbarui', 'konsumer', 'mencapai', 'tujuannya']",21,9,12,mudah komunikasi seleksi gabung linkedln baru konsumer capai tuju,9,9
"Sangat luuar biasaa applikasi ini sehingga saya juga dpt terhubung dengan orang2 pintar, cerdas dan kaya akan ilmu...✌👍",positif,2021-01-29,2021,sangat luuar biasaa applikasi ini sehingga saya juga dpt terhubung dengan orang pintar cerdas dan kaya akan ilmu,18,18,sangat luuar biasaa aplikasi ini sehingga saya juga dapat terhubung dengan orang pintar cerdas dan kayak akan ilmu,18,18,"['sangat', 'luuar', 'biasaa', 'aplikasi', 'ini', 'sehingga', 'saya', 'juga', 'dapat', 'terhubung', 'dengan', 'orang', 'pintar', 'cerdas', 'dan', 'kayak', 'akan', 'ilmu']","['luuar', 'biasaa', 'aplikasi', 'terhubung', 'orang', 'pintar', 'cerdas', 'kayak', 'ilmu']",18,9,9,luuar biasaa aplikasi hubung orang pintar cerdas kayak ilmu,9,9
"LinkedIn masuknya lebih susah,masih mudah joobstreet, LinkedIn pelayanan nya kurang bagus lambat",negatif,2021-01-16,2021,linkedin masuknya lebih susah masih mudah joobstreet linkedin pelayanan nya kurang bagus lambat,12,13,linkedin masuknya lebih susah masih mudah joobstreet linkedin pelayanan nya kurang bagus lambat,13,13,"['linkedin', 'masuknya', 'lebih', 'susah', 'masih', 'mudah', 'joobstreet', 'linkedin', 'pelayanan', 'nya', 'kurang', 'bagus', 'lambat']","['linkedin', 'masuknya', 'susah', 'mudah', 'joobstreet', 'linkedin', 'pelayanan', 'nya', 'bagus', 'lambat']",13,10,3,linkedin masuk susah mudah joobstreet linkedin layan nya bagus lambat,10,10
Sangat Lemot dan Lambat Dlm Upgrade Butuh Waktu Jam2an,negatif,2020-03-14,2020,sangat lemot dan lambat dlm upgrade butuh waktu jam an,9,10,sangat lambat dan lambat dalam upgrade butuh waktu jam an,10,10,"['sangat', 'lambat', 'dan', 'lambat', 'dalam', 'upgrade', 'butuh', 'waktu', 'jam', 'an']","['lambat', 'lambat', 'upgrade', 'butuh', 'jam', 'an']",10,6,4,lambat lambat upgrade butuh jam an,6,6
Sosial media baik dalam mencari pekerjaan ataupun sharing pengalaman apapun seputar pekerjaan yang sangat simple dan inovatif. Cool! 🚀✨,positif,2023-01-04,2023,sosial media baik dalam mencari pekerjaan ataupun sharing pengalaman apapun seputar pekerjaan yang sangat simple dan inovatif cool,19,18,sosial media baik dalam mencari pekerjaan ataupun sharing pengalaman apapun seputar pekerjaan yang sangat simpel dan inovatif cool,18,18,"['sosial', 'media', 'baik', 'dalam', 'mencari', 'pekerjaan', 'ataupun', 'sharing', 'pengalaman', 'apapun', 'seputar', 'pekerjaan', 'yang', 'sangat', 'simpel', 'dan', 'inovatif', 'cool']","['sosial', 'media', 'mencari', 'pekerjaan', 'sharing', 'pengalaman', 'apapun', 'seputar', 'pekerjaan', 'simpel', 'inovatif', 'cool']",18,12,6,sosial media cari kerja sharing alam apa putar kerja simpel inovatif cool,12,12
Sangat membantu,positif,2024-06-25,2024,sangat membantu,2,2,sangat membantu,2,2,"['sangat', 'membantu']",['membantu'],2,1,1,bantu,1,1
Alhamdulillah Mempermudah dan Paling Utama Relasi bisa tersebar dan Bertambah seI donesia,positif,2020-09-07,2020,alhamdulillah mempermudah dan paling utama relasi bisa tersebar dan bertambah sei donesia,12,12,alhamdulillah mempermudah dan paling utama relasi bisa tersebar dan bertambah sei donesia,12,12,"['alhamdulillah', 'mempermudah', 'dan', 'paling', 'utama', 'relasi', 'bisa', 'tersebar', 'dan', 'bertambah', 'sei', 'donesia']","['alhamdulillah', 'mempermudah', 'utama', 'relasi', 'tersebar', 'bertambah', 'sei', 'donesia']",12,8,4,alhamdulillah mudah utama relasi sebar tambah sei donesia,8,8
"Band terus,gak tau salah nya di mana malah di band trs...udah ganti no tlp,ganti alamat email malah di band terus...sangat mengecewakan",negatif,2023-11-02,2023,band terus gak tau salah nya di mana malah di band trs udah ganti no tlp ganti alamat email malah di band terus sangat mengecewakan,21,25,band terus tidak tahu salah nya di mana bahkan di band terus sudah ganti nomor telpon ganti alamat email bahkan di band terus sangat mengecewakan,25,25,"['band', 'terus', 'tidak', 'tahu', 'salah', 'nya', 'di', 'mana', 'bahkan', 'di', 'band', 'terus', 'sudah', 'ganti', 'nomor', 'telpon', 'ganti', 'alamat', 'email', 'bahkan', 'di', 'band', 'terus', 'sangat', 'mengecewakan']","['band', 'tidak', 'salah', 'nya', 'band', 'ganti', 'nomor', 'telpon', 'ganti', 'alamat', 'email', 'band', 'mengecewakan']",25,13,12,band tidak salah nya band ganti nomor telpon ganti alamat email band kecewa,13,13
Good lah.sangat mudah digunakan untuk referensi dan mencari teman,positif,2020-10-28,2020,good lah sangat mudah digunakan untuk referensi dan mencari teman,9,10,bagus lah sangat mudah digunakan untuk referensi dan mencari teman,10,10,"['bagus', 'lah', 'sangat', 'mudah', 'digunakan', 'untuk', 'referensi', 'dan', 'mencari', 'teman']","['bagus', 'mudah', 'referensi', 'mencari', 'teman']",10,5,5,bagus mudah referensi cari teman,5,5
Gk bisa masuk. Verifikasi gak selesai selesai. Mohon diperbaiki,negatif,2023-08-10,2023,gk bisa masuk verifikasi gak selesai selesai mohon diperbaiki,9,9,tidak bisa masuk verifikasi tidak selesai selesai mohon di perbaiki,9,10,"['tidak', 'bisa', 'masuk', 'verifikasi', 'tidak', 'selesai', 'selesai', 'mohon', 'di', 'perbaiki']","['tidak', 'masuk', 'verifikasi', 'tidak', 'selesai', 'selesai', 'mohon', 'perbaiki']",10,8,2,tidak masuk verifikasi tidak selesai selesai mohon baik,8,8
Aplikasi asuu..tembak gambar verfikasi nya gagal mulu..padahal udah bener tu gambar madep ke atass...asuu emang..nyeseeelllll siiall,negatif,2021-02-06,2021,aplikasi asuu tembak gambar verfikasi nya gagal mulu padahal udah bener tu gambar madep ke atass asuu emang nyeseeelllll siiall,16,20,aplikasi asuu tembak gambar verfikasi nya gagal mulu padahal sudah benar tu gambar madep ke atass asuu memang nyeseeelllll siiall,20,20,"['aplikasi', 'asuu', 'tembak', 'gambar', 'verfikasi', 'nya', 'gagal', 'mulu', 'padahal', 'sudah', 'benar', 'tu', 'gambar', 'madep', 'ke', 'atass', 'asuu', 'memang', 'nyeseeelllll', 'siiall']","['aplikasi', 'asuu', 'tembak', 'gambar', 'verfikasi', 'nya', 'gagal', 'mulu', 'tu', 'gambar', 'madep', 'atass', 'asuu', 'nyeseeelllll', 'siiall']",20,15,5,aplikasi asuu tembak gambar verfikasi nya gagal mulu tu gambar madep atass asuu nyeseeelllll siiall,15,15
Aplikasi jasa keuangan & paling banyak asuransi. Kl mau cari kerja di jasa keuangan disini tempatnya. Terutama asuransi,positif,2021-07-08,2021,aplikasi jasa keuangan paling banyak asuransi kl mau cari kerja di jasa keuangan disini tempatnya terutama asuransi,18,17,aplikasi jasa keuangan paling banyak asuransi kalau mau cari kerja di jasa keuangan disini tempatnya terutama asuransi,17,17,"['aplikasi', 'jasa', 'keuangan', 'paling', 'banyak', 'asuransi', 'kalau', 'mau', 'cari', 'kerja', 'di', 'jasa', 'keuangan', 'disini', 'tempatnya', 'terutama', 'asuransi']","['aplikasi', 'jasa', 'keuangan', 'asuransi', 'cari', 'kerja', 'jasa', 'keuangan', 'tempatnya', 'asuransi']",17,10,7,aplikasi jasa uang asuransi cari kerja jasa uang tempat asuransi,10,10
Keren. Sangat membantu mencari info lowongan pekerjaan dan bisa terhubung langsung dengan orang orang profesional. Sukses selalu,positif,2021-08-18,2021,keren sangat membantu mencari info lowongan pekerjaan dan bisa terhubung langsung dengan orang orang profesional sukses selalu,17,17,keren sangat membantu mencari informasi lowongan pekerjaan dan bisa terhubung langsung dengan orang orang profesional sukses selalu,17,17,"['keren', 'sangat', 'membantu', 'mencari', 'informasi', 'lowongan', 'pekerjaan', 'dan', 'bisa', 'terhubung', 'langsung', 'dengan', 'orang', 'orang', 'profesional', 'sukses', 'selalu']","['keren', 'membantu', 'mencari', 'informasi', 'lowongan', 'pekerjaan', 'terhubung', 'langsung', 'orang', 'orang', 'profesional', 'sukses']",17,12,5,keren bantu cari informasi lowong kerja hubung langsung orang orang profesional sukses,12,12
Perasaan tidak pernah ganti pasword... tp sll gagal masuk .. aplg verifikasi berkali2 gagal (gambar katak),negatif,2022-06-26,2022,perasaan tidak pernah ganti pasword tp sll gagal masuk aplg verifikasi berkali gagal gambar katak,16,15,perasaan tidak pernah ganti pasword tapi selalu gagal masuk apalagi verifikasi berkali gagal gambar katak,15,15,"['perasaan', 'tidak', 'pernah', 'ganti', 'pasword', 'tapi', 'selalu', 'gagal', 'masuk', 'apalagi', 'verifikasi', 'berkali', 'gagal', 'gambar', 'katak']","['perasaan', 'tidak', 'ganti', 'pasword', 'gagal', 'masuk', 'verifikasi', 'berkali', 'gagal', 'gambar', 'katak']",15,11,4,asa tidak ganti pasword gagal masuk verifikasi kali gagal gambar katak,11,11
Saya tidak bisa login sama sekali setiap gambar terakhir yang saya klik selalu salah,negatif,2023-05-14,2023,saya tidak bisa login sama sekali setiap gambar terakhir yang saya klik selalu salah,14,14,saya tidak bisa login sama sekali setiap gambar terakhir yang saya klik selalu salah,14,14,"['saya', 'tidak', 'bisa', 'login', 'sama', 'sekali', 'setiap', 'gambar', 'terakhir', 'yang', 'saya', 'klik', 'selalu', 'salah']","['tidak', 'login', 'gambar', 'klik', 'salah']",14,5,9,tidak login gambar klik salah,5,5
"Haha suruh cari yg mnhdap ke atas, 1 smpe 3biar nungguing pasti benar giliran ke 4 biar jelas mnghadap ke atas ttp aja salah,, heemmm gak beres,, gak jelas apk nya",negatif,2021-10-02,2021,haha suruh cari yg mnhdap ke atas smpe biar nungguing pasti benar giliran ke biar jelas mnghadap ke atas ttp aja salah heemmm gak beres gak jelas apk nya,31,29,haha suruh cari yang mnhdap ke atas sampai biar nungguing pasti benar giliran ke biar jelas mnghadap ke atas tetap saja salah heemmm tidak beres tidak jelas aplikasi nya,29,29,"['haha', 'suruh', 'cari', 'yang', 'mnhdap', 'ke', 'atas', 'sampai', 'biar', 'nungguing', 'pasti', 'benar', 'giliran', 'ke', 'biar', 'jelas', 'mnghadap', 'ke', 'atas', 'tetap', 'saja', 'salah', 'heemmm', 'tidak', 'beres', 'tidak', 'jelas', 'aplikasi', 'nya']","['haha', 'suruh', 'cari', 'mnhdap', 'biar', 'nungguing', 'giliran', 'biar', 'mnghadap', 'salah', 'heemmm', 'tidak', 'beres', 'tidak', 'aplikasi', 'nya']",29,16,13,haha suruh cari mnhdap biar nungguing gilir biar mnghadap salah heemmm tidak beres tidak aplikasi nya,16,16
"Gak ngerti banget sma pemeriksaan kemanan nya, no 1-4 ngasal pun ttp di acc tpi pas yg terakhir serius jg salah mulu . Heran sumpah🙂",negatif,2022-06-03,2022,gak ngerti banget sma pemeriksaan kemanan nya no ngasal pun ttp di acc tpi pas yg terakhir serius jg salah mulu heran sumpah,25,23,tidak mengerti banget sama pemeriksaan kemanan nya nomor ngasal pun tetap di acc tetapi pas yang terakhir serius juga salah mulu heran sumpah,23,23,"['tidak', 'mengerti', 'banget', 'sama', 'pemeriksaan', 'kemanan', 'nya', 'nomor', 'ngasal', 'pun', 'tetap', 'di', 'acc', 'tetapi', 'pas', 'yang', 'terakhir', 'serius', 'juga', 'salah', 'mulu', 'heran', 'sumpah']","['tidak', 'mengerti', 'banget', 'pemeriksaan', 'kemanan', 'nya', 'nomor', 'ngasal', 'acc', 'pas', 'serius', 'salah', 'mulu', 'heran', 'sumpah']",23,15,8,tidak erti banget periksa keman nya nomor ngasal acc pas serius salah mulu heran sumpah,15,15
Linkedln sangat bagus untuk menambah relasi kita baik lokal dan internasional.,positif,2020-12-21,2020,linkedln sangat bagus untuk menambah relasi kita baik lokal dan internasional,11,11,linkedln sangat bagus untuk menambah relasi kita baik lokal dan internasional,11,11,"['linkedln', 'sangat', 'bagus', 'untuk', 'menambah', 'relasi', 'kita', 'baik', 'lokal', 'dan', 'internasional']","['linkedln', 'bagus', 'menambah', 'relasi', 'lokal', 'internasional']",11,6,5,linkedln bagus tambah relasi lokal internasional,6,6
"Aplikasi bagus dan menarik, sebab semakin mudah berkomunikasi sektor bisnis dan lowongan kerja.",positif,2021-01-09,2021,aplikasi bagus dan menarik sebab semakin mudah berkomunikasi sektor bisnis dan lowongan kerja,13,13,aplikasi bagus dan menarik sebab semakin mudah berkomunikasi sektor bisnis dan lowongan kerja,13,13,"['aplikasi', 'bagus', 'dan', 'menarik', 'sebab', 'semakin', 'mudah', 'berkomunikasi', 'sektor', 'bisnis', 'dan', 'lowongan', 'kerja']","['aplikasi', 'bagus', 'menarik', 'mudah', 'berkomunikasi', 'sektor', 'bisnis', 'lowongan', 'kerja']",13,9,4,aplikasi bagus tarik mudah komunikasi sektor bisnis lowong kerja,9,9
"Apk gajelas, uda berkali kali verifikasi tp gabisa login. Hadehhh",negatif,2023-05-22,2023,apk gajelas uda berkali kali verifikasi tp gabisa login hadehhh,10,10,aplikasi tidak jelas sudah berkali kali verifikasi tapi tidak bisa login hadehhh,10,12,"['aplikasi', 'tidak', 'jelas', 'sudah', 'berkali', 'kali', 'verifikasi', 'tapi', 'tidak', 'bisa', 'login', 'hadehhh']","['aplikasi', 'tidak', 'berkali', 'kali', 'verifikasi', 'tidak', 'login', 'hadehhh']",12,8,4,aplikasi tidak kali kali verifikasi tidak login hadehhh,8,8
"Apk bermanfaat , membantu dalam berkarir dan penuh edukasi positif",positif,2020-09-30,2020,apk bermanfaat membantu dalam berkarir dan penuh edukasi positif,10,9,aplikasi bermanfaat membantu dalam berkarir dan penuh edukasi positif,9,9,"['aplikasi', 'bermanfaat', 'membantu', 'dalam', 'berkarir', 'dan', 'penuh', 'edukasi', 'positif']","['aplikasi', 'bermanfaat', 'membantu', 'berkarir', 'penuh', 'edukasi', 'positif']",9,7,2,aplikasi manfaat bantu berkarir penuh edukasi positif,7,7
Apk susah masuk ga hebat,negatif,2024-06-01,2024,apk susah masuk ga hebat,5,5,aplikasi susah masuk tidak hebat,5,5,"['aplikasi', 'susah', 'masuk', 'tidak', 'hebat']","['aplikasi', 'susah', 'masuk', 'tidak', 'hebat']",5,5,0,aplikasi susah masuk tidak hebat,5,5
daftarnya susah padahal tinggal kirim kode lewat sms tapi nungguin lama ga di kirim2 kodenya yauda akhirnya uninstal aja,negatif,2023-09-09,2023,daftarnya susah padahal tinggal kirim kode lewat sms tapi nungguin lama ga di kirim kodenya yauda akhirnya uninstal aja,19,19,daftarnya susah padahal tinggal kirim kode lewat sms tapi menunggu lama tidak di kirim kodenya yauda akhirnya hapus instalan saja,19,20,"['daftarnya', 'susah', 'padahal', 'tinggal', 'kirim', 'kode', 'lewat', 'sms', 'tapi', 'menunggu', 'lama', 'tidak', 'di', 'kirim', 'kodenya', 'yauda', 'akhirnya', 'hapus', 'instalan', 'saja']","['daftarnya', 'susah', 'tinggal', 'kirim', 'kode', 'sms', 'menunggu', 'tidak', 'kirim', 'kodenya', 'yauda', 'hapus', 'instalan']",20,13,7,daftar susah tinggal kirim kode sms tunggu tidak kirim kode yauda hapus instalan,13,13
Kok di refresh ga bisa ya ? Giliran di logout ga bisa masuk lagi sama klik lupa sandi ga bisa Ada yang bisa bantu ga ?,negatif,2020-11-29,2020,kok di refresh ga bisa ya giliran di logout ga bisa masuk lagi sama klik lupa sandi ga bisa ada yang bisa bantu ga,26,24,kok di refresh tidak bisa ya giliran di logout tidak bisa masuk lagi sama klik lupa sandi tidak bisa ada yang bisa bantu tidak,24,24,"['kok', 'di', 'refresh', 'tidak', 'bisa', 'ya', 'giliran', 'di', 'logout', 'tidak', 'bisa', 'masuk', 'lagi', 'sama', 'klik', 'lupa', 'sandi', 'tidak', 'bisa', 'ada', 'yang', 'bisa', 'bantu', 'tidak']","['refresh', 'tidak', 'ya', 'giliran', 'logout', 'tidak', 'masuk', 'klik', 'lupa', 'sandi', 'tidak', 'bantu', 'tidak']",24,13,11,refresh tidak ya gilir logout tidak masuk klik lupa sandi tidak bantu tidak,13,13
Kok aplikasi nya tdk dpat di un-install ya?? Beritahu cara meng un-install nya,negatif,2020-06-30,2020,kok aplikasi nya tdk dpat di un install ya beritahu cara meng un install nya,13,15,kok aplikasi nya tidak dpat di un install ya beritahu cara meng un install nya,15,15,"['kok', 'aplikasi', 'nya', 'tidak', 'dpat', 'di', 'un', 'install', 'ya', 'beritahu', 'cara', 'meng', 'un', 'install', 'nya']","['aplikasi', 'nya', 'tidak', 'dpat', 'un', 'install', 'ya', 'beritahu', 'meng', 'un', 'install', 'nya']",15,12,3,aplikasi nya tidak dpat un install ya beritahu meng un install nya,12,12
Akses masuk yg susah dan sistem verifikasi yg payah.... Susaaaah g worth it,negatif,2022-08-09,2022,akses masuk yg susah dan sistem verifikasi yg payah susaaaah g worth it,13,13,akses masuk yang susah dan sistem verifikasi yang payah susaaaah tidak worth it,13,13,"['akses', 'masuk', 'yang', 'susah', 'dan', 'sistem', 'verifikasi', 'yang', 'payah', 'susaaaah', 'tidak', 'worth', 'it']","['akses', 'masuk', 'susah', 'sistem', 'verifikasi', 'payah', 'susaaaah', 'tidak', 'worth', 'it']",13,10,3,akses masuk susah sistem verifikasi payah susaaaah tidak worth it,10,10
"Maaf ya dikasih bintang 1, tiap abis diupdate selalu gabisa diakses, disuruh coba lagi terus",negatif,2021-04-16,2021,maaf ya dikasih bintang tiap abis diupdate selalu gabisa diakses disuruh coba lagi terus,15,14,maaf ya dikasih bintang tiap habis di perbarui selalu tidak bisa diakses disuruh coba lagi terus,14,16,"['maaf', 'ya', 'dikasih', 'bintang', 'tiap', 'habis', 'di', 'perbarui', 'selalu', 'tidak', 'bisa', 'diakses', 'disuruh', 'coba', 'lagi', 'terus']","['maaf', 'ya', 'dikasih', 'bintang', 'habis', 'perbarui', 'tidak', 'diakses', 'disuruh', 'coba']",16,10,6,maaf ya kasih bintang habis baru tidak akses suruh coba,10,10
"aplikasinya bagus, membantu sy mendapatkan pekerjaan dan mengenal orang- orang para rekruter perusahaan sehingga sy mendapatkan pekerjaan disalah satu perbankan",positif,2023-03-04,2023,aplikasinya bagus membantu sy mendapatkan pekerjaan dan mengenal orang orang para rekruter perusahaan sehingga sy mendapatkan pekerjaan disalah satu perbankan,20,20,aplikasi nya bagus membantu saya mendapatkan pekerjaan dan mengenal orang orang para rekruter perusahaan sehingga saya mendapatkan pekerjaan disalah satu perbankan,20,21,"['aplikasi', 'nya', 'bagus', 'membantu', 'saya', 'mendapatkan', 'pekerjaan', 'dan', 'mengenal', 'orang', 'orang', 'para', 'rekruter', 'perusahaan', 'sehingga', 'saya', 'mendapatkan', 'pekerjaan', 'disalah', 'satu', 'perbankan']","['aplikasi', 'nya', 'bagus', 'membantu', 'pekerjaan', 'mengenal', 'orang', 'orang', 'rekruter', 'perusahaan', 'pekerjaan', 'disalah', 'perbankan']",21,13,8,aplikasi nya bagus bantu kerja kenal orang orang rekruter usaha kerja salah perban,13,13
"Sangat bermanfaat, mampu menambah wawasan dan pengetahuan",positif,2020-06-17,2020,sangat bermanfaat mampu menambah wawasan dan pengetahuan,7,7,sangat bermanfaat mampu menambah wawasan dan pengetahuan,7,7,"['sangat', 'bermanfaat', 'mampu', 'menambah', 'wawasan', 'dan', 'pengetahuan']","['bermanfaat', 'menambah', 'wawasan', 'pengetahuan']",7,4,3,manfaat tambah wawas tahu,4,4
Aplikasi gk jelasssss verifikasi keamanan gk bisa2 terus ngulang 10x lebih tetep gk cocok,negatif,2022-08-03,2022,aplikasi gk jelasssss verifikasi keamanan gk bisa terus ngulang x lebih tetep gk cocok,14,14,aplikasi tidak jelasssss verifikasi keamanan tidak bisa terus mengulang x lebih tetap tidak cocok,14,14,"['aplikasi', 'tidak', 'jelasssss', 'verifikasi', 'keamanan', 'tidak', 'bisa', 'terus', 'mengulang', 'x', 'lebih', 'tetap', 'tidak', 'cocok']","['aplikasi', 'tidak', 'jelasssss', 'verifikasi', 'keamanan', 'tidak', 'mengulang', 'x', 'tidak', 'cocok']",14,10,4,aplikasi tidak jelasssss verifikasi aman tidak ulang x tidak cocok,10,10
Woyyyyyyy kenapa susah banget login nya!!!!!! Kembali ke menu log in terus! Tolonglah diperbaiki,negatif,2023-01-03,2023,woyyyyyyy kenapa susah banget login nya kembali ke menu log in terus tolonglah diperbaiki,14,14,woyyyyyyy kenapa susah banget login nya kembali ke menu log in terus tolonglah di perbaiki,14,15,"['woyyyyyyy', 'kenapa', 'susah', 'banget', 'login', 'nya', 'kembali', 'ke', 'menu', 'log', 'in', 'terus', 'tolonglah', 'di', 'perbaiki']","['woyyyyyyy', 'susah', 'banget', 'login', 'nya', 'menu', 'log', 'in', 'tolonglah', 'perbaiki']",15,10,5,woyyyyyyy susah banget login nya menu log in tolong baik,10,10
"Tiap mau login gak bisa🤧, kata sandi salah terus klik lupa kata sandi ada perintah isi nama depan dan belakang kok gak bisa😭",negatif,2023-08-11,2023,tiap mau login gak bisa kata sandi salah terus klik lupa kata sandi ada perintah isi nama depan dan belakang kok gak bisa,23,23,tiap mau login tidak bisa kata sandi salah terus klik lupa kata sandi ada perintah isi nama depan dan belakang kok tidak bisa,23,23,"['tiap', 'mau', 'login', 'tidak', 'bisa', 'kata', 'sandi', 'salah', 'terus', 'klik', 'lupa', 'kata', 'sandi', 'ada', 'perintah', 'isi', 'nama', 'depan', 'dan', 'belakang', 'kok', 'tidak', 'bisa']","['login', 'tidak', 'sandi', 'salah', 'klik', 'lupa', 'sandi', 'perintah', 'isi', 'nama', 'tidak']",23,11,12,login tidak sandi salah klik lupa sandi perintah isi nama tidak,11,11
"Kenapa gabisa login yaa?? Udah dua kali masukin email tapi gabisa,",negatif,2020-12-14,2020,kenapa gabisa login yaa udah dua kali masukin email tapi gabisa,11,11,kenapa tidak bisa login ya sudah dua kali masukkan email tapi tidak bisa,11,13,"['kenapa', 'tidak', 'bisa', 'login', 'ya', 'sudah', 'dua', 'kali', 'masukkan', 'email', 'tapi', 'tidak', 'bisa']","['tidak', 'login', 'ya', 'kali', 'masukkan', 'email', 'tidak']",13,7,6,tidak login ya kali masuk email tidak,7,7
Email saya tidak dapat di verifikasi selalu di kendalanya emailnya saja giliran bikin baru bisa pdhl email lama saya udh dri dlu d pke giliran buat lmr krj ora iso,negatif,2020-09-28,2020,email saya tidak dapat di verifikasi selalu di kendalanya emailnya saja giliran bikin baru bisa pdhl email lama saya udh dri dlu d pke giliran buat lmr krj ora iso,30,30,email saya tidak dapat di verifikasi selalu di kendalanya emailnya saja giliran bikin baru bisa padahal email lama saya sudah dari dulu di pakai giliran buat lmr krj ora iso,30,30,"['email', 'saya', 'tidak', 'dapat', 'di', 'verifikasi', 'selalu', 'di', 'kendalanya', 'emailnya', 'saja', 'giliran', 'bikin', 'baru', 'bisa', 'padahal', 'email', 'lama', 'saya', 'sudah', 'dari', 'dulu', 'di', 'pakai', 'giliran', 'buat', 'lmr', 'krj', 'ora', 'iso']","['email', 'tidak', 'verifikasi', 'kendalanya', 'emailnya', 'giliran', 'bikin', 'email', 'pakai', 'giliran', 'lmr', 'krj', 'ora', 'iso']",30,14,16,email tidak verifikasi kendala email gilir bikin email pakai gilir lmr krj ora iso,14,14
Terimaksih linkedln..telah memudahkan saya dalam mencari kerja..dan dapat mengasah tentang skill saya..🙏,positif,2022-03-14,2022,terimaksih linkedln telah memudahkan saya dalam mencari kerja dan dapat mengasah tentang skill saya,12,14,terima kasih linkedln telah memudahkan saya dalam mencari kerja dan dapat mengasah tentang skill saya,14,15,"['terima', 'kasih', 'linkedln', 'telah', 'memudahkan', 'saya', 'dalam', 'mencari', 'kerja', 'dan', 'dapat', 'mengasah', 'tentang', 'skill', 'saya']","['terima', 'kasih', 'linkedln', 'memudahkan', 'mencari', 'kerja', 'mengasah', 'skill']",15,8,7,terima kasih linkedln mudah cari kerja asah skill,8,8
Linkedin sangat bermanfaat.. Terus tingkatkan kualitasnya Terima kasih,positif,2023-07-15,2023,linkedin sangat bermanfaat terus tingkatkan kualitasnya terima kasih,8,8,linkedin sangat bermanfaat terus tingkatkan kualitasnya terima kasih,8,8,"['linkedin', 'sangat', 'bermanfaat', 'terus', 'tingkatkan', 'kualitasnya', 'terima', 'kasih']","['linkedin', 'bermanfaat', 'tingkatkan', 'kualitasnya', 'terima', 'kasih']",8,6,2,linkedin manfaat tingkat kualitas terima kasih,6,6
Verifikasi doang ribet amat bikin emosi,negatif,2024-05-31,2024,verifikasi doang ribet amat bikin emosi,6,6,verifikasi saja rumit amat bikin emosi,6,6,"['verifikasi', 'saja', 'rumit', 'amat', 'bikin', 'emosi']","['verifikasi', 'rumit', 'bikin', 'emosi']",6,4,2,verifikasi rumit bikin emosi,4,4
Mempunyai lebih banyak teman dan jaringan dapat mempromosikan paket tour dan daya tarik wisata di daerah kami,positif,2023-08-26,2023,mempunyai lebih banyak teman dan jaringan dapat mempromosikan paket tour dan daya tarik wisata di daerah kami,17,17,mempunyai lebih banyak teman dan jaringan dapat mempromosikan paket tour dan daya tarik wisata di daerah kami,17,17,"['mempunyai', 'lebih', 'banyak', 'teman', 'dan', 'jaringan', 'dapat', 'mempromosikan', 'paket', 'tour', 'dan', 'daya', 'tarik', 'wisata', 'di', 'daerah', 'kami']","['teman', 'jaringan', 'mempromosikan', 'paket', 'tour', 'daya', 'tarik', 'wisata', 'daerah']",17,9,8,teman jaring promosi paket tour daya tarik wisata daerah,9,9
Masih ada 30% loker palsu atau penipuan yg mengatasnamakan PT A dan B jadi tolong untuk filterisasi jangan merekomendasikan loker bodong,negatif,2022-06-18,2022,masih ada loker palsu atau penipuan yg mengatasnamakan pt a dan b jadi tolong untuk filterisasi jangan merekomendasikan loker bodong,21,20,masih ada loker palsu atau penipuan yang mengatasnamakan perseroan terbatas a dan biasa jadi tolong untuk filterisasi jangan merekomendasikan loker bodong,20,21,"['masih', 'ada', 'loker', 'palsu', 'atau', 'penipuan', 'yang', 'mengatasnamakan', 'perseroan', 'terbatas', 'a', 'dan', 'biasa', 'jadi', 'tolong', 'untuk', 'filterisasi', 'jangan', 'merekomendasikan', 'loker', 'bodong']","['loker', 'palsu', 'penipuan', 'mengatasnamakan', 'perseroan', 'terbatas', 'a', 'tolong', 'filterisasi', 'merekomendasikan', 'loker', 'bodong']",21,12,9,loker palsu tipu mengatasnamakan persero batas a tolong filter rekomendasi loker bodong,12,12
Dengan Linkedin informasinya sangat berguna dalam silahturahmi.,positif,2021-03-01,2021,dengan linkedin informasinya sangat berguna dalam silahturahmi,7,7,dengan linkedin informasinya sangat berguna dalam silahturahmi,7,7,"['dengan', 'linkedin', 'informasinya', 'sangat', 'berguna', 'dalam', 'silahturahmi']","['linkedin', 'informasinya', 'berguna', 'silahturahmi']",7,4,3,linkedin informasi guna silahturahmi,4,4
iklan susah di close,negatif,2024-06-21,2024,iklan susah di close,4,4,iklan susah di close,4,4,"['iklan', 'susah', 'di', 'close']","['iklan', 'susah', 'close']",4,3,1,iklan susah close,3,3
"Kontol mau login ae muter mulu ,gk bisa login ngetddd ,mau ngwrjain tugas anjlah",negatif,2024-06-15,2024,kontol mau login ae muter mulu gk bisa login ngetddd mau ngwrjain tugas anjlah,14,14,kontol mau login ae memutar mulu tidak bisa login ngetddd mau ngwrjain tugas anjlah,14,14,"['kontol', 'mau', 'login', 'ae', 'memutar', 'mulu', 'tidak', 'bisa', 'login', 'ngetddd', 'mau', 'ngwrjain', 'tugas', 'anjlah']","['kontol', 'login', 'ae', 'memutar', 'mulu', 'tidak', 'login', 'ngetddd', 'ngwrjain', 'tugas', 'anjlah']",14,11,3,kontol login ae putar mulu tidak login ngetddd ngwrjain tugas anjlah,11,11
Akun diban sementara disuruh verifikasi identitas tapi gagal. Mau verifikasi lagi gak bisa,negatif,2024-06-28,2024,akun diban sementara disuruh verifikasi identitas tapi gagal mau verifikasi lagi gak bisa,13,13,akun diban sementara disuruh verifikasi identitas tapi gagal mau verifikasi lagi tidak bisa,13,13,"['akun', 'diban', 'sementara', 'disuruh', 'verifikasi', 'identitas', 'tapi', 'gagal', 'mau', 'verifikasi', 'lagi', 'tidak', 'bisa']","['akun', 'diban', 'disuruh', 'verifikasi', 'identitas', 'gagal', 'verifikasi', 'tidak']",13,8,5,akun ban suruh verifikasi identitas gagal verifikasi tidak,8,8
"Ribet login nya segala pake tekateki, udh gitu salah mulu, padahal gambar nya aja yang kaga jelas juntrungannya,,",negatif,2022-08-03,2022,ribet login nya segala pake tekateki udh gitu salah mulu padahal gambar nya aja yang kaga jelas juntrungannya,18,18,rumit login nya segala pakai tekateki sudah begitu salah mulu padahal gambar nya saja yang tidak jelas juntrungannya,18,18,"['rumit', 'login', 'nya', 'segala', 'pakai', 'tekateki', 'sudah', 'begitu', 'salah', 'mulu', 'padahal', 'gambar', 'nya', 'saja', 'yang', 'tidak', 'jelas', 'juntrungannya']","['rumit', 'login', 'nya', 'pakai', 'tekateki', 'salah', 'mulu', 'gambar', 'nya', 'tidak', 'juntrungannya']",18,11,7,rumit login nya pakai tekateki salah mulu gambar nya tidak juntrung,11,11
bagus bgtt ni aplikasi bisa membantu banyak orang,positif,2024-07-04,2024,bagus bgtt ni aplikasi bisa membantu banyak orang,8,8,bagus banget ini aplikasi bisa membantu banyak orang,8,8,"['bagus', 'banget', 'ini', 'aplikasi', 'bisa', 'membantu', 'banyak', 'orang']","['bagus', 'banget', 'aplikasi', 'membantu', 'orang']",8,5,3,bagus banget aplikasi bantu orang,5,5
Saya mau tutup akun susah banget disitu nyuruh masukan sandi udah mau dimasukin tapi malah disuruh main tebak2an. Tolong bantuannya,negatif,2024-06-21,2024,saya mau tutup akun susah banget disitu nyuruh masukan sandi udah mau dimasukin tapi malah disuruh main tebak an tolong bantuannya,20,21,saya mau tutup akun susah banget disitu nyuruh masukan sandi sudah mau di masuk in tapi bahkan disuruh main tebak an tolong bantuannya,21,23,"['saya', 'mau', 'tutup', 'akun', 'susah', 'banget', 'disitu', 'nyuruh', 'masukan', 'sandi', 'sudah', 'mau', 'di', 'masuk', 'in', 'tapi', 'bahkan', 'disuruh', 'main', 'tebak', 'an', 'tolong', 'bantuannya']","['tutup', 'akun', 'susah', 'banget', 'disitu', 'nyuruh', 'masukan', 'sandi', 'masuk', 'in', 'disuruh', 'main', 'tebak', 'an', 'tolong', 'bantuannya']",23,16,7,tutup akun susah banget situ nyuruh masuk sandi masuk in suruh main tebak an tolong bantu,16,16
Apk gajelas... Huhhhhhh langsung delete aja.. gaberguna😅😅😅 masa regristrasi aja gagal Mulu.. jawabanya akun anda sudah ada yg pakai... Aneh🤪,negatif,2024-06-27,2024,apk gajelas huhhhhhh langsung delete aja gaberguna masa regristrasi aja gagal mulu jawabanya akun anda sudah ada yg pakai aneh,20,20,aplikasi tidak jelas huhhhhhh langsung delete saja gaberguna masa regristrasi saja gagal mulu jawabanya akun anda sudah ada yang pakai aneh,20,21,"['aplikasi', 'tidak', 'jelas', 'huhhhhhh', 'langsung', 'delete', 'saja', 'gaberguna', 'masa', 'regristrasi', 'saja', 'gagal', 'mulu', 'jawabanya', 'akun', 'anda', 'sudah', 'ada', 'yang', 'pakai', 'aneh']","['aplikasi', 'tidak', 'huhhhhhh', 'langsung', 'delete', 'gaberguna', 'regristrasi', 'gagal', 'mulu', 'jawabanya', 'akun', 'pakai', 'aneh']",21,13,8,aplikasi tidak huhhhhhh langsung delete gaberguna regristrasi gagal mulu jawabanya akun pakai aneh,13,13
knp tidak bisa di update...,negatif,2024-07-02,2024,knp tidak bisa di update,5,5,kenapa tidak bisa di diperbarui,5,5,"['kenapa', 'tidak', 'bisa', 'di', 'diperbarui']","['tidak', 'diperbarui']",5,2,3,tidak baru,2,2
Aplikasi gila verifikasi mulu kaga masuk ke menu.,negatif,2024-07-20,2024,aplikasi gila verifikasi mulu kaga masuk ke menu,8,8,aplikasi gila verifikasi mulu tidak masuk ke menu,8,8,"['aplikasi', 'gila', 'verifikasi', 'mulu', 'tidak', 'masuk', 'ke', 'menu']","['aplikasi', 'gila', 'verifikasi', 'mulu', 'tidak', 'masuk', 'menu']",8,7,1,aplikasi gila verifikasi mulu tidak masuk menu,7,7
"Ga jelas, mau login susah bgt. Akun di batasi segala, padahal akun gw gak pernah ngapa2in",negatif,2024-07-02,2024,ga jelas mau login susah bgt akun di batasi segala padahal akun gw gak pernah ngapa in,16,17,tidak jelas mau login susah banget akun di batasi segala padahal akun saya tidak pernah ngapa in,17,17,"['tidak', 'jelas', 'mau', 'login', 'susah', 'banget', 'akun', 'di', 'batasi', 'segala', 'padahal', 'akun', 'saya', 'tidak', 'pernah', 'ngapa', 'in']","['tidak', 'login', 'susah', 'banget', 'akun', 'batasi', 'akun', 'tidak', 'ngapa', 'in']",17,10,7,tidak login susah banget akun batas akun tidak ngapa in,10,10
"Error, Feriv gambar terus, buka linkedin paling enak pakai website",negatif,2023-11-24,2023,error feriv gambar terus buka linkedin paling enak pakai website,10,10,error feriv gambar terus buka linkedin paling enak pakai website,10,10,"['error', 'feriv', 'gambar', 'terus', 'buka', 'linkedin', 'paling', 'enak', 'pakai', 'website']","['error', 'feriv', 'gambar', 'buka', 'linkedin', 'enak', 'pakai', 'website']",10,8,2,error feriv gambar buka linkedin enak pakai website,8,8
"susah masuk, verifikasi bikin pusing",negatif,2024-06-12,2024,susah masuk verifikasi bikin pusing,5,5,susah masuk verifikasi bikin pusing,5,5,"['susah', 'masuk', 'verifikasi', 'bikin', 'pusing']","['susah', 'masuk', 'verifikasi', 'bikin', 'pusing']",5,5,0,susah masuk verifikasi bikin pusing,5,5
kenapa akun aku tiba2 jadi punya orang.. sejak kapan aku jadi cewek dan berubah nama jadi Ting R.. udah capek buat tulisa bio.. cacat ni apss,negatif,2024-07-22,2024,kenapa akun aku tiba jadi punya orang sejak kapan aku jadi cewek dan berubah nama jadi ting r udah capek buat tulisa bio cacat ni apss,26,26,kenapa akun aku tiba jadi punya orang sejak kapan aku jadi cewek dan berubah nama jadi ting r sudah capek buat tulisa bio cacat ini apss,26,26,"['kenapa', 'akun', 'aku', 'tiba', 'jadi', 'punya', 'orang', 'sejak', 'kapan', 'aku', 'jadi', 'cewek', 'dan', 'berubah', 'nama', 'jadi', 'ting', 'r', 'sudah', 'capek', 'buat', 'tulisa', 'bio', 'cacat', 'ini', 'apss']","['akun', 'orang', 'cewek', 'berubah', 'nama', 'ting', 'r', 'capek', 'tulisa', 'bio', 'cacat', 'apss']",26,12,14,akun orang cewek ubah nama ting r capek tulisa bio cacat apss,12,12
"Aplikasi apa ini,diajukan pendeletan akun masih muncul trs",negatif,2024-06-20,2024,aplikasi apa ini diajukan pendeletan akun masih muncul trs,8,9,aplikasi apa ini diajukan pendeletan akun masih muncul terus,9,9,"['aplikasi', 'apa', 'ini', 'diajukan', 'pendeletan', 'akun', 'masih', 'muncul', 'terus']","['aplikasi', 'diajukan', 'pendeletan', 'akun', 'muncul']",9,5,4,aplikasi aju pendeletan akun muncul,5,5
Tetiba kok ada tagihan padahal sdh sy hapus krn penasaran saya instal lg,negatif,2024-06-23,2024,tetiba kok ada tagihan padahal sdh sy hapus krn penasaran saya instal lg,13,13,tiba tiba kok ada tagihan padahal sudah saya hapus karena penasaran saya memasang lagi,13,14,"['tiba', 'tiba', 'kok', 'ada', 'tagihan', 'padahal', 'sudah', 'saya', 'hapus', 'karena', 'penasaran', 'saya', 'memasang', 'lagi']","['tagihan', 'hapus', 'penasaran', 'memasang']",14,4,10,tagih hapus penasaran pasang,4,4
Selalu memberikan informasi tentang pekerjaan dan ilmu dalam bekerja,positif,2020-12-02,2020,selalu memberikan informasi tentang pekerjaan dan ilmu dalam bekerja,9,9,selalu memberikan informasi tentang pekerjaan dan ilmu dalam bekerja,9,9,"['selalu', 'memberikan', 'informasi', 'tentang', 'pekerjaan', 'dan', 'ilmu', 'dalam', 'bekerja']","['informasi', 'pekerjaan', 'ilmu']",9,3,6,informasi kerja ilmu,3,3
Sangat membantu dalam memperluas jaringan para profesional di berbagai bidang ilmu pengetahuan dan pekerjaan,positif,2024-04-01,2024,sangat membantu dalam memperluas jaringan para profesional di berbagai bidang ilmu pengetahuan dan pekerjaan,14,14,sangat membantu dalam memperluas jaringan para profesional di berbagai bidang ilmu pengetahuan dan pekerjaan,14,14,"['sangat', 'membantu', 'dalam', 'memperluas', 'jaringan', 'para', 'profesional', 'di', 'berbagai', 'bidang', 'ilmu', 'pengetahuan', 'dan', 'pekerjaan']","['membantu', 'memperluas', 'jaringan', 'profesional', 'bidang', 'ilmu', 'pengetahuan', 'pekerjaan']",14,8,6,bantu luas jaring profesional bidang ilmu tahu kerja,8,8
Minta tolong Developer apk nya tidak bisa untuk di login!!,negatif,2023-05-17,2023,minta tolong developer apk nya tidak bisa untuk di login,10,10,minta tolong developer aplikasi nya tidak bisa untuk di login,10,10,"['minta', 'tolong', 'developer', 'aplikasi', 'nya', 'tidak', 'bisa', 'untuk', 'di', 'login']","['tolong', 'developer', 'aplikasi', 'nya', 'tidak', 'login']",10,6,4,tolong developer aplikasi nya tidak login,6,6
"KEBANYAKAN BUG .. BEBERAPA KALI INSTAL, UNINSTAL, RE INSTALL TETAP ERROR KELUAR APLIKASI SENDIRI",negatif,2024-08-01,2024,kebanyakan bug beberapa kali instal uninstal re install tetap error keluar aplikasi sendiri,14,13,kebanyakan bug beberapa kali memasang hapus instalan re install tetap error keluar aplikasi sendiri,13,14,"['kebanyakan', 'bug', 'beberapa', 'kali', 'memasang', 'hapus', 'instalan', 're', 'install', 'tetap', 'error', 'keluar', 'aplikasi', 'sendiri']","['kebanyakan', 'bug', 'kali', 'memasang', 'hapus', 'instalan', 're', 'install', 'error', 'aplikasi']",14,10,4,banyak bug kali pasang hapus instalan re install error aplikasi,10,10
Tolong verifikasinya diperbaiki udh ngisi benar masih salah dan bisa ngulang sampai 10 kali,negatif,2024-01-25,2024,tolong verifikasinya diperbaiki udh ngisi benar masih salah dan bisa ngulang sampai kali,14,13,tolong verifikasinya di perbaiki sudah mengisi benar masih salah dan bisa mengulang sampai kali,13,14,"['tolong', 'verifikasinya', 'di', 'perbaiki', 'sudah', 'mengisi', 'benar', 'masih', 'salah', 'dan', 'bisa', 'mengulang', 'sampai', 'kali']","['tolong', 'verifikasinya', 'perbaiki', 'mengisi', 'salah', 'mengulang', 'kali']",14,7,7,tolong verifikasi baik isi salah ulang kali,7,7
Mudah dalam ber interaksi ke seluruh penjuru dan tambah banyak kawan,positif,2022-01-19,2022,mudah dalam ber interaksi ke seluruh penjuru dan tambah banyak kawan,11,11,mudah dalam ber interaksi ke seluruh penjuru dan tambah banyak kawan,11,11,"['mudah', 'dalam', 'ber', 'interaksi', 'ke', 'seluruh', 'penjuru', 'dan', 'tambah', 'banyak', 'kawan']","['mudah', 'ber', 'interaksi', 'penjuru', 'kawan']",11,5,6,mudah ber interaksi penjuru kawan,5,5
BAGAIMANA CARA MENGHILANGKAN IKLAN APLIKASI INI? SETIAP KALI BUKA APLIKASI SELALU MUNCUL IKLANNYA PADAHAL TIDAK DI INSTAL 🗿,negatif,2024-06-20,2024,bagaimana cara menghilangkan iklan aplikasi ini setiap kali buka aplikasi selalu muncul iklannya padahal tidak di instal,18,17,bagaimana cara menghilangkan iklan aplikasi ini setiap kali buka aplikasi selalu muncul iklannya padahal tidak di memasang,17,17,"['bagaimana', 'cara', 'menghilangkan', 'iklan', 'aplikasi', 'ini', 'setiap', 'kali', 'buka', 'aplikasi', 'selalu', 'muncul', 'iklannya', 'padahal', 'tidak', 'di', 'memasang']","['menghilangkan', 'iklan', 'aplikasi', 'kali', 'buka', 'aplikasi', 'muncul', 'iklannya', 'tidak', 'memasang']",17,10,7,hilang iklan aplikasi kali buka aplikasi muncul iklan tidak pasang,10,10
"Selama ini ditempatq,sinyal rdk bagus,perbuatannya Tower..tks.",negatif,2024-06-20,2024,selama ini ditempatq sinyal rdk bagus perbuatannya tower tks,6,9,selama ini ditempatq sinyal rdk bagus perbuatannya tower terima kasih,9,10,"['selama', 'ini', 'ditempatq', 'sinyal', 'rdk', 'bagus', 'perbuatannya', 'tower', 'terima', 'kasih']","['ditempatq', 'sinyal', 'rdk', 'bagus', 'perbuatannya', 'tower', 'terima', 'kasih']",10,8,2,ditempatq sinyal rdk bagus buat tower terima kasih,8,8
Banyak sekali penipuan disini. Entah filternya kurang ketat mungkin atau gimana. Pinter pinter nya jobseeker kalo milih loker,negatif,2020-11-09,2020,banyak sekali penipuan disini entah filternya kurang ketat mungkin atau gimana pinter pinter nya jobseeker kalo milih loker,18,18,banyak sekali penipuan disini entah filternya kurang ketat mungkin atau bagaimana pinter pinter nya jobseeker kalau memilih loker,18,18,"['banyak', 'sekali', 'penipuan', 'disini', 'entah', 'filternya', 'kurang', 'ketat', 'mungkin', 'atau', 'bagaimana', 'pinter', 'pinter', 'nya', 'jobseeker', 'kalau', 'memilih', 'loker']","['penipuan', 'filternya', 'ketat', 'pinter', 'pinter', 'nya', 'jobseeker', 'memilih', 'loker']",18,9,9,tipu filter ketat pinter pinter nya jobseeker pilih loker,9,9
"aplikasi tolol gabisa login stuck di verifikasi captcha mending playstore hapus apk ini aplikasi ga berguna,saya naik pitam gara"" apk ini",negatif,2023-07-29,2023,aplikasi tolol gabisa login stuck di verifikasi captcha mending playstore hapus apk ini aplikasi ga berguna saya naik pitam gara apk ini,21,22,aplikasi tolol tidak bisa login stuck di verifikasi captcha mending playstore hapus aplikasi ini aplikasi tidak berguna saya naik pitam gara aplikasi ini,22,23,"['aplikasi', 'tolol', 'tidak', 'bisa', 'login', 'stuck', 'di', 'verifikasi', 'captcha', 'mending', 'playstore', 'hapus', 'aplikasi', 'ini', 'aplikasi', 'tidak', 'berguna', 'saya', 'naik', 'pitam', 'gara', 'aplikasi', 'ini']","['aplikasi', 'tolol', 'tidak', 'login', 'stuck', 'verifikasi', 'captcha', 'mending', 'playstore', 'hapus', 'aplikasi', 'aplikasi', 'tidak', 'berguna', 'pitam', 'gara', 'aplikasi']",23,17,6,aplikasi tolol tidak login stuck verifikasi captcha mending playstore hapus aplikasi aplikasi tidak guna pitam gara aplikasi,17,17
"Verifikasi capcha nya bikin stres, tolong dong di benerin, padahal udah bener pilihanya, masih di ulang2 aja",negatif,2023-05-09,2023,verifikasi capcha nya bikin stres tolong dong di benerin padahal udah bener pilihanya masih di ulang aja,17,17,verifikasi capcha nya bikin stres tolong dong di benerin padahal sudah benar pilihanya masih di ulang saja,17,17,"['verifikasi', 'capcha', 'nya', 'bikin', 'stres', 'tolong', 'dong', 'di', 'benerin', 'padahal', 'sudah', 'benar', 'pilihanya', 'masih', 'di', 'ulang', 'saja']","['verifikasi', 'capcha', 'nya', 'bikin', 'stres', 'tolong', 'benerin', 'pilihanya', 'ulang']",17,9,8,verifikasi capcha nya bikin stres tolong benerin pilihanya ulang,9,9
Agak Sulit untuk memperbaruinya dan terlalu banyak memakan ruang penyimpanan,negatif,2021-11-08,2021,agak sulit untuk memperbaruinya dan terlalu banyak memakan ruang penyimpanan,10,10,agak sulit untuk memperbaruinya dan terlalu banyak memakan ruang penyimpanan,10,10,"['agak', 'sulit', 'untuk', 'memperbaruinya', 'dan', 'terlalu', 'banyak', 'memakan', 'ruang', 'penyimpanan']","['sulit', 'memperbaruinya', 'memakan', 'ruang', 'penyimpanan']",10,5,5,sulit baru makan ruang simpan,5,5
"ayolah, ga ngapain2 tb2 precaution. app ga jelas.",negatif,2024-06-06,2024,ayolah ga ngapain tb precaution app ga jelas,8,8,ayolah tidak buat apa tb precaution aplikasi tidak jelas,8,9,"['ayolah', 'tidak', 'buat', 'apa', 'tb', 'precaution', 'aplikasi', 'tidak', 'jelas']","['ayolah', 'tidak', 'tb', 'precaution', 'aplikasi', 'tidak']",9,6,3,ayo tidak tb precaution aplikasi tidak,6,6
Cara cek email gmn? Saya lupa email sya.. tolong adakan cara cek email.. saya ingin login tidak bisa... 🤝 thank,negatif,2022-02-25,2022,cara cek email gmn saya lupa email sya tolong adakan cara cek email saya ingin login tidak bisa thank,20,19,cara cek email bagaimana saya lupa email saya tolong adakan cara cek email saya ingin login tidak bisa terima kasih,19,20,"['cara', 'cek', 'email', 'bagaimana', 'saya', 'lupa', 'email', 'saya', 'tolong', 'adakan', 'cara', 'cek', 'email', 'saya', 'ingin', 'login', 'tidak', 'bisa', 'terima', 'kasih']","['cek', 'email', 'lupa', 'email', 'tolong', 'adakan', 'cek', 'email', 'login', 'tidak', 'terima', 'kasih']",20,12,8,cek email lupa email tolong adakan cek email login tidak terima kasih,12,12
Login nya gimana sih nggak bisa terus verifikasi Id foto udah jelas tetep nggak bisa,negatif,2024-02-12,2024,login nya gimana sih nggak bisa terus verifikasi id foto udah jelas tetep nggak bisa,15,15,login nya bagaimana sih tidak bisa terus verifikasi id foto sudah jelas tetap tidak bisa,15,15,"['login', 'nya', 'bagaimana', 'sih', 'tidak', 'bisa', 'terus', 'verifikasi', 'id', 'foto', 'sudah', 'jelas', 'tetap', 'tidak', 'bisa']","['login', 'nya', 'sih', 'tidak', 'verifikasi', 'id', 'foto', 'tidak']",15,8,7,login nya sih tidak verifikasi id foto tidak,8,8
"Aplikasi yang dapat mendukung mencari pekerjaaan, menambah wawasan, jaringan pertemanan dan bisnis serta pengembangan diri dan bisnis.",positif,2020-09-06,2020,aplikasi yang dapat mendukung mencari pekerjaaan menambah wawasan jaringan pertemanan dan bisnis serta pengembangan diri dan bisnis,17,17,aplikasi yang dapat mendukung mencari pekerjaaan menambah wawasan jaringan pertemanan dan bisnis serta pengembangan diri dan bisnis,17,17,"['aplikasi', 'yang', 'dapat', 'mendukung', 'mencari', 'pekerjaaan', 'menambah', 'wawasan', 'jaringan', 'pertemanan', 'dan', 'bisnis', 'serta', 'pengembangan', 'diri', 'dan', 'bisnis']","['aplikasi', 'mendukung', 'mencari', 'pekerjaaan', 'menambah', 'wawasan', 'jaringan', 'pertemanan', 'bisnis', 'pengembangan', 'bisnis']",17,11,6,aplikasi dukung cari pekerjaaan tambah wawas jaring teman bisnis kembang bisnis,11,11
Aneh Gak bisa login Sama mau daftar gk Kirim kirim kode nya,negatif,2024-03-23,2024,aneh gak bisa login sama mau daftar gk kirim kirim kode nya,12,12,aneh tidak bisa login sama mau daftar tidak kirim kirim kode nya,12,12,"['aneh', 'tidak', 'bisa', 'login', 'sama', 'mau', 'daftar', 'tidak', 'kirim', 'kirim', 'kode', 'nya']","['aneh', 'tidak', 'login', 'daftar', 'tidak', 'kirim', 'kirim', 'kode', 'nya']",12,9,3,aneh tidak login daftar tidak kirim kirim kode nya,9,9
Aplikasinya bagus untuk nyari kerja. Pokoknya the best lah linkedin,positif,2023-10-21,2023,aplikasinya bagus untuk nyari kerja pokoknya the best lah linkedin,10,10,aplikasi nya bagus untuk mencari kerja pokoknya the terbaik lah linkedin,10,11,"['aplikasi', 'nya', 'bagus', 'untuk', 'mencari', 'kerja', 'pokoknya', 'the', 'terbaik', 'lah', 'linkedin']","['aplikasi', 'nya', 'bagus', 'mencari', 'kerja', 'pokoknya', 'the', 'terbaik', 'linkedin']",11,9,2,aplikasi nya bagus cari kerja pokok the baik linkedin,9,9
"Hampir 1 minggu ini, linkedin tidak mengupdate wall status.. Apakah ada yg error?",negatif,2020-10-27,2020,hampir minggu ini linkedin tidak mengupdate wall status apakah ada yg error,13,12,hampir minggu ini linkedin tidak mengupdate wall status apakah ada yang error,12,12,"['hampir', 'minggu', 'ini', 'linkedin', 'tidak', 'mengupdate', 'wall', 'status', 'apakah', 'ada', 'yang', 'error']","['minggu', 'linkedin', 'tidak', 'mengupdate', 'wall', 'status', 'error']",12,7,5,minggu linkedin tidak mengupdate wall status error,7,7
"Aplikasi tdk bermanfaat bagi khalayak umum... hapus aja bikin full memory,buang2 data pula... 👎👎👎👎",negatif,2021-02-26,2021,aplikasi tdk bermanfaat bagi khalayak umum hapus aja bikin full memory buang data pula,14,14,aplikasi tidak bermanfaat bagi khalayak umum hapus saja bikin full memory buang data pula,14,14,"['aplikasi', 'tidak', 'bermanfaat', 'bagi', 'khalayak', 'umum', 'hapus', 'saja', 'bikin', 'full', 'memory', 'buang', 'data', 'pula']","['aplikasi', 'tidak', 'bermanfaat', 'khalayak', 'hapus', 'bikin', 'full', 'memory', 'buang', 'data']",14,10,4,aplikasi tidak manfaat khalayak hapus bikin full memory buang data,10,10
Mantap.. saya yakin suatu saat jadi aplikasi no.1 untuk jaringan propesional...,positif,2020-05-29,2020,mantap saya yakin suatu saat jadi aplikasi no untuk jaringan propesional,11,11,mantap saya yakin suatu saat jadi aplikasi nomor untuk jaringan propesional,11,11,"['mantap', 'saya', 'yakin', 'suatu', 'saat', 'jadi', 'aplikasi', 'nomor', 'untuk', 'jaringan', 'propesional']","['mantap', 'aplikasi', 'nomor', 'jaringan', 'propesional']",11,5,6,mantap aplikasi nomor jaring propesional,5,5
"Tidak bisa login , padahal udah verivikasi berkali-kali",negatif,2023-08-10,2023,tidak bisa login padahal udah verivikasi berkali kali,8,8,tidak bisa login padahal sudah verivikasi berkali kali,8,8,"['tidak', 'bisa', 'login', 'padahal', 'sudah', 'verivikasi', 'berkali', 'kali']","['tidak', 'login', 'verivikasi', 'berkali', 'kali']",8,5,3,tidak login verivikasi kali kali,5,5
Sangatlah membantu dalam mencari pekerjaan karena banyak orang hebat penguna aplikasi ini,positif,2020-07-03,2020,sangatlah membantu dalam mencari pekerjaan karena banyak orang hebat penguna aplikasi ini,12,12,sangatlah membantu dalam mencari pekerjaan karena banyak orang hebat penguna aplikasi ini,12,12,"['sangatlah', 'membantu', 'dalam', 'mencari', 'pekerjaan', 'karena', 'banyak', 'orang', 'hebat', 'penguna', 'aplikasi', 'ini']","['membantu', 'mencari', 'pekerjaan', 'orang', 'hebat', 'penguna', 'aplikasi']",12,7,5,bantu cari kerja orang hebat penguna aplikasi,7,7
Sangat terbantu dalam menjalin hubungan komunikasi sesama profesional dari setiap bidang pekerjaan.,positif,2020-06-02,2020,sangat terbantu dalam menjalin hubungan komunikasi sesama profesional dari setiap bidang pekerjaan,12,12,sangat membantu dalam menjalin hubungan komunikasi sesama profesional dari setiap bidang pekerjaan,12,12,"['sangat', 'membantu', 'dalam', 'menjalin', 'hubungan', 'komunikasi', 'sesama', 'profesional', 'dari', 'setiap', 'bidang', 'pekerjaan']","['membantu', 'menjalin', 'hubungan', 'komunikasi', 'profesional', 'bidang', 'pekerjaan']",12,7,5,bantu jalin hubung komunikasi profesional bidang kerja,7,7
Aplikasi sudah bagus bapak/ibu Tapi kenapa harus bayar kalau mau kirim CV melalui inmail..,positif,2021-03-18,2021,aplikasi sudah bagus bapak ibu tapi kenapa harus bayar kalau mau kirim cv melalui inmail,14,15,aplikasi sudah bagus bapak ibu tapi kenapa harus bayar kalau mau kirim cv melalui inmail,15,15,"['aplikasi', 'sudah', 'bagus', 'bapak', 'ibu', 'tapi', 'kenapa', 'harus', 'bayar', 'kalau', 'mau', 'kirim', 'cv', 'melalui', 'inmail']","['aplikasi', 'bagus', 'bayar', 'kirim', 'cv', 'inmail']",15,6,9,aplikasi bagus bayar kirim cv inmail,6,6
Sangat membantu bagi anak anak muda yg ingin bekerja di dalam negri maupun luar negri,positif,2020-04-15,2020,sangat membantu bagi anak anak muda yg ingin bekerja di dalam negri maupun luar negri,15,15,sangat membantu bagi anak anak muda yang ingin bekerja di dalam negri maupun luar negri,15,15,"['sangat', 'membantu', 'bagi', 'anak', 'anak', 'muda', 'yang', 'ingin', 'bekerja', 'di', 'dalam', 'negri', 'maupun', 'luar', 'negri']","['membantu', 'anak', 'anak', 'muda', 'negri', 'negri']",15,6,9,bantu anak anak muda negri negri,6,6
Akun saya tidak bisa masuk di website LinkedIn dan harus verifikasi capthca yang tidak ada habisnya.,negatif,2023-12-24,2023,akun saya tidak bisa masuk di website linkedin dan harus verifikasi capthca yang tidak ada habisnya,16,16,akun saya tidak bisa masuk di website linkedin dan harus verifikasi capthca yang tidak ada habisnya,16,16,"['akun', 'saya', 'tidak', 'bisa', 'masuk', 'di', 'website', 'linkedin', 'dan', 'harus', 'verifikasi', 'capthca', 'yang', 'tidak', 'ada', 'habisnya']","['akun', 'tidak', 'masuk', 'website', 'linkedin', 'verifikasi', 'capthca', 'tidak', 'habisnya']",16,9,7,akun tidak masuk website linkedin verifikasi capthca tidak habis,9,9
captcha bermasalah jdi tidak bisa masuk/login apk :( mohon diperbaiki,negatif,2024-01-19,2024,captcha bermasalah jdi tidak bisa masuk login apk mohon diperbaiki,10,10,captcha bermasalah jadi tidak bisa masuk login aplikasi mohon di perbaiki,10,11,"['captcha', 'bermasalah', 'jadi', 'tidak', 'bisa', 'masuk', 'login', 'aplikasi', 'mohon', 'di', 'perbaiki']","['captcha', 'bermasalah', 'tidak', 'masuk', 'login', 'aplikasi', 'mohon', 'perbaiki']",11,8,3,captcha masalah tidak masuk login aplikasi mohon baik,8,8
Membantu sekali dan mempermudah dalam hal link mencari informasi ke seluruh penjuru dunia,positif,2022-06-26,2022,membantu sekali dan mempermudah dalam hal link mencari informasi ke seluruh penjuru dunia,13,13,membantu sekali dan mempermudah dalam hal link mencari informasi ke seluruh penjuru dunia,13,13,"['membantu', 'sekali', 'dan', 'mempermudah', 'dalam', 'hal', 'link', 'mencari', 'informasi', 'ke', 'seluruh', 'penjuru', 'dunia']","['membantu', 'mempermudah', 'link', 'mencari', 'informasi', 'penjuru', 'dunia']",13,7,6,bantu mudah link cari informasi penjuru dunia,7,7
Verifikasi keamanan cepatnya susah suruh nyari yang menghadap ke atas,negatif,2022-09-06,2022,verifikasi keamanan cepatnya susah suruh nyari yang menghadap ke atas,10,10,verifikasi keamanan cepatnya susah suruh mencari yang menghadap ke atas,10,10,"['verifikasi', 'keamanan', 'cepatnya', 'susah', 'suruh', 'mencari', 'yang', 'menghadap', 'ke', 'atas']","['verifikasi', 'keamanan', 'cepatnya', 'susah', 'suruh', 'mencari', 'menghadap']",10,7,3,verifikasi aman cepat susah suruh cari hadap,7,7
Tiba tiba tidak bisa log in -_-. Ada apa dengan linkedin,negatif,2023-06-30,2023,tiba tiba tidak bisa log in ada apa dengan linkedin,11,10,tiba tiba tidak bisa log in ada apa dengan linkedin,10,10,"['tiba', 'tiba', 'tidak', 'bisa', 'log', 'in', 'ada', 'apa', 'dengan', 'linkedin']","['tidak', 'log', 'in', 'linkedin']",10,4,6,tidak log in linkedin,4,4
"Tolong verifikasi nya yang mudah dong, ngasih verifikasi susah banget",negatif,2024-02-10,2024,tolong verifikasi nya yang mudah dong ngasih verifikasi susah banget,10,10,tolong verifikasi nya yang mudah dong memberikan verifikasi susah banget,10,10,"['tolong', 'verifikasi', 'nya', 'yang', 'mudah', 'dong', 'memberikan', 'verifikasi', 'susah', 'banget']","['tolong', 'verifikasi', 'nya', 'mudah', 'verifikasi', 'susah', 'banget']",10,7,3,tolong verifikasi nya mudah verifikasi susah banget,7,7
Tidak cukup ruangan utk update ! Terlalu banyak harus nambah ruangan !,negatif,2020-12-16,2020,tidak cukup ruangan utk update terlalu banyak harus nambah ruangan,12,10,tidak cukup ruangan untuk diperbarui terlalu banyak harus nambah ruangan,10,10,"['tidak', 'cukup', 'ruangan', 'untuk', 'diperbarui', 'terlalu', 'banyak', 'harus', 'nambah', 'ruangan']","['tidak', 'ruangan', 'diperbarui', 'nambah', 'ruangan']",10,5,5,tidak ruang baru nambah ruang,5,5
Appnya sangat membantu banget apalagi bagi kawan-kawan yg sedang mencari pekerjaan.,positif,2020-08-28,2020,appnya sangat membantu banget apalagi bagi kawan kawan yg sedang mencari pekerjaan,11,12,appnya sangat membantu banget apalagi bagi kawan kawan yang sedang mencari pekerjaan,12,12,"['appnya', 'sangat', 'membantu', 'banget', 'apalagi', 'bagi', 'kawan', 'kawan', 'yang', 'sedang', 'mencari', 'pekerjaan']","['appnya', 'membantu', 'banget', 'kawan', 'kawan', 'mencari', 'pekerjaan']",12,7,5,appnya bantu banget kawan kawan cari kerja,7,7
"Aplikasi professional yang menghubungkan pencari kerja Dan pemberi kerja, saat ini sudah menjadi ajang diskusi berbagai hal terkait Pekerjaan, Political, social, budaya dll, yang pastinya applikasi ini mendatangkan aura positive Dan sangat bermanfaat untuk di ikuti",positif,2020-06-03,2020,aplikasi professional yang menghubungkan pencari kerja dan pemberi kerja saat ini sudah menjadi ajang diskusi berbagai hal terkait pekerjaan political social budaya dll yang pastinya applikasi ini mendatangkan aura positive dan sangat bermanfaat untuk di ikuti,36,36,aplikasi professional yang menghubungkan pencari kerja dan pemberi kerja saat ini sudah menjadi ajang diskusi berbagai hal terkait pekerjaan political social budaya dan lain lain yang pastinya aplikasi ini mendatangkan aura positive dan sangat bermanfaat untuk di ikuti,36,38,"['aplikasi', 'professional', 'yang', 'menghubungkan', 'pencari', 'kerja', 'dan', 'pemberi', 'kerja', 'saat', 'ini', 'sudah', 'menjadi', 'ajang', 'diskusi', 'berbagai', 'hal', 'terkait', 'pekerjaan', 'political', 'social', 'budaya', 'dan', 'lain', 'lain', 'yang', 'pastinya', 'aplikasi', 'ini', 'mendatangkan', 'aura', 'positive', 'dan', 'sangat', 'bermanfaat', 'untuk', 'di', 'ikuti']","['aplikasi', 'professional', 'menghubungkan', 'pencari', 'kerja', 'pemberi', 'kerja', 'ajang', 'diskusi', 'terkait', 'pekerjaan', 'political', 'social', 'budaya', 'pastinya', 'aplikasi', 'aura', 'positive', 'bermanfaat', 'ikuti']",38,20,18,aplikasi professional hubung cari kerja beri kerja ajang diskusi kait kerja political social budaya pasti aplikasi aura positive manfaat ikut,20,20
"Terlalu sering update ya, mana update nya hal yang tidak banyak berarti",negatif,2022-03-17,2022,terlalu sering update ya mana update nya hal yang tidak banyak berarti,12,12,terlalu sering diperbarui ya mana diperbarui nya hal yang tidak banyak berarti,12,12,"['terlalu', 'sering', 'diperbarui', 'ya', 'mana', 'diperbarui', 'nya', 'hal', 'yang', 'tidak', 'banyak', 'berarti']","['diperbarui', 'ya', 'diperbarui', 'nya', 'tidak']",12,5,7,baru ya baru nya tidak,5,5
Provider job yg ada di linked in terlalu ribed....ga bikin simpel,negatif,2020-09-04,2020,provider job yg ada di linked in terlalu ribed ga bikin simpel,11,12,provider kerja yang ada di linked in terlalu ribed tidak bikin simpel,12,12,"['provider', 'kerja', 'yang', 'ada', 'di', 'linked', 'in', 'terlalu', 'ribed', 'tidak', 'bikin', 'simpel']","['provider', 'kerja', 'linked', 'in', 'ribed', 'tidak', 'bikin', 'simpel']",12,8,4,provider kerja linked in ribed tidak bikin simpel,8,8
Bismillah.. Semoga dengan menggunakan aplikasi LinkedIn ini saya bisa mendapatkan pekerjaan yang baik dan secepatnya 🙏,positif,2020-09-15,2020,bismillah semoga dengan menggunakan aplikasi linkedin ini saya bisa mendapatkan pekerjaan yang baik dan secepatnya,16,15,bismillah semoga dengan menggunakan aplikasi linkedin ini saya bisa mendapatkan pekerjaan yang baik dan secepatnya,15,15,"['bismillah', 'semoga', 'dengan', 'menggunakan', 'aplikasi', 'linkedin', 'ini', 'saya', 'bisa', 'mendapatkan', 'pekerjaan', 'yang', 'baik', 'dan', 'secepatnya']","['bismillah', 'semoga', 'aplikasi', 'linkedin', 'pekerjaan', 'secepatnya']",15,6,9,bismillah moga aplikasi linkedin kerja cepat,6,6
Buruk Verifikasi gambar saat masuk terlalu mengada-ada,negatif,2023-08-02,2023,buruk verifikasi gambar saat masuk terlalu mengada ada,7,8,buruk verifikasi gambar saat masuk terlalu mengada ada,8,8,"['buruk', 'verifikasi', 'gambar', 'saat', 'masuk', 'terlalu', 'mengada', 'ada']","['buruk', 'verifikasi', 'gambar', 'masuk', 'mengada']",8,5,3,buruk verifikasi gambar masuk ada,5,5
Sangat membantu para profesional mencari pekerjaan sesuai dgn bidang kerjanya,positif,2023-02-10,2023,sangat membantu para profesional mencari pekerjaan sesuai dgn bidang kerjanya,10,10,sangat membantu para profesional mencari pekerjaan sesuai dengan bidang kerjanya,10,10,"['sangat', 'membantu', 'para', 'profesional', 'mencari', 'pekerjaan', 'sesuai', 'dengan', 'bidang', 'kerjanya']","['membantu', 'profesional', 'mencari', 'pekerjaan', 'sesuai', 'bidang', 'kerjanya']",10,7,3,bantu profesional cari kerja sesuai bidang kerja,7,7
Asu gabisa login. Padahal verifikasi udah bener tapi malah ngulang terus asu,negatif,2023-05-17,2023,asu gabisa login padahal verifikasi udah bener tapi malah ngulang terus asu,12,12,asu tidak bisa login padahal verifikasi sudah benar tapi bahkan mengulang terus asu,12,13,"['asu', 'tidak', 'bisa', 'login', 'padahal', 'verifikasi', 'sudah', 'benar', 'tapi', 'bahkan', 'mengulang', 'terus', 'asu']","['asu', 'tidak', 'login', 'verifikasi', 'mengulang', 'asu']",13,6,7,asu tidak login verifikasi ulang asu,6,6
Mayanlah banyak loker....cuma sayangnya susah apply direct aja,negatif,2024-06-12,2024,mayanlah banyak loker cuma sayangnya susah apply direct aja,8,9,mayanlah banyak loker cuma sayangnya susah apply direct saja,9,9,"['mayanlah', 'banyak', 'loker', 'cuma', 'sayangnya', 'susah', 'apply', 'direct', 'saja']","['mayanlah', 'loker', 'sayangnya', 'susah', 'apply', 'direct']",9,6,3,mayanlah loker sayang susah apply direct,6,6
"Gak bisa log in, disuruh berkali kali verifikasi tapi tetap gagal",negatif,2023-07-06,2023,gak bisa log in disuruh berkali kali verifikasi tapi tetap gagal,11,11,tidak bisa log in disuruh berkali kali verifikasi tapi tetap gagal,11,11,"['tidak', 'bisa', 'log', 'in', 'disuruh', 'berkali', 'kali', 'verifikasi', 'tapi', 'tetap', 'gagal']","['tidak', 'log', 'in', 'disuruh', 'berkali', 'kali', 'verifikasi', 'gagal']",11,8,3,tidak log in suruh kali kali verifikasi gagal,8,8
"Gabung di aplikasi In, bukan saja banyak sahabat , tp banyak mengetahui aneka pekerjaan / profesi yg luar biasa, sangat bermanfaat dech 🙏",positif,2022-03-10,2022,gabung di aplikasi in bukan saja banyak sahabat tp banyak mengetahui aneka pekerjaan profesi yg luar biasa sangat bermanfaat dech,23,20,gabung di aplikasi in bukan saja banyak sahabat tapi banyak mengetahui aneka pekerjaan profesi yang luar biasa sangat bermanfaat deh,20,20,"['gabung', 'di', 'aplikasi', 'in', 'bukan', 'saja', 'banyak', 'sahabat', 'tapi', 'banyak', 'mengetahui', 'aneka', 'pekerjaan', 'profesi', 'yang', 'luar', 'biasa', 'sangat', 'bermanfaat', 'deh']","['gabung', 'aplikasi', 'in', 'sahabat', 'aneka', 'pekerjaan', 'profesi', 'bermanfaat', 'deh']",20,9,11,gabung aplikasi in sahabat aneka kerja profesi manfaat deh,9,9
Terlalu banyak iklan & proses daftar rumit serta mesti bayar!,negatif,2021-10-20,2021,terlalu banyak iklan proses daftar rumit serta mesti bayar,10,9,terlalu banyak iklan proses daftar rumit serta mesti bayar,9,9,"['terlalu', 'banyak', 'iklan', 'proses', 'daftar', 'rumit', 'serta', 'mesti', 'bayar']","['iklan', 'proses', 'daftar', 'rumit', 'mesti', 'bayar']",9,6,3,iklan proses daftar rumit mesti bayar,6,6
Aplikasi linkedn buat saya banyak buka jaringan dan pertemanan yang profesional,positif,2024-02-01,2024,aplikasi linkedn buat saya banyak buka jaringan dan pertemanan yang profesional,11,11,aplikasi linkedn buat saya banyak buka jaringan dan pertemanan yang profesional,11,11,"['aplikasi', 'linkedn', 'buat', 'saya', 'banyak', 'buka', 'jaringan', 'dan', 'pertemanan', 'yang', 'profesional']","['aplikasi', 'linkedn', 'buka', 'jaringan', 'pertemanan', 'profesional']",11,6,5,aplikasi linkedn buka jaring teman profesional,6,6
"Aplikasix sngat bagus, untuk mebantu orang dpat informasi soal pekerjaan. 5 bintang buat aplikasi ini. 😇",positif,2021-11-11,2021,aplikasix sngat bagus untuk mebantu orang dpat informasi soal pekerjaan bintang buat aplikasi ini,16,14,aplikasix sangat bagus untuk mebantu orang dpat informasi soal pekerjaan bintang buat aplikasi ini,14,14,"['aplikasix', 'sangat', 'bagus', 'untuk', 'mebantu', 'orang', 'dpat', 'informasi', 'soal', 'pekerjaan', 'bintang', 'buat', 'aplikasi', 'ini']","['aplikasix', 'bagus', 'mebantu', 'orang', 'dpat', 'informasi', 'pekerjaan', 'bintang', 'aplikasi']",14,9,5,aplikasix bagus mebantu orang dpat informasi kerja bintang aplikasi,9,9
"tidak bisa login, karena captcha selalu berulang-ulang tidak pernah selesai.",negatif,2023-11-28,2023,tidak bisa login karena captcha selalu berulang ulang tidak pernah selesai,10,11,tidak bisa login karena captcha selalu berulang ulang tidak pernah selesai,11,11,"['tidak', 'bisa', 'login', 'karena', 'captcha', 'selalu', 'berulang', 'ulang', 'tidak', 'pernah', 'selesai']","['tidak', 'login', 'captcha', 'berulang', 'ulang', 'tidak', 'selesai']",11,7,4,tidak login captcha ulang ulang tidak selesai,7,7
"Halo perkenalkan saya indra, menurut saya aplikasi yg sangat berguna, dan saya banyak mendapatkan ilmu dari para pengguna linkedin.",positif,2020-11-19,2020,halo perkenalkan saya indra menurut saya aplikasi yg sangat berguna dan saya banyak mendapatkan ilmu dari para pengguna linkedin,19,19,halo perkenalkan saya indra menurut saya aplikasi yang sangat berguna dan saya banyak mendapatkan ilmu dari para pengguna linkedin,19,19,"['halo', 'perkenalkan', 'saya', 'indra', 'menurut', 'saya', 'aplikasi', 'yang', 'sangat', 'berguna', 'dan', 'saya', 'banyak', 'mendapatkan', 'ilmu', 'dari', 'para', 'pengguna', 'linkedin']","['halo', 'perkenalkan', 'indra', 'aplikasi', 'berguna', 'ilmu', 'pengguna', 'linkedin']",19,8,11,halo kenal indra aplikasi guna ilmu guna linkedin,8,8
Sangat bermanfaat buat saya dalam menjalin relasi dan komunikasi positif,positif,2020-11-02,2020,sangat bermanfaat buat saya dalam menjalin relasi dan komunikasi positif,10,10,sangat bermanfaat buat saya dalam menjalin relasi dan komunikasi positif,10,10,"['sangat', 'bermanfaat', 'buat', 'saya', 'dalam', 'menjalin', 'relasi', 'dan', 'komunikasi', 'positif']","['bermanfaat', 'menjalin', 'relasi', 'komunikasi', 'positif']",10,5,5,manfaat jalin relasi komunikasi positif,5,5
secara aplikasi bagus cuman karna blm pernah dapat kerjaan lewat ini aplikasi aja kasih bintang 2.,positif,2023-06-19,2023,secara aplikasi bagus cuman karna blm pernah dapat kerjaan lewat ini aplikasi aja kasih bintang,16,15,secara aplikasi bagus cuman karena belum pernah dapat kerjaan lewat ini aplikasi saja kasih bintang,15,15,"['secara', 'aplikasi', 'bagus', 'cuman', 'karena', 'belum', 'pernah', 'dapat', 'kerjaan', 'lewat', 'ini', 'aplikasi', 'saja', 'kasih', 'bintang']","['aplikasi', 'bagus', 'cuman', 'kerjaan', 'aplikasi', 'kasih', 'bintang']",15,7,8,aplikasi bagus cuman kerja aplikasi kasih bintang,7,7
Udh ngisi kode tpi terus terusan diulang coba perbaikin dong bug nya,negatif,2022-06-16,2022,udh ngisi kode tpi terus terusan diulang coba perbaikin dong bug nya,12,12,sudah mengisi kode tetapi terus terusan diulang coba perbaikin dong bug nya,12,12,"['sudah', 'mengisi', 'kode', 'tetapi', 'terus', 'terusan', 'diulang', 'coba', 'perbaikin', 'dong', 'bug', 'nya']","['mengisi', 'kode', 'terusan', 'diulang', 'coba', 'perbaikin', 'bug', 'nya']",12,8,4,isi kode terus ulang coba perbaikin bug nya,8,8
Sangat membantu dalam menampilkan pengalaman kerja dan mencari pekerjaan,positif,2021-05-24,2021,sangat membantu dalam menampilkan pengalaman kerja dan mencari pekerjaan,9,9,sangat membantu dalam menampilkan pengalaman kerja dan mencari pekerjaan,9,9,"['sangat', 'membantu', 'dalam', 'menampilkan', 'pengalaman', 'kerja', 'dan', 'mencari', 'pekerjaan']","['membantu', 'menampilkan', 'pengalaman', 'kerja', 'mencari', 'pekerjaan']",9,6,3,bantu tampil alam kerja cari kerja,6,6
Lagi edit intro ga bisa di simpan dan terjadi kesalahpahaman mulu,negatif,2022-12-24,2022,lagi edit intro ga bisa di simpan dan terjadi kesalahpahaman mulu,11,11,lagi edit intro tidak bisa di simpan dan terjadi kesalahpahaman mulu,11,11,"['lagi', 'edit', 'intro', 'tidak', 'bisa', 'di', 'simpan', 'dan', 'terjadi', 'kesalahpahaman', 'mulu']","['edit', 'intro', 'tidak', 'simpan', 'kesalahpahaman', 'mulu']",11,6,5,edit intro tidak simpan kesalahpahaman mulu,6,6
Sangat bermanfaat dan membantu untuk mencari rekan kerja,positif,2020-12-14,2020,sangat bermanfaat dan membantu untuk mencari rekan kerja,8,8,sangat bermanfaat dan membantu untuk mencari rekan kerja,8,8,"['sangat', 'bermanfaat', 'dan', 'membantu', 'untuk', 'mencari', 'rekan', 'kerja']","['bermanfaat', 'membantu', 'mencari', 'rekan', 'kerja']",8,5,3,manfaat bantu cari rekan kerja,5,5
"Pas login disuruh verifikasi chaptca, verifikasinya udh bener malah disuruh verifikasi sampe 4 kali. Verif aja trus ampe kiamat",negatif,2023-09-21,2023,pas login disuruh verifikasi chaptca verifikasinya udh bener malah disuruh verifikasi sampe kali verif aja trus ampe kiamat,19,18,pas login disuruh verifikasi chaptca verifikasinya sudah benar bahkan disuruh verifikasi sampai kali verif saja terus sampai kiamat,18,18,"['pas', 'login', 'disuruh', 'verifikasi', 'chaptca', 'verifikasinya', 'sudah', 'benar', 'bahkan', 'disuruh', 'verifikasi', 'sampai', 'kali', 'verif', 'saja', 'terus', 'sampai', 'kiamat']","['pas', 'login', 'disuruh', 'verifikasi', 'chaptca', 'verifikasinya', 'disuruh', 'verifikasi', 'kali', 'verif', 'kiamat']",18,11,7,pas login suruh verifikasi chaptca verifikasi suruh verifikasi kali verif kiamat,11,11
Mengganggu...kebanyakan iklan,negatif,2024-06-18,2024,mengganggu kebanyakan iklan,2,3,mengganggu kebanyakan iklan,3,3,"['mengganggu', 'kebanyakan', 'iklan']","['mengganggu', 'kebanyakan', 'iklan']",3,3,0,ganggu banyak iklan,3,3
Payah nih. Mau masuk ke linkedin mentok di a quick security check. Hadeh,negatif,2023-11-27,2023,payah nih mau masuk ke linkedin mentok di a quick security check hadeh,13,13,payah nih mau masuk ke linkedin mentok di a quick security cek hadeh,13,13,"['payah', 'nih', 'mau', 'masuk', 'ke', 'linkedin', 'mentok', 'di', 'a', 'quick', 'security', 'cek', 'hadeh']","['payah', 'nih', 'masuk', 'linkedin', 'mentok', 'a', 'quick', 'security', 'cek', 'hadeh']",13,10,3,payah nih masuk linkedin mentok a quick security cek hadeh,10,10
"Sangat membantu untuk mendapatkan lowongan pekerjaan, sukses terus untuk aplikasi ini",positif,2023-10-18,2023,sangat membantu untuk mendapatkan lowongan pekerjaan sukses terus untuk aplikasi ini,11,11,sangat membantu untuk mendapatkan lowongan pekerjaan sukses terus untuk aplikasi ini,11,11,"['sangat', 'membantu', 'untuk', 'mendapatkan', 'lowongan', 'pekerjaan', 'sukses', 'terus', 'untuk', 'aplikasi', 'ini']","['membantu', 'lowongan', 'pekerjaan', 'sukses', 'aplikasi']",11,5,6,bantu lowong kerja sukses aplikasi,5,5
Bangkrut?? Udah banyak dapet uang dari iklan sekarang tinggalin apk gitu aja,negatif,2024-02-01,2024,bangkrut udah banyak dapet uang dari iklan sekarang tinggalin apk gitu aja,12,12,bangkrut sudah banyak dapat uang dari iklan sekarang tinggalin aplikasi begitu saja,12,12,"['bangkrut', 'sudah', 'banyak', 'dapat', 'uang', 'dari', 'iklan', 'sekarang', 'tinggalin', 'aplikasi', 'begitu', 'saja']","['bangkrut', 'uang', 'iklan', 'tinggalin', 'aplikasi']",12,5,7,bangkrut uang iklan tinggalin aplikasi,5,5
Good apk nya ....jadi ketemu teman2 lama Is ok gaes lanjut kan lah Apalagi klau bnyak hadiah nya hehehehe,positif,2021-12-07,2021,good apk nya jadi ketemu teman lama is ok gaes lanjut kan lah apalagi klau bnyak hadiah nya hehehehe,19,19,bagus aplikasi nya jadi ketemu teman lama is oke gaes lanjut akan lah apalagi klau banyak hadiah nya hehehehe,19,19,"['bagus', 'aplikasi', 'nya', 'jadi', 'ketemu', 'teman', 'lama', 'is', 'oke', 'gaes', 'lanjut', 'akan', 'lah', 'apalagi', 'klau', 'banyak', 'hadiah', 'nya', 'hehehehe']","['bagus', 'aplikasi', 'nya', 'ketemu', 'teman', 'is', 'oke', 'gaes', 'klau', 'hadiah', 'nya', 'hehehehe']",19,12,7,bagus aplikasi nya ketemu teman is oke gaes klau hadiah nya hehehehe,12,12
"gak bisa login anjir, kalo login disuruh nebak trs giliran selesai suruh ngulang trs",negatif,2023-08-22,2023,gak bisa login anjir kalo login disuruh nebak trs giliran selesai suruh ngulang trs,14,14,tidak bisa login anjir kalau login disuruh nebak terus giliran selesai suruh mengulang terus,14,14,"['tidak', 'bisa', 'login', 'anjir', 'kalau', 'login', 'disuruh', 'nebak', 'terus', 'giliran', 'selesai', 'suruh', 'mengulang', 'terus']","['tidak', 'login', 'anjir', 'login', 'disuruh', 'nebak', 'giliran', 'selesai', 'suruh', 'mengulang']",14,10,4,tidak login anjir login suruh nebak gilir selesai suruh ulang,10,10
Akun saya di hack orang lain. Dan saya tidak bisa memgembalikan akun saya. Email customer service pun tidak berguna. PERBAIKI SISTEM KEAMANAN KALIAN !!!,negatif,2023-10-03,2023,akun saya di hack orang lain dan saya tidak bisa memgembalikan akun saya email customer service pun tidak berguna perbaiki sistem keamanan kalian,24,23,akun saya di hack orang lain dan saya tidak bisa memgembalikan akun saya email pelanggan pelayanan pun tidak berguna perbaikan sistem keamanan kalian,23,23,"['akun', 'saya', 'di', 'hack', 'orang', 'lain', 'dan', 'saya', 'tidak', 'bisa', 'memgembalikan', 'akun', 'saya', 'email', 'pelanggan', 'pelayanan', 'pun', 'tidak', 'berguna', 'perbaikan', 'sistem', 'keamanan', 'kalian']","['akun', 'hack', 'orang', 'tidak', 'memgembalikan', 'akun', 'email', 'pelanggan', 'pelayanan', 'tidak', 'berguna', 'perbaikan', 'sistem', 'keamanan']",23,14,9,akun hack orang tidak memgembalikan akun email langgan layan tidak guna baik sistem aman,14,14
Bagus informasinya,positif,2024-04-27,2024,bagus informasinya,2,2,bagus informasinya,2,2,"['bagus', 'informasinya']","['bagus', 'informasinya']",2,2,0,bagus informasi,2,2
Apk gak jelas udah jelas-jelas saya nyari kerjaan baru malah harus ceri ini lah itu lah sama perusahaan lama udah jelas gak kerja lagi di sana kalo masih kerja gak akan cari kerjaan,negatif,2024-05-13,2024,apk gak jelas udah jelas jelas saya nyari kerjaan baru malah harus ceri ini lah itu lah sama perusahaan lama udah jelas gak kerja lagi di sana kalo masih kerja gak akan cari kerjaan,33,34,aplikasi tidak jelas sudah jelas jelas saya mencari kerjaan baru bahkan harus ceri ini lah itu lah sama perusahaan lama sudah jelas tidak kerja lagi di sana kalau masih kerja tidak akan cari kerjaan,34,34,"['aplikasi', 'tidak', 'jelas', 'sudah', 'jelas', 'jelas', 'saya', 'mencari', 'kerjaan', 'baru', 'bahkan', 'harus', 'ceri', 'ini', 'lah', 'itu', 'lah', 'sama', 'perusahaan', 'lama', 'sudah', 'jelas', 'tidak', 'kerja', 'lagi', 'di', 'sana', 'kalau', 'masih', 'kerja', 'tidak', 'akan', 'cari', 'kerjaan']","['aplikasi', 'tidak', 'mencari', 'kerjaan', 'ceri', 'perusahaan', 'tidak', 'kerja', 'kerja', 'tidak', 'cari', 'kerjaan']",34,12,22,aplikasi tidak cari kerja ceri usaha tidak kerja kerja tidak cari kerja,12,12
tidak bisa login...baru hendak mengetik alamat email sudah keluar aplikasi.,negatif,2021-03-18,2021,tidak bisa login baru hendak mengetik alamat email sudah keluar aplikasi,10,11,tidak bisa login baru hendak mengetik alamat email sudah keluar aplikasi,11,11,"['tidak', 'bisa', 'login', 'baru', 'hendak', 'mengetik', 'alamat', 'email', 'sudah', 'keluar', 'aplikasi']","['tidak', 'login', 'mengetik', 'alamat', 'email', 'aplikasi']",11,6,5,tidak login etik alamat email aplikasi,6,6
Sangat baik untuk menambah pengetahuan di berbagai dunia kerja,positif,2020-05-29,2020,sangat baik untuk menambah pengetahuan di berbagai dunia kerja,9,9,sangat baik untuk menambah pengetahuan di berbagai dunia kerja,9,9,"['sangat', 'baik', 'untuk', 'menambah', 'pengetahuan', 'di', 'berbagai', 'dunia', 'kerja']","['menambah', 'pengetahuan', 'dunia', 'kerja']",9,4,5,tambah tahu dunia kerja,4,4
Costumer servicenya bener bener buruk dan gak mau balas chat saya perihal akun restricted. Mohon untuk ditingkatkan lagi.,negatif,2023-08-11,2023,costumer servicenya bener bener buruk dan gak mau balas chat saya perihal akun restricted mohon untuk ditingkatkan lagi,18,18,pelanggan service nya benar benar buruk dan tidak mau balas chat saya perihal akun restricted mohon untuk ditingkatkan lagi,18,19,"['pelanggan', 'service', 'nya', 'benar', 'benar', 'buruk', 'dan', 'tidak', 'mau', 'balas', 'chat', 'saya', 'perihal', 'akun', 'restricted', 'mohon', 'untuk', 'ditingkatkan', 'lagi']","['pelanggan', 'service', 'nya', 'buruk', 'tidak', 'balas', 'chat', 'perihal', 'akun', 'restricted', 'mohon', 'ditingkatkan']",19,12,7,langgan service nya buruk tidak balas chat perihal akun restricted mohon tingkat,12,12
Gak jelas mau login aja susah padahal jaringan bagus banyak2 tes GAK JELAS!!!,negatif,2022-08-20,2022,gak jelas mau login aja susah padahal jaringan bagus banyak tes gak jelas,13,13,tidak jelas mau login saja susah padahal jaringan bagus banyak tes tidak jelas,13,13,"['tidak', 'jelas', 'mau', 'login', 'saja', 'susah', 'padahal', 'jaringan', 'bagus', 'banyak', 'tes', 'tidak', 'jelas']","['tidak', 'login', 'susah', 'jaringan', 'bagus', 'tes', 'tidak']",13,7,6,tidak login susah jaring bagus tes tidak,7,7
sangat bermanfaat,positif,2024-06-25,2024,sangat bermanfaat,2,2,sangat bermanfaat,2,2,"['sangat', 'bermanfaat']",['bermanfaat'],2,1,1,manfaat,1,1
Jelek bgt suka ngebug di bagian chapchanya sampai berulang2 kali nggk bisa terferivikasi.,negatif,2024-01-02,2024,jelek bgt suka ngebug di bagian chapchanya sampai berulang kali nggk bisa terferivikasi,13,13,jelek banget suka nge bug di bagian chapchanya sampai berulang kali tidak bisa terferivikasi,13,14,"['jelek', 'banget', 'suka', 'nge', 'bug', 'di', 'bagian', 'chapchanya', 'sampai', 'berulang', 'kali', 'tidak', 'bisa', 'terferivikasi']","['jelek', 'banget', 'suka', 'nge', 'bug', 'chapchanya', 'berulang', 'kali', 'tidak', 'terferivikasi']",14,10,4,jelek banget suka nge bug chapchanya ulang kali tidak terferivikasi,10,10
"Vertivasinya sangat susah lebih baik uninstall saja , masih banyak sosmed yg gampang",negatif,2023-05-19,2023,vertivasinya sangat susah lebih baik uninstall saja masih banyak sosmed yg gampang,13,12,vertivasinya sangat susah lebih baik uninstall saja masih banyak sosmed yang gampang,12,12,"['vertivasinya', 'sangat', 'susah', 'lebih', 'baik', 'uninstall', 'saja', 'masih', 'banyak', 'sosmed', 'yang', 'gampang']","['vertivasinya', 'susah', 'uninstall', 'sosmed', 'gampang']",12,5,7,vertivasinya susah uninstall sosmed gampang,5,5
"Cari kerja susah, ada aplikasi kerain mempermudah malah mempersulit hidup 😪",negatif,2023-06-13,2023,cari kerja susah ada aplikasi kerain mempermudah malah mempersulit hidup,11,10,cari kerja susah ada aplikasi kerain mempermudah bahkan mempersulit hidup,10,10,"['cari', 'kerja', 'susah', 'ada', 'aplikasi', 'kerain', 'mempermudah', 'bahkan', 'mempersulit', 'hidup']","['cari', 'kerja', 'susah', 'aplikasi', 'kerain', 'mempermudah', 'mempersulit', 'hidup']",10,8,2,cari kerja susah aplikasi kerain mudah sulit hidup,8,8
"Sangat mudah ketimbang dari web, setidaknya mendukung bahasa Indonesia",positif,2022-02-11,2022,sangat mudah ketimbang dari web setidaknya mendukung bahasa indonesia,9,9,sangat mudah ketimbang dari web setidaknya mendukung bahasa indonesia,9,9,"['sangat', 'mudah', 'ketimbang', 'dari', 'web', 'setidaknya', 'mendukung', 'bahasa', 'indonesia']","['mudah', 'ketimbang', 'web', 'mendukung', 'bahasa', 'indonesia']",9,6,3,mudah ketimbang web dukung bahasa indonesia,6,6
"Aplikasi cukup membantu untuk mencari kerja, tapi belum ada hasilnya saya dapat, semiga ada hasilnya dari aplikasi ini🙏",positif,2020-06-22,2020,aplikasi cukup membantu untuk mencari kerja tapi belum ada hasilnya saya dapat semiga ada hasilnya dari aplikasi ini,18,18,aplikasi cukup membantu untuk mencari kerja tapi belum ada hasilnya saya dapat semiga ada hasilnya dari aplikasi ini,18,18,"['aplikasi', 'cukup', 'membantu', 'untuk', 'mencari', 'kerja', 'tapi', 'belum', 'ada', 'hasilnya', 'saya', 'dapat', 'semiga', 'ada', 'hasilnya', 'dari', 'aplikasi', 'ini']","['aplikasi', 'membantu', 'mencari', 'kerja', 'hasilnya', 'semiga', 'hasilnya', 'aplikasi']",18,8,10,aplikasi bantu cari kerja hasil semiga hasil aplikasi,8,8
Linkedin lebih mudah dan praktis untuk loker mantap,positif,2020-06-29,2020,linkedin lebih mudah dan praktis untuk loker mantap,8,8,linkedin lebih mudah dan praktis untuk loker mantap,8,8,"['linkedin', 'lebih', 'mudah', 'dan', 'praktis', 'untuk', 'loker', 'mantap']","['linkedin', 'mudah', 'praktis', 'loker', 'mantap']",8,5,3,linkedin mudah praktis loker mantap,5,5
"semoga sukses terus dan bermanfaat buat yang membutuhkan selalu,,, sukses yerus",positif,2021-08-09,2021,semoga sukses terus dan bermanfaat buat yang membutuhkan selalu sukses yerus,11,11,semoga sukses terus dan bermanfaat buat yang membutuhkan selalu sukses yerus,11,11,"['semoga', 'sukses', 'terus', 'dan', 'bermanfaat', 'buat', 'yang', 'membutuhkan', 'selalu', 'sukses', 'yerus']","['semoga', 'sukses', 'bermanfaat', 'membutuhkan', 'sukses', 'yerus']",11,6,5,moga sukses manfaat butuh sukses yerus,6,6
Platform yang bagus untuk para profesionals,positif,2022-08-04,2022,platform yang bagus untuk para profesionals,6,6,platform yang bagus untuk para profesionals,6,6,"['platform', 'yang', 'bagus', 'untuk', 'para', 'profesionals']","['platform', 'bagus', 'profesionals']",6,3,3,platform bagus profesionals,3,3
Berkat LinkedIn... Lebih mudah mencari rekan kerja dan pekerjaan yang sesuai keahlian saya,positif,2023-07-23,2023,berkat linkedin lebih mudah mencari rekan kerja dan pekerjaan yang sesuai keahlian saya,13,13,berkat linkedin lebih mudah mencari rekan kerja dan pekerjaan yang sesuai keahlian saya,13,13,"['berkat', 'linkedin', 'lebih', 'mudah', 'mencari', 'rekan', 'kerja', 'dan', 'pekerjaan', 'yang', 'sesuai', 'keahlian', 'saya']","['berkat', 'linkedin', 'mudah', 'mencari', 'rekan', 'kerja', 'pekerjaan', 'sesuai', 'keahlian']",13,9,4,berkat linkedin mudah cari rekan kerja kerja sesuai ahli,9,9
Saya sangat membutuhkan pekerjaan daerah banyuwangi dan link ini sangat membantu untuk cari pekerjaan,positif,2022-07-21,2022,saya sangat membutuhkan pekerjaan daerah banyuwangi dan link ini sangat membantu untuk cari pekerjaan,14,14,saya sangat membutuhkan pekerjaan daerah banyuwangi dan link ini sangat membantu untuk cari pekerjaan,14,14,"['saya', 'sangat', 'membutuhkan', 'pekerjaan', 'daerah', 'banyuwangi', 'dan', 'link', 'ini', 'sangat', 'membantu', 'untuk', 'cari', 'pekerjaan']","['membutuhkan', 'pekerjaan', 'daerah', 'banyuwangi', 'link', 'membantu', 'cari', 'pekerjaan']",14,8,6,butuh kerja daerah banyuwangi link bantu cari kerja,8,8
Aplikasi ini sangat bagus sih tapi hadirkan dark mode ya di versi yang akan datang...,positif,2020-07-02,2020,aplikasi ini sangat bagus sih tapi hadirkan dark mode ya di versi yang akan datang,15,15,aplikasi ini sangat bagus sih tapi hadirkan dark mode ya di versi yang akan datang,15,15,"['aplikasi', 'ini', 'sangat', 'bagus', 'sih', 'tapi', 'hadirkan', 'dark', 'mode', 'ya', 'di', 'versi', 'yang', 'akan', 'datang']","['aplikasi', 'bagus', 'sih', 'hadirkan', 'dark', 'mode', 'ya', 'versi']",15,8,7,aplikasi bagus sih hadir dark mode ya versi,8,8
"Saya bekerja secara profesional. Teamwork. Baik mandiri maupun secara team, saya mampu berkomunikasi dengan baik",positif,2022-05-08,2022,saya bekerja secara profesional teamwork baik mandiri maupun secara team saya mampu berkomunikasi dengan baik,15,15,saya bekerja secara profesional teamwork baik mandiri maupun secara team saya mampu berkomunikasi dengan baik,15,15,"['saya', 'bekerja', 'secara', 'profesional', 'teamwork', 'baik', 'mandiri', 'maupun', 'secara', 'team', 'saya', 'mampu', 'berkomunikasi', 'dengan', 'baik']","['profesional', 'teamwork', 'mandiri', 'team', 'berkomunikasi']",15,5,10,profesional teamwork mandiri team komunikasi,5,5
Gak jelas dibuat verifikasi KTP terus Udah kirim foto KTP 3x tetep ajah gak bisa masuk. Niatnya ngehindarin hack yang ada malah nyusahin,negatif,2023-08-28,2023,gak jelas dibuat verifikasi ktp terus udah kirim foto ktp x tetep ajah gak bisa masuk niatnya ngehindarin hack yang ada malah nyusahin,23,23,tidak jelas dibuat verifikasi ktp terus sudah kirim foto ktp x tetap ajah tidak bisa masuk niatnya ngehindarin hack yang ada bahkan nyusahin,23,23,"['tidak', 'jelas', 'dibuat', 'verifikasi', 'ktp', 'terus', 'sudah', 'kirim', 'foto', 'ktp', 'x', 'tetap', 'ajah', 'tidak', 'bisa', 'masuk', 'niatnya', 'ngehindarin', 'hack', 'yang', 'ada', 'bahkan', 'nyusahin']","['tidak', 'verifikasi', 'ktp', 'kirim', 'foto', 'ktp', 'x', 'ajah', 'tidak', 'masuk', 'niatnya', 'ngehindarin', 'hack', 'nyusahin']",23,14,9,tidak verifikasi ktp kirim foto ktp x ajah tidak masuk niat ngehindarin hack nyusahin,14,14
"Teka teki nyusahin, gak masuk akal yang bikin program aplikasinya",negatif,2024-02-10,2024,teka teki nyusahin gak masuk akal yang bikin program aplikasinya,10,10,teka teki nyusahin tidak masuk akal yang bikin program aplikasi nya,10,11,"['teka', 'teki', 'nyusahin', 'tidak', 'masuk', 'akal', 'yang', 'bikin', 'program', 'aplikasi', 'nya']","['teka', 'teki', 'nyusahin', 'tidak', 'masuk', 'akal', 'bikin', 'program', 'aplikasi', 'nya']",11,10,1,teka teki nyusahin tidak masuk akal bikin program aplikasi nya,10,10
"Terhubung dengan orang-orang. Terhubung dengan Peluang. Aplikasi LinkedIn memudahkan untuk terhubung dengan orang-orang dan hal-hal yang penting untuk kehidupan profesional Anda. Bangun dan kembangkan jaringan profesional Anda, baca berita bisnis dan industri terbaru, dan temukan pekerjaan impian Anda. Semuanya dimulai dengan profil LinkedIn Anda. Di sini tidak hanya sekadar resume profesional Anda — tapi juga menunjukkan siapa diri Anda dan apa yang telah Anda capai dalam karier Anda. Ini bar",positif,2022-02-10,2022,terhubung dengan orang orang terhubung dengan peluang aplikasi linkedin memudahkan untuk terhubung dengan orang orang dan hal hal yang penting untuk kehidupan profesional anda bangun dan kembangkan jaringan profesional anda baca berita bisnis dan industri terbaru dan temukan pekerjaan impian anda semuanya dimulai dengan profil linkedin anda di sini tidak hanya sekadar resume profesional anda — tapi juga menunjukkan siapa diri anda dan apa yang telah anda capai dalam karier anda ini bar,70,73,terhubung dengan orang orang terhubung dengan peluang aplikasi linkedin memudahkan untuk terhubung dengan orang orang dan hal hal yang penting untuk kehidupan profesional anda bangun dan kembangkan jaringan profesional anda baca berita bisnis dan industri terbaru dan temukan pekerjaan impian anda semuanya dimulai dengan profil linkedin anda di sini tidak hanya sekadar resume profesional anda — tapi juga menunjukkan siapa diri anda dan apa yang telah anda capai dalam karier anda ini bar,73,73,"['terhubung', 'dengan', 'orang', 'orang', 'terhubung', 'dengan', 'peluang', 'aplikasi', 'linkedin', 'memudahkan', 'untuk', 'terhubung', 'dengan', 'orang', 'orang', 'dan', 'hal', 'hal', 'yang', 'penting', 'untuk', 'kehidupan', 'profesional', 'anda', 'bangun', 'dan', 'kembangkan', 'jaringan', 'profesional', 'anda', 'baca', 'berita', 'bisnis', 'dan', 'industri', 'terbaru', 'dan', 'temukan', 'pekerjaan', 'impian', 'anda', 'semuanya', 'dimulai', 'dengan', 'profil', 'linkedin', 'anda', 'di', 'sini', 'tidak', 'hanya', 'sekadar', 'resume', 'profesional', 'anda', '—', 'tapi', 'juga', 'menunjukkan', 'siapa', 'diri', 'anda', 'dan', 'apa', 'yang', 'telah', 'anda', 'capai', 'dalam', 'karier', 'anda', 'ini', 'bar']","['terhubung', 'orang', 'orang', 'terhubung', 'peluang', 'aplikasi', 'linkedin', 'memudahkan', 'terhubung', 'orang', 'orang', 'kehidupan', 'profesional', 'bangun', 'kembangkan', 'jaringan', 'profesional', 'baca', 'berita', 'bisnis', 'industri', 'terbaru', 'temukan', 'pekerjaan', 'impian', 'profil', 'linkedin', 'tidak', 'resume', 'profesional', '—', 'capai', 'karier', 'bar']",73,34,39,hubung orang orang hubung peluang aplikasi linkedin mudah hubung orang orang hidup profesional bangun kembang jaring profesional baca berita bisnis industri baru temu kerja impi profil linkedin tidak resume profesional capai karier bar,34,33
"Ga bisa login. Pas verifikasi, ngulang terus walau udah dapet jawaban ""selamat blablabla sudah membuktikan Anda manusia""",negatif,2024-03-07,2024,ga bisa login pas verifikasi ngulang terus walau udah dapet jawaban selamat blablabla sudah membuktikan anda manusia,17,17,tidak bisa login pas verifikasi mengulang terus walau sudah dapat jawaban selamat blablabla sudah membuktikan anda manusia,17,17,"['tidak', 'bisa', 'login', 'pas', 'verifikasi', 'mengulang', 'terus', 'walau', 'sudah', 'dapat', 'jawaban', 'selamat', 'blablabla', 'sudah', 'membuktikan', 'anda', 'manusia']","['tidak', 'login', 'pas', 'verifikasi', 'mengulang', 'selamat', 'blablabla', 'membuktikan', 'manusia']",17,9,8,tidak login pas verifikasi ulang selamat blablabla bukti manusia,9,9
Tidak bisa log in / daftar.. Udah coba Verifikasi berkali kali tapi tetep ga bisa,negatif,2021-09-26,2021,tidak bisa log in daftar udah coba verifikasi berkali kali tapi tetep ga bisa,15,14,tidak bisa log in daftar sudah coba verifikasi berkali kali tapi tetap tidak bisa,14,14,"['tidak', 'bisa', 'log', 'in', 'daftar', 'sudah', 'coba', 'verifikasi', 'berkali', 'kali', 'tapi', 'tetap', 'tidak', 'bisa']","['tidak', 'log', 'in', 'daftar', 'coba', 'verifikasi', 'berkali', 'kali', 'tidak']",14,9,5,tidak log in daftar coba verifikasi kali kali tidak,9,9
Kalo dibuka lewat web harusnya ngelink ya ke linked app nya..hadeh,negatif,2022-01-31,2022,kalo dibuka lewat web harusnya ngelink ya ke linked app nya hadeh,11,12,kalau dibuka lewat web harusnya ngelink ya ke linked aplikasi nya hadeh,12,12,"['kalau', 'dibuka', 'lewat', 'web', 'harusnya', 'ngelink', 'ya', 'ke', 'linked', 'aplikasi', 'nya', 'hadeh']","['dibuka', 'web', 'ngelink', 'ya', 'linked', 'aplikasi', 'nya', 'hadeh']",12,8,4,buka web ngelink ya linked aplikasi nya hadeh,8,8
"Terima Kasih, Tingkatkan lagi Performa Signal HP Jikalau Jauh Dari Pemancar Signal",positif,2020-08-28,2020,terima kasih tingkatkan lagi performa signal hp jikalau jauh dari pemancar signal,12,12,terima kasih tingkatkan lagi performa signal handphone jikalau jauh dari pemancar signal,12,12,"['terima', 'kasih', 'tingkatkan', 'lagi', 'performa', 'signal', 'handphone', 'jikalau', 'jauh', 'dari', 'pemancar', 'signal']","['terima', 'kasih', 'tingkatkan', 'performa', 'signal', 'handphone', 'pemancar', 'signal']",12,8,4,terima kasih tingkat performa signal handphone pancar signal,8,8
Rekomendasi buat cari pekerjaan,positif,2024-09-01,2024,rekomendasi buat cari pekerjaan,4,4,rekomendasi buat cari pekerjaan,4,4,"['rekomendasi', 'buat', 'cari', 'pekerjaan']","['rekomendasi', 'cari', 'pekerjaan']",4,3,1,rekomendasi cari kerja,3,3
Aplikasi Baik penuh skill dan komunikasi nya juga insfirasi,positif,2021-03-16,2021,aplikasi baik penuh skill dan komunikasi nya juga insfirasi,9,9,aplikasi baik penuh skill dan komunikasi nya juga insfirasi,9,9,"['aplikasi', 'baik', 'penuh', 'skill', 'dan', 'komunikasi', 'nya', 'juga', 'insfirasi']","['aplikasi', 'penuh', 'skill', 'komunikasi', 'nya', 'insfirasi']",9,6,3,aplikasi penuh skill komunikasi nya insfirasi,6,6
"Lowongan krja yg ditawarkn tingkat PROFESIONAL, tp persyaratan trlalu ketat membatasi pelamar yg profesional dlm mencari pekerjaan dr segi usia, disamakan dg pelamar menengah kebawah yg baru lulus kuliah. Gaji yg ditawarkan tuk profesional sgt TDK sesuai dg pengalaman kerjanya disamakan dg yg baru lulus kuliah. Informasi lowongan yang dibuka oleh Perusahaan kebanyakan hnya sbg syarat seorang HRD mencari kandidat, yg pd akhirnya mereka sdh menemukan calon karyawan, bnyak penipuan tnpa penyaringan",negatif,2020-11-10,2020,lowongan krja yg ditawarkn tingkat profesional tp persyaratan trlalu ketat membatasi pelamar yg profesional dlm mencari pekerjaan dr segi usia disamakan dg pelamar menengah kebawah yg baru lulus kuliah gaji yg ditawarkan tuk profesional sgt tdk sesuai dg pengalaman kerjanya disamakan dg yg baru lulus kuliah informasi lowongan yang dibuka oleh perusahaan kebanyakan hnya sbg syarat seorang hrd mencari kandidat yg pd akhirnya mereka sdh menemukan calon karyawan bnyak penipuan tnpa penyaringan,72,72,lowongan krja yang ditawarkn tingkat profesional tapi persyaratan terlalu ketat membatasi pelamar yang profesional dalam mencari pekerjaan dari segi usia disamakan dengan pelamar menengah kebawah yang baru lulus kuliah gaji yang ditawarkan untuk profesional sangat tidak sesuai dengan pengalaman kerjanya disamakan dengan yang baru lulus kuliah informasi lowongan yang dibuka oleh perusahaan kebanyakan hanya sebagai syarat seorang hrd mencari kandidat yang pada akhirnya mereka sudah menemukan calon karyawan banyak penipuan tanpa penyaringan,72,72,"['lowongan', 'krja', 'yang', 'ditawarkn', 'tingkat', 'profesional', 'tapi', 'persyaratan', 'terlalu', 'ketat', 'membatasi', 'pelamar', 'yang', 'profesional', 'dalam', 'mencari', 'pekerjaan', 'dari', 'segi', 'usia', 'disamakan', 'dengan', 'pelamar', 'menengah', 'kebawah', 'yang', 'baru', 'lulus', 'kuliah', 'gaji', 'yang', 'ditawarkan', 'untuk', 'profesional', 'sangat', 'tidak', 'sesuai', 'dengan', 'pengalaman', 'kerjanya', 'disamakan', 'dengan', 'yang', 'baru', 'lulus', 'kuliah', 'informasi', 'lowongan', 'yang', 'dibuka', 'oleh', 'perusahaan', 'kebanyakan', 'hanya', 'sebagai', 'syarat', 'seorang', 'hrd', 'mencari', 'kandidat', 'yang', 'pada', 'akhirnya', 'mereka', 'sudah', 'menemukan', 'calon', 'karyawan', 'banyak', 'penipuan', 'tanpa', 'penyaringan']","['lowongan', 'krja', 'ditawarkn', 'tingkat', 'profesional', 'persyaratan', 'ketat', 'membatasi', 'pelamar', 'profesional', 'mencari', 'pekerjaan', 'segi', 'usia', 'disamakan', 'pelamar', 'menengah', 'kebawah', 'lulus', 'kuliah', 'gaji', 'ditawarkan', 'profesional', 'tidak', 'sesuai', 'pengalaman', 'kerjanya', 'disamakan', 'lulus', 'kuliah', 'informasi', 'lowongan', 'dibuka', 'perusahaan', 'kebanyakan', 'syarat', 'hrd', 'mencari', 'kandidat', 'menemukan', 'calon', 'karyawan', 'penipuan', 'penyaringan']",72,44,28,lowong krja ditawarkn tingkat profesional syarat ketat batas lamar profesional cari kerja segi usia sama lamar tengah bawah lulus kuliah gaji tawar profesional tidak sesuai alam kerja sama lulus kuliah informasi lowong buka usaha banyak syarat hrd cari kandidat temu calon karyawan tipu nyaring,44,44
"""Aplikasi yang tepat, untuk sarana mencari atau di cari dalam peluang kerja yang kita harapkan ...",positif,2022-07-30,2022,aplikasi yang tepat untuk sarana mencari atau di cari dalam peluang kerja yang kita harapkan,16,15,aplikasi yang tepat untuk sarana mencari atau di cari dalam peluang kerja yang kita harapkan,15,15,"['aplikasi', 'yang', 'tepat', 'untuk', 'sarana', 'mencari', 'atau', 'di', 'cari', 'dalam', 'peluang', 'kerja', 'yang', 'kita', 'harapkan']","['aplikasi', 'sarana', 'mencari', 'cari', 'peluang', 'kerja', 'harapkan']",15,7,8,aplikasi sarana cari cari peluang kerja harap,7,7
"Aplikasi sangat bagus,untuk membangun komonikasi dengan orang-orang sekitar.",positif,2020-01-25,2020,aplikasi sangat bagus untuk membangun komonikasi dengan orang orang sekitar,8,10,aplikasi sangat bagus untuk membangun komonikasi dengan orang orang sekitar,10,10,"['aplikasi', 'sangat', 'bagus', 'untuk', 'membangun', 'komonikasi', 'dengan', 'orang', 'orang', 'sekitar']","['aplikasi', 'bagus', 'membangun', 'komonikasi', 'orang', 'orang']",10,6,4,aplikasi bagus bangun komonikasi orang orang,6,6
Mau daftar aja nggak bisa2! Login apalagi. Tolong diperbaiki!!,negatif,2021-06-04,2021,mau daftar aja nggak bisa login apalagi tolong diperbaiki,9,9,mau daftar saja tidak bisa login apalagi tolong di perbaiki,9,10,"['mau', 'daftar', 'saja', 'tidak', 'bisa', 'login', 'apalagi', 'tolong', 'di', 'perbaiki']","['daftar', 'tidak', 'login', 'tolong', 'perbaiki']",10,5,5,daftar tidak login tolong baik,5,5
"Memudahkan z bisa terhubung dengan teman,relasi dan pejuang pencari kerja untuk bisa mendapatkan informasi lebih banyak🙏",positif,2020-12-18,2020,memudahkan z bisa terhubung dengan teman relasi dan pejuang pencari kerja untuk bisa mendapatkan informasi lebih banyak,16,17,memudahkan z bisa terhubung dengan teman relasi dan pejuang pencari kerja untuk bisa mendapatkan informasi lebih banyak,17,17,"['memudahkan', 'z', 'bisa', 'terhubung', 'dengan', 'teman', 'relasi', 'dan', 'pejuang', 'pencari', 'kerja', 'untuk', 'bisa', 'mendapatkan', 'informasi', 'lebih', 'banyak']","['memudahkan', 'z', 'terhubung', 'teman', 'relasi', 'pejuang', 'pencari', 'kerja', 'informasi']",17,9,8,mudah z hubung teman relasi juang cari kerja informasi,9,9
Sangat membantu orang2 cari kerjaan dan yg gak ada ijazah juga sangar mudah cari kerjaan,positif,2023-06-04,2023,sangat membantu orang cari kerjaan dan yg gak ada ijazah juga sangar mudah cari kerjaan,15,15,sangat membantu orang cari kerjaan dan yang tidak ada ijazah juga sangar mudah cari kerjaan,15,15,"['sangat', 'membantu', 'orang', 'cari', 'kerjaan', 'dan', 'yang', 'tidak', 'ada', 'ijazah', 'juga', 'sangar', 'mudah', 'cari', 'kerjaan']","['membantu', 'orang', 'cari', 'kerjaan', 'tidak', 'ijazah', 'sangar', 'mudah', 'cari', 'kerjaan']",15,10,5,bantu orang cari kerja tidak ijazah sangar mudah cari kerja,10,10
"Parah, mengecewakan di bagian verifikasi gambar, 47 kali coba gagal2 trus uda sesuai ke atas, dasar verifikasi ampas THUOLOL GAGUNA MEMPERSULIT",negatif,2023-10-27,2023,parah mengecewakan di bagian verifikasi gambar kali coba gagal trus uda sesuai ke atas dasar verifikasi ampas thuolol gaguna mempersulit,21,20,parah mengecewakan di bagian verifikasi gambar kali coba gagal terus sudah sesuai ke atas dasar verifikasi ampas thuolol gaguna mempersulit,20,20,"['parah', 'mengecewakan', 'di', 'bagian', 'verifikasi', 'gambar', 'kali', 'coba', 'gagal', 'terus', 'sudah', 'sesuai', 'ke', 'atas', 'dasar', 'verifikasi', 'ampas', 'thuolol', 'gaguna', 'mempersulit']","['parah', 'mengecewakan', 'verifikasi', 'gambar', 'kali', 'coba', 'gagal', 'sesuai', 'dasar', 'verifikasi', 'ampas', 'thuolol', 'gaguna', 'mempersulit']",20,14,6,parah kecewa verifikasi gambar kali coba gagal sesuai dasar verifikasi ampas thuolol gaguna sulit,14,14
Sangat berguna untuk mempromosikan diri... Disamping juga untuk menambah rekan dan sahabat 👍,positif,2022-06-18,2022,sangat berguna untuk mempromosikan diri disamping juga untuk menambah rekan dan sahabat,13,12,sangat berguna untuk mempromosikan diri disamping juga untuk menambah rekan dan sahabat,12,12,"['sangat', 'berguna', 'untuk', 'mempromosikan', 'diri', 'disamping', 'juga', 'untuk', 'menambah', 'rekan', 'dan', 'sahabat']","['berguna', 'mempromosikan', 'disamping', 'menambah', 'rekan', 'sahabat']",12,6,6,guna promosi samping tambah rekan sahabat,6,6
aplikasi ini sangat membantu. untuk mencari perkerjaan yg sesuai dengan kita. ga nyesel poko nya,positif,2021-02-14,2021,aplikasi ini sangat membantu untuk mencari perkerjaan yg sesuai dengan kita ga nyesel poko nya,15,15,aplikasi ini sangat membantu untuk mencari perkerjaan yang sesuai dengan kita tidak menyesal poko nya,15,15,"['aplikasi', 'ini', 'sangat', 'membantu', 'untuk', 'mencari', 'perkerjaan', 'yang', 'sesuai', 'dengan', 'kita', 'tidak', 'menyesal', 'poko', 'nya']","['aplikasi', 'membantu', 'mencari', 'perkerjaan', 'sesuai', 'tidak', 'menyesal', 'poko', 'nya']",15,9,6,aplikasi bantu cari kerja sesuai tidak sesal poko nya,9,9
login susah banget gilaa!!,negatif,2024-06-05,2024,login susah banget gilaa,4,4,login susah banget gila,4,4,"['login', 'susah', 'banget', 'gila']","['login', 'susah', 'banget', 'gila']",4,4,0,login susah banget gila,4,4
"Produk nasa sangat bermanfaat, respon cepat. Puas akan layanan dan informasi yg diberikan bisa dimengerti",positif,2021-04-02,2021,produk nasa sangat bermanfaat respon cepat puas akan layanan dan informasi yg diberikan bisa dimengerti,15,15,produk nasa sangat bermanfaat respons cepat puas akan layanan dan informasi yang diberikan bisa dimengerti,15,15,"['produk', 'nasa', 'sangat', 'bermanfaat', 'respons', 'cepat', 'puas', 'akan', 'layanan', 'dan', 'informasi', 'yang', 'diberikan', 'bisa', 'dimengerti']","['produk', 'nasa', 'bermanfaat', 'respons', 'cepat', 'puas', 'layanan', 'informasi', 'dimengerti']",15,9,6,produk nasa manfaat respons cepat puas layan informasi erti,9,9
Selama mengikuti tayangan chaenel ini saya memang menyukai... Muda mudahan makin tambah bagus dan lebih menarik lagi...,positif,2020-07-24,2020,selama mengikuti tayangan chaenel ini saya memang menyukai muda mudahan makin tambah bagus dan lebih menarik lagi,17,17,selama mengikuti tayangan chaenel ini saya memang menyukai muda mudahan makin tambah bagus dan lebih menarik lagi,17,17,"['selama', 'mengikuti', 'tayangan', 'chaenel', 'ini', 'saya', 'memang', 'menyukai', 'muda', 'mudahan', 'makin', 'tambah', 'bagus', 'dan', 'lebih', 'menarik', 'lagi']","['mengikuti', 'tayangan', 'chaenel', 'menyukai', 'muda', 'mudahan', 'bagus', 'menarik']",17,8,9,ikut tayang chaenel suka muda mudah bagus tarik,8,8
"verifikasi pertama doang bisa,verifikasi selanjutnya kurang jelas ..mohon dperjelas Lagi dn keamananya.tq",negatif,2022-02-15,2022,verifikasi pertama doang bisa verifikasi selanjutnya kurang jelas mohon dperjelas lagi dn keamananya tq,12,14,verifikasi pertama saja bisa verifikasi selanjutnya kurang jelas mohon dperjelas lagi dan keamananya terima kasih,14,15,"['verifikasi', 'pertama', 'saja', 'bisa', 'verifikasi', 'selanjutnya', 'kurang', 'jelas', 'mohon', 'dperjelas', 'lagi', 'dan', 'keamananya', 'terima', 'kasih']","['verifikasi', 'verifikasi', 'mohon', 'dperjelas', 'keamananya', 'terima', 'kasih']",15,7,8,verifikasi verifikasi mohon dperjelas keamananya terima kasih,7,7
Dengan adanya Linkedln sangat membantu sekali dalam hal cari segala informasi. Linkdln sangat kami perlukan. Linkedln memang Siiiipppp 👍👍👍👍👋👋👋👋,positif,2022-07-12,2022,dengan adanya linkedln sangat membantu sekali dalam hal cari segala informasi linkdln sangat kami perlukan linkedln memang siiiipppp,19,18,dengan adanya linkedln sangat membantu sekali dalam hal cari segala informasi linkdln sangat kami perlukan linkedln memang siiiipppp,18,18,"['dengan', 'adanya', 'linkedln', 'sangat', 'membantu', 'sekali', 'dalam', 'hal', 'cari', 'segala', 'informasi', 'linkdln', 'sangat', 'kami', 'perlukan', 'linkedln', 'memang', 'siiiipppp']","['linkedln', 'membantu', 'cari', 'informasi', 'linkdln', 'perlukan', 'linkedln', 'siiiipppp']",18,8,10,linkedln bantu cari informasi linkdln perlu linkedln siiiipppp,8,8
"Aplikasi nutup sendiri trs ga bisa dibuka, padahal jaringan bagus🤐😷",negatif,2023-08-18,2023,aplikasi nutup sendiri trs ga bisa dibuka padahal jaringan bagus,10,10,aplikasi nutup sendiri terus tidak bisa dibuka padahal jaringan bagus,10,10,"['aplikasi', 'nutup', 'sendiri', 'terus', 'tidak', 'bisa', 'dibuka', 'padahal', 'jaringan', 'bagus']","['aplikasi', 'nutup', 'tidak', 'dibuka', 'jaringan', 'bagus']",10,6,4,aplikasi nutup tidak buka jaring bagus,6,6
Akun ku di hack .dan tidak bisa saya masuk ke akun saya lagi. Verifikasi rumit tidak bisa di selesaiakan sangat buruk,negatif,2024-03-28,2024,akun ku di hack dan tidak bisa saya masuk ke akun saya lagi verifikasi rumit tidak bisa di selesaiakan sangat buruk,21,21,akun saya di hack dan tidak bisa saya masuk ke akun saya lagi verifikasi rumit tidak bisa di selesaiakan sangat buruk,21,21,"['akun', 'saya', 'di', 'hack', 'dan', 'tidak', 'bisa', 'saya', 'masuk', 'ke', 'akun', 'saya', 'lagi', 'verifikasi', 'rumit', 'tidak', 'bisa', 'di', 'selesaiakan', 'sangat', 'buruk']","['akun', 'hack', 'tidak', 'masuk', 'akun', 'verifikasi', 'rumit', 'tidak', 'selesaiakan', 'buruk']",21,10,11,akun hack tidak masuk akun verifikasi rumit tidak selesaiakan buruk,10,10
"Banyak loker bodong berkedok ruko di sini,kenapa ya emng Ga di filter lagi setiap informasi loker yang mau di share",negatif,2023-09-18,2023,banyak loker bodong berkedok ruko di sini kenapa ya emng ga di filter lagi setiap informasi loker yang mau di share,20,21,banyak loker bodong berkedok ruko di sini kenapa ya memang tidak di filter lagi setiap informasi loker yang mau di share,21,21,"['banyak', 'loker', 'bodong', 'berkedok', 'ruko', 'di', 'sini', 'kenapa', 'ya', 'memang', 'tidak', 'di', 'filter', 'lagi', 'setiap', 'informasi', 'loker', 'yang', 'mau', 'di', 'share']","['loker', 'bodong', 'berkedok', 'ruko', 'ya', 'tidak', 'filter', 'informasi', 'loker', 'share']",21,10,11,loker bodong kedok ruko ya tidak filter informasi loker share,10,10
Sangat ok cepat dan tepat untuk segala aktifitas bisnis,positif,2021-03-17,2021,sangat ok cepat dan tepat untuk segala aktifitas bisnis,9,9,sangat oke cepat dan tepat untuk segala aktifitas bisnis,9,9,"['sangat', 'oke', 'cepat', 'dan', 'tepat', 'untuk', 'segala', 'aktifitas', 'bisnis']","['oke', 'cepat', 'aktifitas', 'bisnis']",9,4,5,oke cepat aktifitas bisnis,4,4
Update ap.ikasinya terlalu cepat tgl 6 desember di update tgl 14desember sdhminta update lagi,negatif,2022-12-15,2022,update ap ikasinya terlalu cepat tgl desember di update tgl desember sdhminta update lagi,14,14,diperbarui apa ikasinya terlalu cepat tanggal desember di diperbarui tanggal desember sdhminta diperbarui lagi,14,14,"['diperbarui', 'apa', 'ikasinya', 'terlalu', 'cepat', 'tanggal', 'desember', 'di', 'diperbarui', 'tanggal', 'desember', 'sdhminta', 'diperbarui', 'lagi']","['diperbarui', 'ikasinya', 'cepat', 'tanggal', 'desember', 'diperbarui', 'tanggal', 'desember', 'sdhminta', 'diperbarui']",14,10,4,baru ikasinya cepat tanggal desember baru tanggal desember sdhminta baru,10,10
"Bintang 1000, menjadikan perjalanan karir dengan cara yang mudah dan menyenangkan",positif,2022-06-25,2022,bintang menjadikan perjalanan karir dengan cara yang mudah dan menyenangkan,11,10,bintang menjadikan perjalanan karir dengan cara yang mudah dan menyenangkan,10,10,"['bintang', 'menjadikan', 'perjalanan', 'karir', 'dengan', 'cara', 'yang', 'mudah', 'dan', 'menyenangkan']","['bintang', 'menjadikan', 'perjalanan', 'karir', 'mudah', 'menyenangkan']",10,6,4,bintang jadi jalan karir mudah senang,6,6
"aplikasi yang sangat bagus untuk cari pekerjaan jadi lebih mudah, dan menambah banyak relasi dan wawasan",positif,2023-08-12,2023,aplikasi yang sangat bagus untuk cari pekerjaan jadi lebih mudah dan menambah banyak relasi dan wawasan,16,16,aplikasi yang sangat bagus untuk cari pekerjaan jadi lebih mudah dan menambah banyak relasi dan wawasan,16,16,"['aplikasi', 'yang', 'sangat', 'bagus', 'untuk', 'cari', 'pekerjaan', 'jadi', 'lebih', 'mudah', 'dan', 'menambah', 'banyak', 'relasi', 'dan', 'wawasan']","['aplikasi', 'bagus', 'cari', 'pekerjaan', 'mudah', 'menambah', 'relasi', 'wawasan']",16,8,8,aplikasi bagus cari kerja mudah tambah relasi wawas,8,8
"Verifikasi gambar nya susah amat, udah bener terus aja ngulang",negatif,2023-08-17,2023,verifikasi gambar nya susah amat udah bener terus aja ngulang,10,10,verifikasi gambar nya susah amat sudah benar terus saja mengulang,10,10,"['verifikasi', 'gambar', 'nya', 'susah', 'amat', 'sudah', 'benar', 'terus', 'saja', 'mengulang']","['verifikasi', 'gambar', 'nya', 'susah', 'mengulang']",10,5,5,verifikasi gambar nya susah ulang,5,5
Yaa lumayan mantap,positif,2024-06-08,2024,yaa lumayan mantap,3,3,ya lumayan mantap,3,3,"['ya', 'lumayan', 'mantap']","['ya', 'lumayan', 'mantap']",3,3,0,ya lumayan mantap,3,3
"Sangat membantu dalam mencari pekerjaan, relasi, dll.",positif,2020-06-29,2020,sangat membantu dalam mencari pekerjaan relasi dll,7,7,sangat membantu dalam mencari pekerjaan relasi dan lain lain,7,9,"['sangat', 'membantu', 'dalam', 'mencari', 'pekerjaan', 'relasi', 'dan', 'lain', 'lain']","['membantu', 'mencari', 'pekerjaan', 'relasi']",9,4,5,bantu cari kerja relasi,4,4
Aplikasi ini sangat membantu bagi para pejuang Pencari kerja. Sangat bagus,positif,2022-07-28,2022,aplikasi ini sangat membantu bagi para pejuang pencari kerja sangat bagus,11,11,aplikasi ini sangat membantu bagi para pejuang pencari kerja sangat bagus,11,11,"['aplikasi', 'ini', 'sangat', 'membantu', 'bagi', 'para', 'pejuang', 'pencari', 'kerja', 'sangat', 'bagus']","['aplikasi', 'membantu', 'pejuang', 'pencari', 'kerja', 'bagus']",11,6,5,aplikasi bantu juang cari kerja bagus,6,6
"Aplikasi yang amat memudahkan saya untuk mencari magang ,benar2 sangat berguna sekali!",positif,2022-07-31,2022,aplikasi yang amat memudahkan saya untuk mencari magang benar sangat berguna sekali,12,12,aplikasi yang amat memudahkan saya untuk mencari magang benar sangat berguna sekali,12,12,"['aplikasi', 'yang', 'amat', 'memudahkan', 'saya', 'untuk', 'mencari', 'magang', 'benar', 'sangat', 'berguna', 'sekali']","['aplikasi', 'memudahkan', 'mencari', 'magang', 'berguna']",12,5,7,aplikasi mudah cari magang guna,5,5
Saya disuruh isi opsi industri. Tapi sudah diisi tetap aja dianggap belum diisi. Tolong diperbaiki.,negatif,2023-10-31,2023,saya disuruh isi opsi industri tapi sudah diisi tetap aja dianggap belum diisi tolong diperbaiki,15,15,saya disuruh isi opsi industri tapi sudah diisi tetap saja dianggap belum diisi tolong di perbaiki,15,16,"['saya', 'disuruh', 'isi', 'opsi', 'industri', 'tapi', 'sudah', 'diisi', 'tetap', 'saja', 'dianggap', 'belum', 'diisi', 'tolong', 'di', 'perbaiki']","['disuruh', 'isi', 'opsi', 'industri', 'diisi', 'dianggap', 'diisi', 'tolong', 'perbaiki']",16,9,7,suruh isi opsi industri isi anggap isi tolong baik,9,9
Saya sudah sejak bulan lalu sulit membatalkan premium saya dan akhirnya saya kena tagihan lagi bln ini. Menyebalkan,negatif,2021-05-24,2021,saya sudah sejak bulan lalu sulit membatalkan premium saya dan akhirnya saya kena tagihan lagi bln ini menyebalkan,18,18,saya sudah sejak bulan lalu sulit membatalkan premium saya dan akhirnya saya kena tagihan lagi bulan ini menyebalkan,18,18,"['saya', 'sudah', 'sejak', 'bulan', 'lalu', 'sulit', 'membatalkan', 'premium', 'saya', 'dan', 'akhirnya', 'saya', 'kena', 'tagihan', 'lagi', 'bulan', 'ini', 'menyebalkan']","['sulit', 'membatalkan', 'premium', 'kena', 'tagihan', 'menyebalkan']",18,6,12,sulit batal premium kena tagih sebal,6,6
"Captcha selalu eror tidak bisa log in, payah",negatif,2024-03-08,2024,captcha selalu eror tidak bisa log in payah,8,8,captcha selalu error tidak bisa log in payah,8,8,"['captcha', 'selalu', 'error', 'tidak', 'bisa', 'log', 'in', 'payah']","['captcha', 'error', 'tidak', 'log', 'in', 'payah']",8,6,2,captcha error tidak log in payah,6,6
"Maaf ya, saya kasi bintang 1 sekarang. Belakangan ini saya tidak bisa lagi share link video YouTube ke LinkedIn. Belakangan ini aplikasi LinkedIn eror. Aplikasi LinkedIn terpaksa saya uninstall sekarang!!!!",negatif,2021-09-21,2021,maaf ya saya kasi bintang sekarang belakangan ini saya tidak bisa lagi share link video youtube ke linkedin belakangan ini aplikasi linkedin eror aplikasi linkedin terpaksa saya uninstall sekarang,30,29,maaf ya saya kasih bintang sekarang belakangan ini saya tidak bisa lagi share link video youtube ke linkedin belakangan ini aplikasi linkedin error aplikasi linkedin terpaksa saya uninstall sekarang,29,29,"['maaf', 'ya', 'saya', 'kasih', 'bintang', 'sekarang', 'belakangan', 'ini', 'saya', 'tidak', 'bisa', 'lagi', 'share', 'link', 'video', 'youtube', 'ke', 'linkedin', 'belakangan', 'ini', 'aplikasi', 'linkedin', 'error', 'aplikasi', 'linkedin', 'terpaksa', 'saya', 'uninstall', 'sekarang']","['maaf', 'ya', 'kasih', 'bintang', 'tidak', 'share', 'link', 'video', 'youtube', 'linkedin', 'aplikasi', 'linkedin', 'error', 'aplikasi', 'linkedin', 'terpaksa', 'uninstall']",29,17,12,maaf ya kasih bintang tidak share link video youtube linkedin aplikasi linkedin error aplikasi linkedin paksa uninstall,17,17
Saya suka saya suka tapi penggunanya 30 mb yah biar hemat kuota data,positif,2023-07-13,2023,saya suka saya suka tapi penggunanya mb yah biar hemat kuota data,13,12,saya suka saya suka tapi penggunanya mb ya biar hemat kuota data,12,12,"['saya', 'suka', 'saya', 'suka', 'tapi', 'penggunanya', 'mb', 'ya', 'biar', 'hemat', 'kuota', 'data']","['suka', 'suka', 'penggunanya', 'mb', 'ya', 'biar', 'hemat', 'kuota', 'data']",12,9,3,suka suka guna mb ya biar hemat kuota data,9,9
Menambah Jaringan Profesional dan memperbesar peluang baru.,positif,2020-06-04,2020,menambah jaringan profesional dan memperbesar peluang baru,7,7,menambah jaringan profesional dan memperbesar peluang baru,7,7,"['menambah', 'jaringan', 'profesional', 'dan', 'memperbesar', 'peluang', 'baru']","['menambah', 'jaringan', 'profesional', 'memperbesar', 'peluang']",7,5,2,tambah jaring profesional besar peluang,5,5
Sangat membantu dan bermanfaat untuk membangun jaringan bisnis yang sangat luas,positif,2020-02-26,2020,sangat membantu dan bermanfaat untuk membangun jaringan bisnis yang sangat luas,11,11,sangat membantu dan bermanfaat untuk membangun jaringan bisnis yang sangat luas,11,11,"['sangat', 'membantu', 'dan', 'bermanfaat', 'untuk', 'membangun', 'jaringan', 'bisnis', 'yang', 'sangat', 'luas']","['membantu', 'bermanfaat', 'membangun', 'jaringan', 'bisnis', 'luas']",11,6,5,bantu manfaat bangun jaring bisnis luas,6,6
Mau daftar tapi ada teka teki segala dan salah terus😭,negatif,2022-02-28,2022,mau daftar tapi ada teka teki segala dan salah terus,10,10,mau daftar tapi ada teka teki segala dan salah terus,10,10,"['mau', 'daftar', 'tapi', 'ada', 'teka', 'teki', 'segala', 'dan', 'salah', 'terus']","['daftar', 'teka', 'teki', 'salah']",10,4,6,daftar teka teki salah,4,4
"Sudah verifikasi tapi tidak bisa masuk, kembali ke verifikasi padahal udah benar",negatif,2023-11-06,2023,sudah verifikasi tapi tidak bisa masuk kembali ke verifikasi padahal udah benar,12,12,sudah verifikasi tapi tidak bisa masuk kembali ke verifikasi padahal sudah benar,12,12,"['sudah', 'verifikasi', 'tapi', 'tidak', 'bisa', 'masuk', 'kembali', 'ke', 'verifikasi', 'padahal', 'sudah', 'benar']","['verifikasi', 'tidak', 'masuk', 'verifikasi']",12,4,8,verifikasi tidak masuk verifikasi,4,4
Bagus sih tapi kenapa sekarang mau login aja susah ya sekarang🥹,positif,2024-06-12,2024,bagus sih tapi kenapa sekarang mau login aja susah ya sekarang,11,11,bagus sih tapi kenapa sekarang mau login saja susah ya sekarang,11,11,"['bagus', 'sih', 'tapi', 'kenapa', 'sekarang', 'mau', 'login', 'saja', 'susah', 'ya', 'sekarang']","['bagus', 'sih', 'login', 'susah', 'ya']",11,5,6,bagus sih login susah ya,5,5
"Aksesnya sangat sulit, verifikasi yang diminta berulang-ulang",negatif,2022-07-05,2022,aksesnya sangat sulit verifikasi yang diminta berulang ulang,7,8,aksesnya sangat sulit verifikasi yang diminta berulang ulang,8,8,"['aksesnya', 'sangat', 'sulit', 'verifikasi', 'yang', 'diminta', 'berulang', 'ulang']","['aksesnya', 'sulit', 'verifikasi', 'berulang', 'ulang']",8,5,3,akses sulit verifikasi ulang ulang,5,5
Sentuh gambar hadap atas.tpi selalu ups kurang tepat.hddhhhh apaann.gk jelas bgt,negatif,2021-10-15,2021,sentuh gambar hadap atas tpi selalu ups kurang tepat hddhhhh apaann gk jelas bgt,11,14,sentuh gambar hadap atas tetapi selalu ups kurang tepat hddhhhh apaann tidak jelas banget,14,14,"['sentuh', 'gambar', 'hadap', 'atas', 'tetapi', 'selalu', 'ups', 'kurang', 'tepat', 'hddhhhh', 'apaann', 'tidak', 'jelas', 'banget']","['sentuh', 'gambar', 'hadap', 'ups', 'hddhhhh', 'apaann', 'tidak', 'banget']",14,8,6,sentuh gambar hadap ups hddhhhh apaann tidak banget,8,8
applikasi yg bagus untuk jaringan perkerjaan,positif,2020-05-19,2020,applikasi yg bagus untuk jaringan perkerjaan,6,6,aplikasi yang bagus untuk jaringan perkerjaan,6,6,"['aplikasi', 'yang', 'bagus', 'untuk', 'jaringan', 'perkerjaan']","['aplikasi', 'bagus', 'jaringan', 'perkerjaan']",6,4,2,aplikasi bagus jaring kerja,4,4
Lagi mencari yang cocok lagian pesaing loker sangat berat soal kalah jauh lagi sama yang sekarang ini,positif,2023-01-16,2023,lagi mencari yang cocok lagian pesaing loker sangat berat soal kalah jauh lagi sama yang sekarang ini,17,17,lagi mencari yang cocok lagian pesaing loker sangat berat soal kalah jauh lagi sama yang sekarang ini,17,17,"['lagi', 'mencari', 'yang', 'cocok', 'lagian', 'pesaing', 'loker', 'sangat', 'berat', 'soal', 'kalah', 'jauh', 'lagi', 'sama', 'yang', 'sekarang', 'ini']","['mencari', 'cocok', 'pesaing', 'loker', 'berat', 'kalah']",17,6,11,cari cocok saing loker berat kalah,6,6
"Tolong untuk bisa langsung lamar lewat linkdln langsung, jangan malah prantara untuk daftar di web hire today atau yg lain lagi. Thanks.",negatif,2021-02-01,2021,tolong untuk bisa langsung lamar lewat linkdln langsung jangan malah prantara untuk daftar di web hire today atau yg lain lagi thanks,22,22,tolong untuk bisa langsung lamar lewat linkdln langsung jangan bahkan prantara untuk daftar di web hire today atau yang lain lagi terima kasih,22,23,"['tolong', 'untuk', 'bisa', 'langsung', 'lamar', 'lewat', 'linkdln', 'langsung', 'jangan', 'bahkan', 'prantara', 'untuk', 'daftar', 'di', 'web', 'hire', 'today', 'atau', 'yang', 'lain', 'lagi', 'terima', 'kasih']","['tolong', 'langsung', 'lamar', 'linkdln', 'langsung', 'prantara', 'daftar', 'web', 'hire', 'today', 'terima', 'kasih']",23,12,11,tolong langsung lamar linkdln langsung prantara daftar web hire today terima kasih,12,12
"Jelek banget, pas verifikasi gak masuk akal. Sudah di coba berkali kali tetap salah",negatif,2021-10-15,2021,jelek banget pas verifikasi gak masuk akal sudah di coba berkali kali tetap salah,14,14,jelek banget pas verifikasi tidak masuk akal sudah di coba berkali kali tetap salah,14,14,"['jelek', 'banget', 'pas', 'verifikasi', 'tidak', 'masuk', 'akal', 'sudah', 'di', 'coba', 'berkali', 'kali', 'tetap', 'salah']","['jelek', 'banget', 'pas', 'verifikasi', 'tidak', 'masuk', 'akal', 'coba', 'berkali', 'kali', 'salah']",14,11,3,jelek banget pas verifikasi tidak masuk akal coba kali kali salah,11,11
"Gak bisa kirim pesan,masa harus upgrade ke premium dulu,mana mahal juga",negatif,2022-06-13,2022,gak bisa kirim pesan masa harus upgrade ke premium dulu mana mahal juga,11,13,tidak bisa kirim pesan masa harus upgrade ke premium dahulu mana mahal juga,13,13,"['tidak', 'bisa', 'kirim', 'pesan', 'masa', 'harus', 'upgrade', 'ke', 'premium', 'dahulu', 'mana', 'mahal', 'juga']","['tidak', 'kirim', 'pesan', 'upgrade', 'premium', 'mahal']",13,6,7,tidak kirim pesan upgrade premium mahal,6,6
"Saya agak ragu ragu lo, apalagi bawa bank mandiri soalnya ini, apa lagi nunggu panggilan.. Takutnya saya benar benar di tipu oleh aplikasi ini.",negatif,2022-02-07,2022,saya agak ragu ragu lo apalagi bawa bank mandiri soalnya ini apa lagi nunggu panggilan takutnya saya benar benar di tipu oleh aplikasi ini,24,24,saya agak ragu ragu lo apalagi bawa bank mandiri soalnya ini apa lagi tunggu panggilan takutnya saya benar benar di tipu oleh aplikasi ini,24,24,"['saya', 'agak', 'ragu', 'ragu', 'lo', 'apalagi', 'bawa', 'bank', 'mandiri', 'soalnya', 'ini', 'apa', 'lagi', 'tunggu', 'panggilan', 'takutnya', 'saya', 'benar', 'benar', 'di', 'tipu', 'oleh', 'aplikasi', 'ini']","['ragu', 'ragu', 'lo', 'bawa', 'bank', 'mandiri', 'tunggu', 'panggilan', 'takutnya', 'tipu', 'aplikasi']",24,11,13,ragu ragu lo bawa bank mandiri tunggu panggil takut tipu aplikasi,11,11
Aplikasi tidak berguna,negatif,2024-06-22,2024,aplikasi tidak berguna,3,3,aplikasi tidak berguna,3,3,"['aplikasi', 'tidak', 'berguna']","['aplikasi', 'tidak', 'berguna']",3,3,0,aplikasi tidak guna,3,3
"Ini knpa jadi error mulu?masuk aja ga bisa, edit juga ga bisa di save",negatif,2023-12-13,2023,ini knpa jadi error mulu masuk aja ga bisa edit juga ga bisa di save,14,15,ini kenapa jadi error mulu masuk saja tidak bisa edit juga tidak bisa di save,15,15,"['ini', 'kenapa', 'jadi', 'error', 'mulu', 'masuk', 'saja', 'tidak', 'bisa', 'edit', 'juga', 'tidak', 'bisa', 'di', 'save']","['error', 'mulu', 'masuk', 'tidak', 'edit', 'tidak', 'save']",15,7,8,error mulu masuk tidak edit tidak save,7,7
"Aplikasinya keren, mudah untuk informasi dunia lowongan kerja",positif,2023-07-23,2023,aplikasinya keren mudah untuk informasi dunia lowongan kerja,8,8,aplikasi nya keren mudah untuk informasi dunia lowongan kerja,8,9,"['aplikasi', 'nya', 'keren', 'mudah', 'untuk', 'informasi', 'dunia', 'lowongan', 'kerja']","['aplikasi', 'nya', 'keren', 'mudah', 'informasi', 'dunia', 'lowongan', 'kerja']",9,8,1,aplikasi nya keren mudah informasi dunia lowong kerja,8,8
sangat baik menghubungkan segala profesi dan relasi segala latar belakang,positif,2021-07-26,2021,sangat baik menghubungkan segala profesi dan relasi segala latar belakang,10,10,sangat baik menghubungkan segala profesi dan relasi segala latar belakang,10,10,"['sangat', 'baik', 'menghubungkan', 'segala', 'profesi', 'dan', 'relasi', 'segala', 'latar', 'belakang']","['menghubungkan', 'profesi', 'relasi', 'latar']",10,4,6,hubung profesi relasi latar,4,4
"Buat naik tensi aj ni app, dah tau login lgsung pake email tp ending ny minta email lg utk msuk",negatif,2021-10-13,2021,buat naik tensi aj ni app dah tau login lgsung pake email tp ending ny minta email lg utk msuk,20,20,buat naik tensi saja ini aplikasi sudah tahu login lgsung pakai email tapi ending nya minta email lagi untuk msuk,20,20,"['buat', 'naik', 'tensi', 'saja', 'ini', 'aplikasi', 'sudah', 'tahu', 'login', 'lgsung', 'pakai', 'email', 'tapi', 'ending', 'nya', 'minta', 'email', 'lagi', 'untuk', 'msuk']","['tensi', 'aplikasi', 'login', 'lgsung', 'pakai', 'email', 'ending', 'nya', 'email', 'msuk']",20,10,10,tensi aplikasi login lgsung pakai email ending nya email msuk,10,10
Sangat membantu untuk mencari rekan kerja dan mencari kerja,positif,2020-07-30,2020,sangat membantu untuk mencari rekan kerja dan mencari kerja,9,9,sangat membantu untuk mencari rekan kerja dan mencari kerja,9,9,"['sangat', 'membantu', 'untuk', 'mencari', 'rekan', 'kerja', 'dan', 'mencari', 'kerja']","['membantu', 'mencari', 'rekan', 'kerja', 'mencari', 'kerja']",9,6,3,bantu cari rekan kerja cari kerja,6,6
"Tolong perbaiki akun saya yang tidak bisa menggunakan fitur ""easy apply""",negatif,2023-12-28,2023,tolong perbaiki akun saya yang tidak bisa menggunakan fitur easy apply,11,11,tolong perbaikan akun saya yang tidak bisa menggunakan fitur easy apply,11,11,"['tolong', 'perbaikan', 'akun', 'saya', 'yang', 'tidak', 'bisa', 'menggunakan', 'fitur', 'easy', 'apply']","['tolong', 'perbaikan', 'akun', 'tidak', 'fitur', 'easy', 'apply']",11,7,4,tolong baik akun tidak fitur easy apply,7,7
Sudah 2mingguan aplikasinya saat dibuka sering close sendiri terus...,negatif,2020-07-17,2020,sudah mingguan aplikasinya saat dibuka sering close sendiri terus,9,9,sudah mingguan aplikasi nya saat dibuka sering close sendiri terus,9,10,"['sudah', 'mingguan', 'aplikasi', 'nya', 'saat', 'dibuka', 'sering', 'close', 'sendiri', 'terus']","['mingguan', 'aplikasi', 'nya', 'dibuka', 'close']",10,5,5,minggu aplikasi nya buka close,5,5
Lumayan membantu. Tapi rata² loker yg dipasang jauh²,positif,2022-05-17,2022,lumayan membantu tapi rata² loker yg dipasang jauh²,8,8,lumayan membantu tapi rata² loker yang ditampilkan jauh²,8,8,"['lumayan', 'membantu', 'tapi', 'rata²', 'loker', 'yang', 'ditampilkan', 'jauh²']","['lumayan', 'membantu', 'rata²', 'loker', 'ditampilkan', 'jauh²']",8,6,2,lumayan bantu rata loker tampil jauh,6,6
"Gak buat eangsran tapi ke baned, parahnya lagi udah buat akun malah gak bisa di liat atau di cari not found",negatif,2023-12-27,2023,gak buat eangsran tapi ke baned parahnya lagi udah buat akun malah gak bisa di liat atau di cari not found,21,21,tidak buat eangsran tapi ke baned parahnya lagi sudah buat akun bahkan tidak bisa di lihat atau di cari not found,21,21,"['tidak', 'buat', 'eangsran', 'tapi', 'ke', 'baned', 'parahnya', 'lagi', 'sudah', 'buat', 'akun', 'bahkan', 'tidak', 'bisa', 'di', 'lihat', 'atau', 'di', 'cari', 'not', 'found']","['tidak', 'eangsran', 'baned', 'parahnya', 'akun', 'tidak', 'lihat', 'cari', 'not', 'found']",21,10,11,tidak eangsran baned parah akun tidak lihat cari not found,10,10
"Saya suka Aplikasi LinkedIn , memiliki manfaat untuk Saya dalam membangun relasi .",positif,2022-12-02,2022,saya suka aplikasi linkedin memiliki manfaat untuk saya dalam membangun relasi,13,11,saya suka aplikasi linkedin memiliki manfaat untuk saya dalam membangun relasi,11,11,"['saya', 'suka', 'aplikasi', 'linkedin', 'memiliki', 'manfaat', 'untuk', 'saya', 'dalam', 'membangun', 'relasi']","['suka', 'aplikasi', 'linkedin', 'memiliki', 'manfaat', 'membangun', 'relasi']",11,7,4,suka aplikasi linkedin milik manfaat bangun relasi,7,7
"recaptha udah berhasil, tapi malah ngulang terus sampe 20 kali. alhasil kesel saya uninstall saya kasih bintang 1",negatif,2023-05-09,2023,recaptha udah berhasil tapi malah ngulang terus sampe kali alhasil kesel saya uninstall saya kasih bintang,18,16,recaptha sudah berhasil tapi bahkan mengulang terus sampai kali alhasil kesel saya uninstall saya kasih bintang,16,16,"['recaptha', 'sudah', 'berhasil', 'tapi', 'bahkan', 'mengulang', 'terus', 'sampai', 'kali', 'alhasil', 'kesel', 'saya', 'uninstall', 'saya', 'kasih', 'bintang']","['recaptha', 'berhasil', 'mengulang', 'kali', 'alhasil', 'kesel', 'uninstall', 'kasih', 'bintang']",16,9,7,recaptha hasil ulang kali alhasil kesel uninstall kasih bintang,9,9
"Kurangin dulu 2 bintang, mau nambah koneksi malah dikira bot. Hadeh hadeh",negatif,2023-11-27,2023,kurangin dulu bintang mau nambah koneksi malah dikira bot hadeh hadeh,12,11,kurangin dahulu bintang mau nambah koneksi bahkan dikira bot hadeh hadeh,11,11,"['kurangin', 'dahulu', 'bintang', 'mau', 'nambah', 'koneksi', 'bahkan', 'dikira', 'bot', 'hadeh', 'hadeh']","['kurangin', 'bintang', 'nambah', 'koneksi', 'bot', 'hadeh', 'hadeh']",11,7,4,rangin bintang nambah koneksi bot hadeh hadeh,7,7
"Kenapa ga bisa di edit deskripsinya, mau dibenerin bagian deskripsinya",negatif,2022-09-29,2022,kenapa ga bisa di edit deskripsinya mau dibenerin bagian deskripsinya,10,10,kenapa tidak bisa di edit deskripsinya mau dibenerin bagian deskripsinya,10,10,"['kenapa', 'tidak', 'bisa', 'di', 'edit', 'deskripsinya', 'mau', 'dibenerin', 'bagian', 'deskripsinya']","['tidak', 'edit', 'deskripsinya', 'dibenerin', 'deskripsinya']",10,5,5,tidak edit deskripsi dibenerin deskripsi,5,5
"susah bgt buat login, sama proses verifikasinya lemot",negatif,2024-01-06,2024,susah bgt buat login sama proses verifikasinya lemot,8,8,susah banget buat login sama proses verifikasinya lambat,8,8,"['susah', 'banget', 'buat', 'login', 'sama', 'proses', 'verifikasinya', 'lambat']","['susah', 'banget', 'login', 'proses', 'verifikasinya', 'lambat']",8,6,2,susah banget login proses verifikasi lambat,6,6
Memudahkan melamar pekerjaan dan mendapatkan berita terkini dengan mudah.,positif,2024-02-01,2024,memudahkan melamar pekerjaan dan mendapatkan berita terkini dengan mudah,9,9,memudahkan melamar pekerjaan dan mendapatkan berita terkini dengan mudah,9,9,"['memudahkan', 'melamar', 'pekerjaan', 'dan', 'mendapatkan', 'berita', 'terkini', 'dengan', 'mudah']","['memudahkan', 'melamar', 'pekerjaan', 'berita', 'terkini', 'mudah']",9,6,3,mudah lamar kerja berita kini mudah,6,6
"Aplikasi nggak berguna , mau verifikasi aja tidak bisa..",negatif,2023-05-31,2023,aplikasi nggak berguna mau verifikasi aja tidak bisa,9,8,aplikasi tidak berguna mau verifikasi saja tidak bisa,8,8,"['aplikasi', 'tidak', 'berguna', 'mau', 'verifikasi', 'saja', 'tidak', 'bisa']","['aplikasi', 'tidak', 'berguna', 'verifikasi', 'tidak']",8,5,3,aplikasi tidak guna verifikasi tidak,5,5
Verifikasi sangat menyebalkan. Sudah benar masih tetap salah. Payah.,negatif,2023-01-02,2023,verifikasi sangat menyebalkan sudah benar masih tetap salah payah,9,9,verifikasi sangat menyebalkan sudah benar masih tetap salah payah,9,9,"['verifikasi', 'sangat', 'menyebalkan', 'sudah', 'benar', 'masih', 'tetap', 'salah', 'payah']","['verifikasi', 'menyebalkan', 'salah', 'payah']",9,4,5,verifikasi sebal salah payah,4,4
"Ribet banget najis, verifikasi nya",negatif,2024-03-15,2024,ribet banget najis verifikasi nya,5,5,rumit banget najis verifikasi nya,5,5,"['rumit', 'banget', 'najis', 'verifikasi', 'nya']","['rumit', 'banget', 'najis', 'verifikasi', 'nya']",5,5,0,rumit banget najis verifikasi nya,5,5
"Gabisa login, selalu aja abis ngisi teka teki muncul tulisan merah diatas bahwa kode captcha tidak valid, ngeselin banget",negatif,2023-08-16,2023,gabisa login selalu aja abis ngisi teka teki muncul tulisan merah diatas bahwa kode captcha tidak valid ngeselin banget,19,19,tidak bisa login selalu saja habis mengisi teka teki muncul tulisan merah diatas bahwa kode captcha tidak valid ngeselin banget,19,20,"['tidak', 'bisa', 'login', 'selalu', 'saja', 'habis', 'mengisi', 'teka', 'teki', 'muncul', 'tulisan', 'merah', 'diatas', 'bahwa', 'kode', 'captcha', 'tidak', 'valid', 'ngeselin', 'banget']","['tidak', 'login', 'habis', 'mengisi', 'teka', 'teki', 'muncul', 'tulisan', 'merah', 'diatas', 'kode', 'captcha', 'tidak', 'valid', 'ngeselin', 'banget']",20,16,4,tidak login habis isi teka teki muncul tulis merah atas kode captcha tidak valid ngeselin banget,16,16
Mudah mudahan dengan terhubungnya di LinkedIn banyak teman,positif,2022-08-29,2022,mudah mudahan dengan terhubungnya di linkedin banyak teman,8,8,mudah mudahan dengan terhubungnya di linkedin banyak teman,8,8,"['mudah', 'mudahan', 'dengan', 'terhubungnya', 'di', 'linkedin', 'banyak', 'teman']","['mudah', 'mudahan', 'terhubungnya', 'linkedin', 'teman']",8,5,3,mudah mudah hubung linkedin teman,5,5
Pada saat login semua nya bagus..,positif,2023-07-01,2023,pada saat login semua nya bagus,6,6,pada saat login semua nya bagus,6,6,"['pada', 'saat', 'login', 'semua', 'nya', 'bagus']","['login', 'nya', 'bagus']",6,3,3,login nya bagus,3,3
Verifikasinya konyol. Suru pilih gambar yg menghadap ke atas tapi smuanya hadap atas gambarnya.,negatif,2022-04-24,2022,verifikasinya konyol suru pilih gambar yg menghadap ke atas tapi smuanya hadap atas gambarnya,14,14,verifikasinya konyol suru pilih gambar yang menghadap ke atas tapi semuanya hadap atas gambarnya,14,14,"['verifikasinya', 'konyol', 'suru', 'pilih', 'gambar', 'yang', 'menghadap', 'ke', 'atas', 'tapi', 'semuanya', 'hadap', 'atas', 'gambarnya']","['verifikasinya', 'konyol', 'suru', 'pilih', 'gambar', 'menghadap', 'hadap', 'gambarnya']",14,8,6,verifikasi konyol suru pilih gambar hadap hadap gambar,8,8
Tidak ramah untuk lulusan sma sederajat,negatif,2024-07-14,2024,tidak ramah untuk lulusan sma sederajat,6,6,tidak ramah untuk lulusan sama sederajat,6,6,"['tidak', 'ramah', 'untuk', 'lulusan', 'sama', 'sederajat']","['tidak', 'ramah', 'lulusan', 'sederajat']",6,4,2,tidak ramah lulus derajat,4,4
Semoga ajbdengan ada aplikasi Linkedln mempermudah mencari pekerjaan yg sesuai good,positif,2023-05-17,2023,semoga ajbdengan ada aplikasi linkedln mempermudah mencari pekerjaan yg sesuai good,11,11,semoga ajbdengan ada aplikasi linkedln mempermudah mencari pekerjaan yang sesuai bagus,11,11,"['semoga', 'ajbdengan', 'ada', 'aplikasi', 'linkedln', 'mempermudah', 'mencari', 'pekerjaan', 'yang', 'sesuai', 'bagus']","['semoga', 'ajbdengan', 'aplikasi', 'linkedln', 'mempermudah', 'mencari', 'pekerjaan', 'sesuai', 'bagus']",11,9,2,moga ajbdengan aplikasi linkedln mudah cari kerja sesuai bagus,9,9
"MAU RESET PASSWORD AJA SUSAH, MALAH DI BOLAK BALIK TERUS DI BAGIAN VERIFIKASI KODE EMAIL",negatif,2024-06-12,2024,mau reset password aja susah malah di bolak balik terus di bagian verifikasi kode email,15,15,mau reset password saja susah bahkan di bolak balik terus di bagian verifikasi kode email,15,15,"['mau', 'reset', 'password', 'saja', 'susah', 'bahkan', 'di', 'bolak', 'balik', 'terus', 'di', 'bagian', 'verifikasi', 'kode', 'email']","['reset', 'password', 'susah', 'bolak', 'verifikasi', 'kode', 'email']",15,7,8,reset password susah bolak verifikasi kode email,7,7
"Login nya susah, minta captcha terus. Perbaiki. Thank You",negatif,2024-03-04,2024,login nya susah minta captcha terus perbaiki thank you,9,9,login nya susah minta captcha terus perbaikan terima kasih you,9,10,"['login', 'nya', 'susah', 'minta', 'captcha', 'terus', 'perbaikan', 'terima', 'kasih', 'you']","['login', 'nya', 'susah', 'captcha', 'perbaikan', 'terima', 'kasih', 'you']",10,8,2,login nya susah captcha baik terima kasih you,8,8
Linked  tidak bisa login. Mengalami eror tidak di kenal.,negatif,2020-12-01,2020,linked tidak bisa login mengalami eror tidak di kenal,9,9,linked tidak bisa login mengalami error tidak di kenal,9,9,"['linked', 'tidak', 'bisa', 'login', 'mengalami', 'error', 'tidak', 'di', 'kenal']","['linked', 'tidak', 'login', 'mengalami', 'error', 'tidak', 'kenal']",9,7,2,linked tidak login alami error tidak kenal,7,7
Kode nya lama banget sampe gabisa pake nomor telepon lagi kudu pake nomor baru,negatif,2023-12-12,2023,kode nya lama banget sampe gabisa pake nomor telepon lagi kudu pake nomor baru,14,14,kode nya lama banget sampai tidak bisa pakai nomor telpon lagi kudu pakai nomor baru,14,15,"['kode', 'nya', 'lama', 'banget', 'sampai', 'tidak', 'bisa', 'pakai', 'nomor', 'telpon', 'lagi', 'kudu', 'pakai', 'nomor', 'baru']","['kode', 'nya', 'banget', 'tidak', 'pakai', 'nomor', 'telpon', 'kudu', 'pakai', 'nomor']",15,10,5,kode nya banget tidak pakai nomor telpon kudu pakai nomor,10,10
Akun saya tiba-tiba dinonaktifkan sedangkan akunnya untuk tugas kuliah. Jadi mohon bantuannya untuk mengaktifkan kembali akun saya. Atau ada cara lain. Mohon segera tangani ini. Terimakasih,negatif,2021-10-24,2021,akun saya tiba tiba dinonaktifkan sedangkan akunnya untuk tugas kuliah jadi mohon bantuannya untuk mengaktifkan kembali akun saya atau ada cara lain mohon segera tangani ini terimakasih,26,27,akun saya tiba tiba dinonaktifkan sedangkan akunnya untuk tugas kuliah jadi mohon bantuannya untuk mengaktifkan kembali akun saya atau ada cara lain mohon segera tangani ini terima kasih,27,28,"['akun', 'saya', 'tiba', 'tiba', 'dinonaktifkan', 'sedangkan', 'akunnya', 'untuk', 'tugas', 'kuliah', 'jadi', 'mohon', 'bantuannya', 'untuk', 'mengaktifkan', 'kembali', 'akun', 'saya', 'atau', 'ada', 'cara', 'lain', 'mohon', 'segera', 'tangani', 'ini', 'terima', 'kasih']","['akun', 'dinonaktifkan', 'akunnya', 'tugas', 'kuliah', 'mohon', 'bantuannya', 'mengaktifkan', 'akun', 'mohon', 'tangani', 'terima', 'kasih']",28,13,15,akun nonaktif akun tugas kuliah mohon bantu aktif akun mohon tangan terima kasih,13,13
"Verifikasi reChapta saat login mengganggu banget,dan ga valid-valid reChapta nya.",negatif,2024-01-16,2024,verifikasi rechapta saat login mengganggu banget dan ga valid valid rechapta nya,10,12,verifikasi rechapta saat login mengganggu banget dan tidak valid valid rechapta nya,12,12,"['verifikasi', 'rechapta', 'saat', 'login', 'mengganggu', 'banget', 'dan', 'tidak', 'valid', 'valid', 'rechapta', 'nya']","['verifikasi', 'rechapta', 'login', 'mengganggu', 'banget', 'tidak', 'valid', 'valid', 'rechapta', 'nya']",12,10,2,verifikasi rechapta login ganggu banget tidak valid valid rechapta nya,10,10
"Sangat memuaskan, dan sangat membantu saya mencari pekerjaan.",positif,2020-09-18,2020,sangat memuaskan dan sangat membantu saya mencari pekerjaan,8,8,sangat memuaskan dan sangat membantu saya mencari pekerjaan,8,8,"['sangat', 'memuaskan', 'dan', 'sangat', 'membantu', 'saya', 'mencari', 'pekerjaan']","['memuaskan', 'membantu', 'mencari', 'pekerjaan']",8,4,4,muas bantu cari kerja,4,4
sangat membantu dan memperrmudah dalam mencari teman dan pwkerjaan,positif,2020-06-17,2020,sangat membantu dan memperrmudah dalam mencari teman dan pwkerjaan,9,9,sangat membantu dan memperrmudah dalam mencari teman dan pwkerjaan,9,9,"['sangat', 'membantu', 'dan', 'memperrmudah', 'dalam', 'mencari', 'teman', 'dan', 'pwkerjaan']","['membantu', 'memperrmudah', 'mencari', 'teman', 'pwkerjaan']",9,5,4,bantu memperrmudah cari teman pwkerjaan,5,5
Sangag berguna menambah wawasan dan koneksi,positif,2020-10-19,2020,sangag berguna menambah wawasan dan koneksi,6,6,sangag berguna menambah wawasan dan koneksi,6,6,"['sangag', 'berguna', 'menambah', 'wawasan', 'dan', 'koneksi']","['sangag', 'berguna', 'menambah', 'wawasan', 'koneksi']",6,5,1,sangag guna tambah wawas koneksi,5,5
"Aplikasi yang bermanfaat untuk mencari kerja, menambah relasi, dan wawasan mengenai pekerjaan",positif,2022-03-19,2022,aplikasi yang bermanfaat untuk mencari kerja menambah relasi dan wawasan mengenai pekerjaan,12,12,aplikasi yang bermanfaat untuk mencari kerja menambah relasi dan wawasan mengenai pekerjaan,12,12,"['aplikasi', 'yang', 'bermanfaat', 'untuk', 'mencari', 'kerja', 'menambah', 'relasi', 'dan', 'wawasan', 'mengenai', 'pekerjaan']","['aplikasi', 'bermanfaat', 'mencari', 'kerja', 'menambah', 'relasi', 'wawasan', 'pekerjaan']",12,8,4,aplikasi manfaat cari kerja tambah relasi wawas kerja,8,8
Berawal dari fresgreduwet bisa mendapatkan pekerjaan di LinkedIn ini,positif,2024-04-18,2024,berawal dari fresgreduwet bisa mendapatkan pekerjaan di linkedin ini,9,9,berawal dari fresgreduwet bisa mendapatkan pekerjaan di linkedin ini,9,9,"['berawal', 'dari', 'fresgreduwet', 'bisa', 'mendapatkan', 'pekerjaan', 'di', 'linkedin', 'ini']","['fresgreduwet', 'pekerjaan', 'linkedin']",9,3,6,fresgreduwet kerja linkedin,3,3
"Sangat keren, tapi permudahkan lagi agar bisa mengganti foto Profil ,",positif,2020-06-04,2020,sangat keren tapi permudahkan lagi agar bisa mengganti foto profil,11,10,sangat keren tapi permudahkan lagi agar bisa mengganti foto profil,10,10,"['sangat', 'keren', 'tapi', 'permudahkan', 'lagi', 'agar', 'bisa', 'mengganti', 'foto', 'profil']","['keren', 'permudahkan', 'mengganti', 'foto', 'profil']",10,5,5,keren mudah ganti foto profil,5,5
"Terima kasih. Aplikasinya keren, bisa untuk silaturahmi, cari rekan bisnis DLL.",positif,2021-08-24,2021,terima kasih aplikasinya keren bisa untuk silaturahmi cari rekan bisnis dll,11,11,terima kasih aplikasi nya keren bisa untuk silaturahmi cari rekan bisnis dan lain lain,11,14,"['terima', 'kasih', 'aplikasi', 'nya', 'keren', 'bisa', 'untuk', 'silaturahmi', 'cari', 'rekan', 'bisnis', 'dan', 'lain', 'lain']","['terima', 'kasih', 'aplikasi', 'nya', 'keren', 'silaturahmi', 'cari', 'rekan', 'bisnis']",14,9,5,terima kasih aplikasi nya keren silaturahmi cari rekan bisnis,9,9
Sangat membantu bagi pencari lowongan pekerjaan asal betul-betul sesuai dengan pengumuman lowongan,positif,2021-12-26,2021,sangat membantu bagi pencari lowongan pekerjaan asal betul betul sesuai dengan pengumuman lowongan,12,13,sangat membantu bagi pencari lowongan pekerjaan asal betul betul sesuai dengan pengumuman lowongan,13,13,"['sangat', 'membantu', 'bagi', 'pencari', 'lowongan', 'pekerjaan', 'asal', 'betul', 'betul', 'sesuai', 'dengan', 'pengumuman', 'lowongan']","['membantu', 'pencari', 'lowongan', 'pekerjaan', 'sesuai', 'pengumuman', 'lowongan']",13,7,6,bantu cari lowong kerja sesuai umum lowong,7,7
Aplikasi sangat baik dan sangat mendukung untuk karier,positif,2020-07-05,2020,aplikasi sangat baik dan sangat mendukung untuk karier,8,8,aplikasi sangat baik dan sangat mendukung untuk karier,8,8,"['aplikasi', 'sangat', 'baik', 'dan', 'sangat', 'mendukung', 'untuk', 'karier']","['aplikasi', 'mendukung', 'karier']",8,3,5,aplikasi dukung karier,3,3
"Mau masuk aja susah,harus ada tebak tebak n kayak bocah SD aja mana gambar nya gak jelas lagi",negatif,2022-10-12,2022,mau masuk aja susah harus ada tebak tebak n kayak bocah sd aja mana gambar nya gak jelas lagi,18,19,mau masuk saja susah harus ada tebak tebak dan kayak bocah sudah saja mana gambar nya tidak jelas lagi,19,19,"['mau', 'masuk', 'saja', 'susah', 'harus', 'ada', 'tebak', 'tebak', 'dan', 'kayak', 'bocah', 'sudah', 'saja', 'mana', 'gambar', 'nya', 'tidak', 'jelas', 'lagi']","['masuk', 'susah', 'tebak', 'tebak', 'kayak', 'bocah', 'gambar', 'nya', 'tidak']",19,9,10,masuk susah tebak tebak kayak bocah gambar nya tidak,9,9
Ya tuhan daftar gimana nih mbak/mas saya pusing tolonglah jangan bikin saya emosi di suruh pilih gambar kodok menghadap ke atas uda puluhan kali saya coba gk bisa mau masuk akun pake no juga gagak mulu pake suara uda gagal juga😭 tolong saya kenapa ada aplikasi daftar sesusah ini saya pusing saya emosi tekan kodok dari tadik gagal mulu ok ok relax.. Sabar sabar sabar orang sabar di sayang tuhan...,negatif,2021-12-07,2021,ya tuhan daftar gimana nih mbak mas saya pusing tolonglah jangan bikin saya emosi di suruh pilih gambar kodok menghadap ke atas uda puluhan kali saya coba gk bisa mau masuk akun pake no juga gagak mulu pake suara uda gagal juga tolong saya kenapa ada aplikasi daftar sesusah ini saya pusing saya emosi tekan kodok dari tadik gagal mulu ok ok relax sabar sabar sabar orang sabar di sayang tuhan,70,71,ya tuhan daftar bagaimana nih mbak mas saya pusing tolonglah jangan bikin saya emosi di suruh pilih gambar kodok menghadap ke atas sudah puluhan kali saya coba tidak bisa mau masuk akun pakai nomor juga gagak mulu pakai suara sudah gagal juga tolong saya kenapa ada aplikasi daftar sesusah ini saya pusing saya emosi tekan kodok dari tadik gagal mulu oke oke relax sabar sabar sabar orang sabar di sayang tuhan,71,71,"['ya', 'tuhan', 'daftar', 'bagaimana', 'nih', 'mbak', 'mas', 'saya', 'pusing', 'tolonglah', 'jangan', 'bikin', 'saya', 'emosi', 'di', 'suruh', 'pilih', 'gambar', 'kodok', 'menghadap', 'ke', 'atas', 'sudah', 'puluhan', 'kali', 'saya', 'coba', 'tidak', 'bisa', 'mau', 'masuk', 'akun', 'pakai', 'nomor', 'juga', 'gagak', 'mulu', 'pakai', 'suara', 'sudah', 'gagal', 'juga', 'tolong', 'saya', 'kenapa', 'ada', 'aplikasi', 'daftar', 'sesusah', 'ini', 'saya', 'pusing', 'saya', 'emosi', 'tekan', 'kodok', 'dari', 'tadik', 'gagal', 'mulu', 'oke', 'oke', 'relax', 'sabar', 'sabar', 'sabar', 'orang', 'sabar', 'di', 'sayang', 'tuhan']","['ya', 'tuhan', 'daftar', 'nih', 'mbak', 'mas', 'pusing', 'tolonglah', 'bikin', 'emosi', 'suruh', 'pilih', 'gambar', 'kodok', 'menghadap', 'puluhan', 'kali', 'coba', 'tidak', 'masuk', 'akun', 'pakai', 'nomor', 'gagak', 'mulu', 'pakai', 'suara', 'gagal', 'tolong', 'aplikasi', 'daftar', 'sesusah', 'pusing', 'emosi', 'tekan', 'kodok', 'tadik', 'gagal', 'mulu', 'oke', 'oke', 'relax', 'sabar', 'sabar', 'sabar', 'orang', 'sabar', 'sayang', 'tuhan']",71,49,22,ya tuhan daftar nih mbak mas pusing tolong bikin emosi suruh pilih gambar kodok hadap puluh kali coba tidak masuk akun pakai nomor gagak mulu pakai suara gagal tolong aplikasi daftar susah pusing emosi tekan kodok tadik gagal mulu oke oke relax sabar sabar sabar orang sabar sayang tuhan,49,49
Aplikasi yang sangat positif buat semua kalangan ... Pokoe ada yang baper 👍,positif,2020-08-31,2020,aplikasi yang sangat positif buat semua kalangan pokoe ada yang baper,13,11,aplikasi yang sangat positif buat semua kalangan pokoknya ada yang baper,11,11,"['aplikasi', 'yang', 'sangat', 'positif', 'buat', 'semua', 'kalangan', 'pokoknya', 'ada', 'yang', 'baper']","['aplikasi', 'positif', 'kalangan', 'pokoknya', 'baper']",11,5,6,aplikasi positif kalang pokok baper,5,5
"Dua kali akun dibatasi tiba tiba, aneh. Udah verifikasi data masih aja.",negatif,2023-07-17,2023,dua kali akun dibatasi tiba tiba aneh udah verifikasi data masih aja,12,12,dua kali akun dibatasi tiba tiba aneh sudah verifikasi data masih saja,12,12,"['dua', 'kali', 'akun', 'dibatasi', 'tiba', 'tiba', 'aneh', 'sudah', 'verifikasi', 'data', 'masih', 'saja']","['kali', 'akun', 'dibatasi', 'aneh', 'verifikasi', 'data']",12,6,6,kali akun batas aneh verifikasi data,6,6
"Cari pekerjaan lebih mudah, & banyak relasi yg bisa diikuti supaya tambah wawasan",positif,2023-07-26,2023,cari pekerjaan lebih mudah banyak relasi yg bisa diikuti supaya tambah wawasan,13,12,cari pekerjaan lebih mudah banyak relasi yang bisa diikuti supaya tambah wawasan,12,12,"['cari', 'pekerjaan', 'lebih', 'mudah', 'banyak', 'relasi', 'yang', 'bisa', 'diikuti', 'supaya', 'tambah', 'wawasan']","['cari', 'pekerjaan', 'mudah', 'relasi', 'diikuti', 'wawasan']",12,6,6,cari kerja mudah relasi ikut wawas,6,6
aplikasi sangat membantu dlm mencari teman dan pekerjaan,positif,2020-09-22,2020,aplikasi sangat membantu dlm mencari teman dan pekerjaan,8,8,aplikasi sangat membantu dalam mencari teman dan pekerjaan,8,8,"['aplikasi', 'sangat', 'membantu', 'dalam', 'mencari', 'teman', 'dan', 'pekerjaan']","['aplikasi', 'membantu', 'mencari', 'teman', 'pekerjaan']",8,5,3,aplikasi bantu cari teman kerja,5,5
Aplikasi bagus buat para pencari kerja dan head hunter,positif,2020-07-06,2020,aplikasi bagus buat para pencari kerja dan head hunter,9,9,aplikasi bagus buat para pencari kerja dan head hunter,9,9,"['aplikasi', 'bagus', 'buat', 'para', 'pencari', 'kerja', 'dan', 'head', 'hunter']","['aplikasi', 'bagus', 'pencari', 'kerja', 'head', 'hunter']",9,6,3,aplikasi bagus cari kerja head hunter,6,6
apk bagus dan sangat bermanfaar untuk menambah relasi,positif,2020-06-27,2020,apk bagus dan sangat bermanfaar untuk menambah relasi,8,8,aplikasi bagus dan sangat bermanfaar untuk menambah relasi,8,8,"['aplikasi', 'bagus', 'dan', 'sangat', 'bermanfaar', 'untuk', 'menambah', 'relasi']","['aplikasi', 'bagus', 'bermanfaar', 'menambah', 'relasi']",8,5,3,aplikasi bagus bermanfaar tambah relasi,5,5
Wahh apk ini sangat wortit karen ini semacam sosmed khusus dunia kerja dan kegiatn lomba maupun organisasi sehingga kita bisa bangun relationship dan memperluas jaringan kita dengan orang berprestasi lainnya,positif,2023-11-28,2023,wahh apk ini sangat wortit karen ini semacam sosmed khusus dunia kerja dan kegiatn lomba maupun organisasi sehingga kita bisa bangun relationship dan memperluas jaringan kita dengan orang berprestasi lainnya,30,30,wah aplikasi ini sangat wortit karen ini semacam sosmed khusus dunia kerja dan kegiatn lomba maupun organisasi sehingga kita bisa bangun relationship dan memperluas jaringan kita dengan orang berprestasi lainnya,30,30,"['wah', 'aplikasi', 'ini', 'sangat', 'wortit', 'karen', 'ini', 'semacam', 'sosmed', 'khusus', 'dunia', 'kerja', 'dan', 'kegiatn', 'lomba', 'maupun', 'organisasi', 'sehingga', 'kita', 'bisa', 'bangun', 'relationship', 'dan', 'memperluas', 'jaringan', 'kita', 'dengan', 'orang', 'berprestasi', 'lainnya']","['aplikasi', 'wortit', 'karen', 'sosmed', 'khusus', 'dunia', 'kerja', 'kegiatn', 'lomba', 'organisasi', 'bangun', 'relationship', 'memperluas', 'jaringan', 'orang', 'berprestasi']",30,16,14,aplikasi wortit karen sosmed khusus dunia kerja kegiatn lomba organisasi bangun relationship luas jaring orang prestasi,16,16
"Tidak bisa Login , user and pass sudah bener",negatif,2022-06-16,2022,tidak bisa login user and pass sudah bener,9,8,tidak bisa login user and pass sudah benar,8,8,"['tidak', 'bisa', 'login', 'user', 'and', 'pass', 'sudah', 'benar']","['tidak', 'login', 'user', 'and', 'pass']",8,5,3,tidak login user and pass,5,5
"Mendapat banyak relasi bisnis, banyak channel pekerjaan terbuka, pertahankan kualitas",positif,2022-07-19,2022,mendapat banyak relasi bisnis banyak channel pekerjaan terbuka pertahankan kualitas,10,10,mendapat banyak relasi bisnis banyak channel pekerjaan terbuka pertahankan kualitas,10,10,"['mendapat', 'banyak', 'relasi', 'bisnis', 'banyak', 'channel', 'pekerjaan', 'terbuka', 'pertahankan', 'kualitas']","['relasi', 'bisnis', 'channel', 'pekerjaan', 'terbuka', 'pertahankan', 'kualitas']",10,7,3,relasi bisnis channel kerja buka tahan kualitas,7,7
Aplikasi mobile masih ada bug,negatif,2024-08-19,2024,aplikasi mobile masih ada bug,5,5,aplikasi mobile masih ada bug,5,5,"['aplikasi', 'mobile', 'masih', 'ada', 'bug']","['aplikasi', 'mobile', 'bug']",5,3,2,aplikasi mobile bug,3,3
Sangat membantu dan memudahkan dalam perjalanan,positif,2024-05-15,2024,sangat membantu dan memudahkan dalam perjalanan,6,6,sangat membantu dan memudahkan dalam perjalanan,6,6,"['sangat', 'membantu', 'dan', 'memudahkan', 'dalam', 'perjalanan']","['membantu', 'memudahkan', 'perjalanan']",6,3,3,bantu mudah jalan,3,3
"Lain kali kalau buat verifikasi diperhatikan itu susah, harusnya dipermudah bukan dipersusah",negatif,2023-02-03,2023,lain kali kalau buat verifikasi diperhatikan itu susah harusnya dipermudah bukan dipersusah,12,12,lain kali kalau buat verifikasi diperhatikan itu susah harusnya dipermudah bukan dipersusah,12,12,"['lain', 'kali', 'kalau', 'buat', 'verifikasi', 'diperhatikan', 'itu', 'susah', 'harusnya', 'dipermudah', 'bukan', 'dipersusah']","['kali', 'verifikasi', 'diperhatikan', 'susah', 'dipermudah', 'dipersusah']",12,6,6,kali verifikasi perhati susah mudah susah,6,6
Akun tiba tiba keluar dan ga bisa login lagi,negatif,2024-04-04,2024,akun tiba tiba keluar dan ga bisa login lagi,9,9,akun tiba tiba keluar dan tidak bisa login lagi,9,9,"['akun', 'tiba', 'tiba', 'keluar', 'dan', 'tidak', 'bisa', 'login', 'lagi']","['akun', 'tidak', 'login']",9,3,6,akun tidak login,3,3
"Agar bisa mendapat jaringan dan relasi terbaik,",positif,2020-11-21,2020,agar bisa mendapat jaringan dan relasi terbaik,7,7,agar bisa mendapat jaringan dan relasi terbaik,7,7,"['agar', 'bisa', 'mendapat', 'jaringan', 'dan', 'relasi', 'terbaik']","['jaringan', 'relasi', 'terbaik']",7,3,4,jaring relasi baik,3,3
"Sudah memilih gambar yang benar untuk verifikasi anda manusia, berulang kali tetap salah.buruk",negatif,2023-11-19,2023,sudah memilih gambar yang benar untuk verifikasi anda manusia berulang kali tetap salah buruk,13,14,sudah memilih gambar yang benar untuk verifikasi anda manusia berulang kali tetap salah buruk,14,14,"['sudah', 'memilih', 'gambar', 'yang', 'benar', 'untuk', 'verifikasi', 'anda', 'manusia', 'berulang', 'kali', 'tetap', 'salah', 'buruk']","['memilih', 'gambar', 'verifikasi', 'manusia', 'berulang', 'kali', 'salah', 'buruk']",14,8,6,pilih gambar verifikasi manusia ulang kali salah buruk,8,8
"profil linkedin pada gak keliatan, padahal udah diperbarui 😭",negatif,2024-03-06,2024,profil linkedin pada gak keliatan padahal udah diperbarui,9,8,profil linkedin pada tidak kelihatan padahal sudah diperbarui,8,8,"['profil', 'linkedin', 'pada', 'tidak', 'kelihatan', 'padahal', 'sudah', 'diperbarui']","['profil', 'linkedin', 'tidak', 'diperbarui']",8,4,4,profil linkedin tidak baru,4,4
"sangat membantu, sayang nya iklan sangat menggangu",positif,2024-06-01,2024,sangat membantu sayang nya iklan sangat menggangu,7,7,sangat membantu sayang nya iklan sangat menggangu,7,7,"['sangat', 'membantu', 'sayang', 'nya', 'iklan', 'sangat', 'menggangu']","['membantu', 'sayang', 'nya', 'iklan', 'menggangu']",7,5,2,bantu sayang nya iklan menggangu,5,5
"aplikasi eek, gak bisa verifikasi",negatif,2024-04-02,2024,aplikasi eek gak bisa verifikasi,5,5,aplikasi eek tidak bisa verifikasi,5,5,"['aplikasi', 'eek', 'tidak', 'bisa', 'verifikasi']","['aplikasi', 'eek', 'tidak', 'verifikasi']",5,4,1,aplikasi eek tidak verifikasi,4,4
Wyy tolong di bantu ribet banget apa dia bilang sudah login katanya masuk kan nomor captcah apa waooy di cari di Gugel nomor bantuan akun salah nya di managi pret,negatif,2024-03-12,2024,wyy tolong di bantu ribet banget apa dia bilang sudah login katanya masuk kan nomor captcah apa waooy di cari di gugel nomor bantuan akun salah nya di managi pret,30,30,wyy tolong di bantu rumit banget apa dia bilang sudah login katanya masuk akan nomor captcah apa waooy di cari di gugel nomor bantuan akun salah nya di managi pret,30,30,"['wyy', 'tolong', 'di', 'bantu', 'rumit', 'banget', 'apa', 'dia', 'bilang', 'sudah', 'login', 'katanya', 'masuk', 'akan', 'nomor', 'captcah', 'apa', 'waooy', 'di', 'cari', 'di', 'gugel', 'nomor', 'bantuan', 'akun', 'salah', 'nya', 'di', 'managi', 'pret']","['wyy', 'tolong', 'bantu', 'rumit', 'banget', 'bilang', 'login', 'masuk', 'nomor', 'captcah', 'waooy', 'cari', 'gugel', 'nomor', 'bantuan', 'akun', 'salah', 'nya', 'managi', 'pret']",30,20,10,wyy tolong bantu rumit banget bilang login masuk nomor captcah waooy cari gugel nomor bantu akun salah nya managi pret,20,20
"Aplikasi bagus dan mudah, terimakasih",positif,2024-05-11,2024,aplikasi bagus dan mudah terimakasih,5,5,aplikasi bagus dan mudah terima kasih,5,6,"['aplikasi', 'bagus', 'dan', 'mudah', 'terima', 'kasih']","['aplikasi', 'bagus', 'mudah', 'terima', 'kasih']",6,5,1,aplikasi bagus mudah terima kasih,5,5
Tidak bisa log in. Sistem verifikasinya buruk.,negatif,2023-06-06,2023,tidak bisa log in sistem verifikasinya buruk,7,7,tidak bisa log in sistem verifikasinya buruk,7,7,"['tidak', 'bisa', 'log', 'in', 'sistem', 'verifikasinya', 'buruk']","['tidak', 'log', 'in', 'sistem', 'verifikasinya', 'buruk']",7,6,1,tidak log in sistem verifikasi buruk,6,6
Ribet..... Ribet..... Ribet.,negatif,2024-07-30,2024,ribet ribet ribet,3,3,rumit rumit rumit,3,3,"['rumit', 'rumit', 'rumit']","['rumit', 'rumit', 'rumit']",3,3,0,rumit rumit rumit,3,3
Mohon tambahkan bahasa/translate untuk bahasa Indonesia,negatif,2024-03-08,2024,mohon tambahkan bahasa translate untuk bahasa indonesia,6,7,mohon tambahkan bahasa translate untuk bahasa indonesia,7,7,"['mohon', 'tambahkan', 'bahasa', 'translate', 'untuk', 'bahasa', 'indonesia']","['mohon', 'tambahkan', 'bahasa', 'translate', 'bahasa', 'indonesia']",7,6,1,mohon tambah bahasa translate bahasa indonesia,6,6
"Bermanfaat, utk berbagi lowker yang lagi berjuang utk menghidupi keluarga",positif,2021-11-14,2021,bermanfaat utk berbagi lowker yang lagi berjuang utk menghidupi keluarga,10,10,bermanfaat untuk berbagi lowker yang lagi berjuang untuk menghidupi keluarga,10,10,"['bermanfaat', 'untuk', 'berbagi', 'lowker', 'yang', 'lagi', 'berjuang', 'untuk', 'menghidupi', 'keluarga']","['bermanfaat', 'berbagi', 'lowker', 'berjuang', 'menghidupi', 'keluarga']",10,6,4,manfaat bagi lowker juang hidup keluarga,6,6
"verivikasinya susah benget, apk gajelas ini",negatif,2024-03-08,2024,verivikasinya susah benget apk gajelas ini,6,6,verivikasinya susah benget aplikasi tidak jelas ini,6,7,"['verivikasinya', 'susah', 'benget', 'aplikasi', 'tidak', 'jelas', 'ini']","['verivikasinya', 'susah', 'benget', 'aplikasi', 'tidak']",7,5,2,verivikasinya susah benget aplikasi tidak,5,5
Gajelas mau edit profil dan isi2 profil keluar keluar terus buang waktu,negatif,2023-07-02,2023,gajelas mau edit profil dan isi profil keluar keluar terus buang waktu,12,12,tidak jelas mau edit profil dan isi profil keluar keluar terus buang waktu,12,13,"['tidak', 'jelas', 'mau', 'edit', 'profil', 'dan', 'isi', 'profil', 'keluar', 'keluar', 'terus', 'buang', 'waktu']","['tidak', 'edit', 'profil', 'isi', 'profil', 'buang']",13,6,7,tidak edit profil isi profil buang,6,6
Ini gimana proses verifikasinya kok gak ada kiriman kode verifikasi via sms? Udh berkali nyoba gak ada kode ke sms,negatif,2021-12-24,2021,ini gimana proses verifikasinya kok gak ada kiriman kode verifikasi via sms udh berkali nyoba gak ada kode ke sms,20,20,ini bagaimana proses verifikasinya kok tidak ada kiriman kode verifikasi melalui sms sudah berkali mencoba tidak ada kode ke sms,20,20,"['ini', 'bagaimana', 'proses', 'verifikasinya', 'kok', 'tidak', 'ada', 'kiriman', 'kode', 'verifikasi', 'melalui', 'sms', 'sudah', 'berkali', 'mencoba', 'tidak', 'ada', 'kode', 'ke', 'sms']","['proses', 'verifikasinya', 'tidak', 'kiriman', 'kode', 'verifikasi', 'sms', 'berkali', 'mencoba', 'tidak', 'kode', 'sms']",20,12,8,proses verifikasi tidak kirim kode verifikasi sms kali coba tidak kode sms,12,12
"Tdk bisa login, verifikasi tidak masuk akal. Thx",negatif,2021-03-25,2021,tdk bisa login verifikasi tidak masuk akal thx,8,8,tidak bisa login verifikasi tidak masuk akal terima kasih,8,9,"['tidak', 'bisa', 'login', 'verifikasi', 'tidak', 'masuk', 'akal', 'terima', 'kasih']","['tidak', 'login', 'verifikasi', 'tidak', 'masuk', 'akal', 'terima', 'kasih']",9,8,1,tidak login verifikasi tidak masuk akal terima kasih,8,8
"Sangat membantu kami sebagi pencari kerja,untuk mendapat info2 penting seputar pekerjaan lowongan,perkembangan dunia usaha,menambah koneksi teman sahabat.terimakasih.",positif,2020-10-15,2020,sangat membantu kami sebagi pencari kerja untuk mendapat info penting seputar pekerjaan lowongan perkembangan dunia usaha menambah koneksi teman sahabat terimakasih,17,21,sangat membantu kami sebagi pencari kerja untuk mendapat informasi penting seputar pekerjaan lowongan perkembangan dunia usaha menambah koneksi teman sahabat terima kasih,21,22,"['sangat', 'membantu', 'kami', 'sebagi', 'pencari', 'kerja', 'untuk', 'mendapat', 'informasi', 'penting', 'seputar', 'pekerjaan', 'lowongan', 'perkembangan', 'dunia', 'usaha', 'menambah', 'koneksi', 'teman', 'sahabat', 'terima', 'kasih']","['membantu', 'sebagi', 'pencari', 'kerja', 'informasi', 'seputar', 'pekerjaan', 'lowongan', 'perkembangan', 'dunia', 'usaha', 'menambah', 'koneksi', 'teman', 'sahabat', 'terima', 'kasih']",22,17,5,bantu bagi cari kerja informasi putar kerja lowong kembang dunia usaha tambah koneksi teman sahabat terima kasih,17,17
Saya login pake no telpon gak pernah bisa susah banget dapat notifikasi masuk nya,negatif,2023-01-27,2023,saya login pake no telpon gak pernah bisa susah banget dapat notifikasi masuk nya,14,14,saya login pakai nomor telpon tidak pernah bisa susah banget dapat notifikasi masuk nya,14,14,"['saya', 'login', 'pakai', 'nomor', 'telpon', 'tidak', 'pernah', 'bisa', 'susah', 'banget', 'dapat', 'notifikasi', 'masuk', 'nya']","['login', 'pakai', 'nomor', 'telpon', 'tidak', 'susah', 'banget', 'notifikasi', 'masuk', 'nya']",14,10,4,login pakai nomor telpon tidak susah banget notifikasi masuk nya,10,10
"Gak ngerti lagi sama ini aplikasi, mau login aja sulit 😭",negatif,2023-10-23,2023,gak ngerti lagi sama ini aplikasi mau login aja sulit,11,10,tidak mengerti lagi sama ini aplikasi mau login saja sulit,10,10,"['tidak', 'mengerti', 'lagi', 'sama', 'ini', 'aplikasi', 'mau', 'login', 'saja', 'sulit']","['tidak', 'mengerti', 'aplikasi', 'login', 'sulit']",10,5,5,tidak erti aplikasi login sulit,5,5
Banyak informasi yang bisa kita dapat dengan menggunakan aplikasi LinkedIn. Sukses selalu dan berkembang,positif,2023-09-25,2023,banyak informasi yang bisa kita dapat dengan menggunakan aplikasi linkedin sukses selalu dan berkembang,14,14,banyak informasi yang bisa kita dapat dengan menggunakan aplikasi linkedin sukses selalu dan berkembang,14,14,"['banyak', 'informasi', 'yang', 'bisa', 'kita', 'dapat', 'dengan', 'menggunakan', 'aplikasi', 'linkedin', 'sukses', 'selalu', 'dan', 'berkembang']","['informasi', 'aplikasi', 'linkedin', 'sukses', 'berkembang']",14,5,9,informasi aplikasi linkedin sukses kembang,5,5
"Susah loging, kode verifikasinya tidak terkirim di gmail",negatif,2022-05-07,2022,susah loging kode verifikasinya tidak terkirim di gmail,8,8,susah loging kode verifikasinya tidak terkirim di gmail,8,8,"['susah', 'loging', 'kode', 'verifikasinya', 'tidak', 'terkirim', 'di', 'gmail']","['susah', 'loging', 'kode', 'verifikasinya', 'tidak', 'terkirim', 'gmail']",8,7,1,susah loging kode verifikasi tidak kirim gmail,7,7
Aplikasi yang bagus dan tanpa batas status mendukung semua kegiatan bisnis,positif,2020-04-29,2020,aplikasi yang bagus dan tanpa batas status mendukung semua kegiatan bisnis,11,11,aplikasi yang bagus dan tanpa batas status mendukung semua kegiatan bisnis,11,11,"['aplikasi', 'yang', 'bagus', 'dan', 'tanpa', 'batas', 'status', 'mendukung', 'semua', 'kegiatan', 'bisnis']","['aplikasi', 'bagus', 'batas', 'status', 'mendukung', 'kegiatan', 'bisnis']",11,7,4,aplikasi bagus batas status dukung giat bisnis,7,7
"Daftar di awalnya susah , pemeriksaan saya bukan robot saya jawab masa salah terus sampai daftar 2 akun tetep ajh salah ,",negatif,2021-09-05,2021,daftar di awalnya susah pemeriksaan saya bukan robot saya jawab masa salah terus sampai daftar akun tetep ajh salah,22,19,daftar di awalnya susah pemeriksaan saya bukan robot saya jawab masa salah terus sampai daftar akun tetap saja salah,19,19,"['daftar', 'di', 'awalnya', 'susah', 'pemeriksaan', 'saya', 'bukan', 'robot', 'saya', 'jawab', 'masa', 'salah', 'terus', 'sampai', 'daftar', 'akun', 'tetap', 'saja', 'salah']","['daftar', 'susah', 'pemeriksaan', 'robot', 'salah', 'daftar', 'akun', 'salah']",19,8,11,daftar susah periksa robot salah daftar akun salah,8,8
"Linkedim,. Aku beri reting bintang tiga,kenapa malah sulit sinyalnya, banding",negatif,2022-05-28,2022,linkedim aku beri reting bintang tiga kenapa malah sulit sinyalnya banding,10,11,linkedim aku beri reting bintang tiga kenapa bahkan sulit sinyalnya banding,11,11,"['linkedim', 'aku', 'beri', 'reting', 'bintang', 'tiga', 'kenapa', 'bahkan', 'sulit', 'sinyalnya', 'banding']","['linkedim', 'reting', 'bintang', 'sulit', 'sinyalnya', 'banding']",11,6,5,linkedim reting bintang sulit sinyal banding,6,6
"Sangat bermanfaat, untuk menambah relasi dan wawasan",positif,2022-05-27,2022,sangat bermanfaat untuk menambah relasi dan wawasan,7,7,sangat bermanfaat untuk menambah relasi dan wawasan,7,7,"['sangat', 'bermanfaat', 'untuk', 'menambah', 'relasi', 'dan', 'wawasan']","['bermanfaat', 'menambah', 'relasi', 'wawasan']",7,4,3,manfaat tambah relasi wawas,4,4
Sangat membantu untuk mencari koneksi pekerjaan,positif,2022-07-03,2022,sangat membantu untuk mencari koneksi pekerjaan,6,6,sangat membantu untuk mencari koneksi pekerjaan,6,6,"['sangat', 'membantu', 'untuk', 'mencari', 'koneksi', 'pekerjaan']","['membantu', 'mencari', 'koneksi', 'pekerjaan']",6,4,2,bantu cari koneksi kerja,4,4
"kenapa ya 2 akun saya dibatasi padahal akun baru, menyulitkan pengguna",negatif,2024-05-04,2024,kenapa ya akun saya dibatasi padahal akun baru menyulitkan pengguna,11,10,kenapa ya akun saya dibatasi padahal akun baru menyulitkan pengguna,10,10,"['kenapa', 'ya', 'akun', 'saya', 'dibatasi', 'padahal', 'akun', 'baru', 'menyulitkan', 'pengguna']","['ya', 'akun', 'dibatasi', 'akun', 'menyulitkan', 'pengguna']",10,6,4,ya akun batas akun sulit guna,6,6
Berterimakasih sangat membantu,positif,2024-06-04,2024,berterimakasih sangat membantu,3,3,berterimakasih sangat membantu,3,3,"['berterimakasih', 'sangat', 'membantu']","['berterimakasih', 'membantu']",3,2,1,berterimakasih bantu,2,2
aplikasi gak tau diri bodoh,negatif,2024-04-23,2024,aplikasi gak tau diri bodoh,5,5,aplikasi tidak tahu diri bodoh,5,5,"['aplikasi', 'tidak', 'tahu', 'diri', 'bodoh']","['aplikasi', 'tidak', 'bodoh']",5,3,2,aplikasi tidak bodoh,3,3
Padahal noCAPTCHA selalu benar. Tpi selalu mengulang ahhsudahlah,negatif,2023-07-18,2023,padahal nocaptcha selalu benar tpi selalu mengulang ahhsudahlah,8,8,padahal nocaptcha selalu benar tetapi selalu mengulang ahhsudahlah,8,8,"['padahal', 'nocaptcha', 'selalu', 'benar', 'tetapi', 'selalu', 'mengulang', 'ahhsudahlah']","['nocaptcha', 'mengulang', 'ahhsudahlah']",8,3,5,nocaptcha ulang ahhsudahlah,3,3
"Saya,suka melihat pertemanan dunia,apa yg terjadi di dunia ekonomi&bisnis atau pun aktifitas 2 yg jarang orang banyak ketahui.lov Linkedln.saya mendukung mu.",positif,2021-03-30,2021,saya suka melihat pertemanan dunia apa yg terjadi di dunia ekonomi bisnis atau pun aktifitas yg jarang orang banyak ketahui lov linkedln saya mendukung mu,21,25,saya suka melihat pertemanan dunia apa yang terjadi di dunia ekonomi bisnis atau pun aktifitas yang jarang orang banyak ketahui lov linkedln saya mendukung mau,25,25,"['saya', 'suka', 'melihat', 'pertemanan', 'dunia', 'apa', 'yang', 'terjadi', 'di', 'dunia', 'ekonomi', 'bisnis', 'atau', 'pun', 'aktifitas', 'yang', 'jarang', 'orang', 'banyak', 'ketahui', 'lov', 'linkedln', 'saya', 'mendukung', 'mau']","['suka', 'pertemanan', 'dunia', 'dunia', 'ekonomi', 'bisnis', 'aktifitas', 'jarang', 'orang', 'ketahui', 'lov', 'linkedln', 'mendukung']",25,13,12,suka teman dunia dunia ekonomi bisnis aktifitas jarang orang tahu lov linkedln dukung,13,13
Menghubungkan ke berbagai relasi dan info job.,positif,2022-02-10,2022,menghubungkan ke berbagai relasi dan info job,7,7,menghubungkan ke berbagai relasi dan informasi kerja,7,7,"['menghubungkan', 'ke', 'berbagai', 'relasi', 'dan', 'informasi', 'kerja']","['menghubungkan', 'relasi', 'informasi', 'kerja']",7,4,3,hubung relasi informasi kerja,4,4
"Aplikasinya tidak bisa instal, mentok di 91%",negatif,2022-06-03,2022,aplikasinya tidak bisa instal mentok di,7,6,aplikasi nya tidak bisa memasang mentok di,6,7,"['aplikasi', 'nya', 'tidak', 'bisa', 'memasang', 'mentok', 'di']","['aplikasi', 'nya', 'tidak', 'memasang', 'mentok']",7,5,2,aplikasi nya tidak pasang mentok,5,5
"Verifikasi log in rumit banget, main teka teki. Gimana si, cari solusi di youtube wow ternyata banyak banget orang yang senasib. Dan ga ada solusi 🤣",negatif,2023-08-28,2023,verifikasi log in rumit banget main teka teki gimana si cari solusi di youtube wow ternyata banyak banget orang yang senasib dan ga ada solusi,26,25,verifikasi log in rumit banget main teka teki bagaimana sih cari solusi di youtube wow ternyata banyak banget orang yang senasib dan tidak ada solusi,25,25,"['verifikasi', 'log', 'in', 'rumit', 'banget', 'main', 'teka', 'teki', 'bagaimana', 'sih', 'cari', 'solusi', 'di', 'youtube', 'wow', 'ternyata', 'banyak', 'banget', 'orang', 'yang', 'senasib', 'dan', 'tidak', 'ada', 'solusi']","['verifikasi', 'log', 'in', 'rumit', 'banget', 'main', 'teka', 'teki', 'sih', 'cari', 'solusi', 'youtube', 'wow', 'banget', 'orang', 'senasib', 'tidak', 'solusi']",25,18,7,verifikasi log in rumit banget main teka teki sih cari solusi youtube wow banget orang nasib tidak solusi,18,18
Menarik tampilan ui nya moga ada fitur penunjang lainnya,positif,2022-12-15,2022,menarik tampilan ui nya moga ada fitur penunjang lainnya,9,9,menarik tampilan ui nya semoga ada fitur penunjang lainnya,9,9,"['menarik', 'tampilan', 'ui', 'nya', 'semoga', 'ada', 'fitur', 'penunjang', 'lainnya']","['menarik', 'tampilan', 'ui', 'nya', 'semoga', 'fitur', 'penunjang']",9,7,2,tarik tampil ui nya moga fitur tunjang,7,7
"Aplikasi terbaik saya sering dan selalu mendapat panggilan kerja dengan aplikasi ini, terimakasih Linkedin",positif,2023-04-10,2023,aplikasi terbaik saya sering dan selalu mendapat panggilan kerja dengan aplikasi ini terimakasih linkedin,14,14,aplikasi terbaik saya sering dan selalu mendapat panggilan kerja dengan aplikasi ini terima kasih linkedin,14,15,"['aplikasi', 'terbaik', 'saya', 'sering', 'dan', 'selalu', 'mendapat', 'panggilan', 'kerja', 'dengan', 'aplikasi', 'ini', 'terima', 'kasih', 'linkedin']","['aplikasi', 'terbaik', 'panggilan', 'kerja', 'aplikasi', 'terima', 'kasih', 'linkedin']",15,8,7,aplikasi baik panggil kerja aplikasi terima kasih linkedin,8,8
selalu puas dengan pelayanan terimakasih kak selalu ditingkatkan lagi ya kk jangan selalu merasa puas tetap usaha dan amanah 🙂☺,positif,2022-07-03,2022,selalu puas dengan pelayanan terimakasih kak selalu ditingkatkan lagi ya kk jangan selalu merasa puas tetap usaha dan amanah,20,19,selalu puas dengan pelayanan terima kasih kak selalu ditingkatkan lagi ya kakak jangan selalu merasa puas tetap usaha dan amanah,19,20,"['selalu', 'puas', 'dengan', 'pelayanan', 'terima', 'kasih', 'kak', 'selalu', 'ditingkatkan', 'lagi', 'ya', 'kakak', 'jangan', 'selalu', 'merasa', 'puas', 'tetap', 'usaha', 'dan', 'amanah']","['puas', 'pelayanan', 'terima', 'kasih', 'kak', 'ditingkatkan', 'ya', 'kakak', 'puas', 'usaha', 'amanah']",20,11,9,puas layan terima kasih kak tingkat ya kakak puas usaha amanah,11,11
Sangat mantap bosku👍🙏,positif,2024-05-28,2024,sangat mantap bosku,3,3,sangat mantap bosku,3,3,"['sangat', 'mantap', 'bosku']","['mantap', 'bosku']",3,2,1,mantap bos,2,2
Sangat membantu dalam mencari relasi dan pekerjaan,positif,2022-06-16,2022,sangat membantu dalam mencari relasi dan pekerjaan,7,7,sangat membantu dalam mencari relasi dan pekerjaan,7,7,"['sangat', 'membantu', 'dalam', 'mencari', 'relasi', 'dan', 'pekerjaan']","['membantu', 'mencari', 'relasi', 'pekerjaan']",7,4,3,bantu cari relasi kerja,4,4
Fleksibilitas dan dashboard menarik,positif,2022-07-28,2022,fleksibilitas dan dashboard menarik,4,4,fleksibilitas dan dashboard menarik,4,4,"['fleksibilitas', 'dan', 'dashboard', 'menarik']","['fleksibilitas', 'dashboard', 'menarik']",4,3,1,fleksibilitas dashboard tarik,3,3
"Padahal sdh benar memilih gambar yg menghadap ke atas, tp diulang-ulang terus",negatif,2023-04-12,2023,padahal sdh benar memilih gambar yg menghadap ke atas tp diulang ulang terus,12,13,padahal sudah benar memilih gambar yang menghadap ke atas tapi diulang ulang terus,13,13,"['padahal', 'sudah', 'benar', 'memilih', 'gambar', 'yang', 'menghadap', 'ke', 'atas', 'tapi', 'diulang', 'ulang', 'terus']","['memilih', 'gambar', 'menghadap', 'diulang', 'ulang']",13,5,8,pilih gambar hadap ulang ulang,5,5
Sangat bermanfaat bagi pengembangan diri dalam berbagai hal dalam hidup dan kehidupan,positif,2020-06-17,2020,sangat bermanfaat bagi pengembangan diri dalam berbagai hal dalam hidup dan kehidupan,12,12,sangat bermanfaat bagi pengembangan diri dalam berbagai hal dalam hidup dan kehidupan,12,12,"['sangat', 'bermanfaat', 'bagi', 'pengembangan', 'diri', 'dalam', 'berbagai', 'hal', 'dalam', 'hidup', 'dan', 'kehidupan']","['bermanfaat', 'pengembangan', 'hidup', 'kehidupan']",12,4,8,manfaat kembang hidup hidup,4,4
"Lamaran rata2 pakai bahasa inggris,& ada berbayar, bagusan aplikasi sebelah",negatif,2022-03-22,2022,lamaran rata pakai bahasa inggris ada berbayar bagusan aplikasi sebelah,10,10,lamaran rata pakai bahasa inggris ada berbayar bagusan aplikasi sebelah,10,10,"['lamaran', 'rata', 'pakai', 'bahasa', 'inggris', 'ada', 'berbayar', 'bagusan', 'aplikasi', 'sebelah']","['lamaran', 'pakai', 'bahasa', 'inggris', 'berbayar', 'bagusan', 'aplikasi', 'sebelah']",10,8,2,lamar pakai bahasa inggris bayar bagus aplikasi belah,8,8
"kocak, bahkan robot juga kaga bisa inimah milih gambar kodok menghadap keatas udh di klik semua ttp kga bisa, mao menghadap kmana lagi. bulan kah?",negatif,2022-10-08,2022,kocak bahkan robot juga kaga bisa inimah milih gambar kodok menghadap keatas udh di klik semua ttp kga bisa mao menghadap kmana lagi bulan kah,25,25,kocak bahkan robot juga tidak bisa ini mah memilih gambar kodok menghadap keatas sudah di klik semua tetap kga bisa mau menghadap ke mana lagi bulan kah,25,27,"['kocak', 'bahkan', 'robot', 'juga', 'tidak', 'bisa', 'ini', 'mah', 'memilih', 'gambar', 'kodok', 'menghadap', 'keatas', 'sudah', 'di', 'klik', 'semua', 'tetap', 'kga', 'bisa', 'mau', 'menghadap', 'ke', 'mana', 'lagi', 'bulan', 'kah']","['kocak', 'robot', 'tidak', 'mah', 'memilih', 'gambar', 'kodok', 'menghadap', 'keatas', 'klik', 'kga', 'menghadap', 'kah']",27,13,14,kocak robot tidak mah pilih gambar kodok hadap atas klik kga hadap kah,13,13
Aplikasi Yang Sangat membantu para pencari Kerja..,positif,2021-08-03,2021,aplikasi yang sangat membantu para pencari kerja,7,7,aplikasi yang sangat membantu para pencari kerja,7,7,"['aplikasi', 'yang', 'sangat', 'membantu', 'para', 'pencari', 'kerja']","['aplikasi', 'membantu', 'pencari', 'kerja']",7,4,3,aplikasi bantu cari kerja,4,4
Sangat bermanfaat untuk mengembangkan bisnis melalui relasi2 yg ada,positif,2021-03-08,2021,sangat bermanfaat untuk mengembangkan bisnis melalui relasi yg ada,9,9,sangat bermanfaat untuk mengembangkan bisnis melalui relasi yang ada,9,9,"['sangat', 'bermanfaat', 'untuk', 'mengembangkan', 'bisnis', 'melalui', 'relasi', 'yang', 'ada']","['bermanfaat', 'mengembangkan', 'bisnis', 'relasi']",9,4,5,manfaat kembang bisnis relasi,4,4
Sangat membantu untuk berbagi dan mencari informasi pekerjaan,positif,2020-09-30,2020,sangat membantu untuk berbagi dan mencari informasi pekerjaan,8,8,sangat membantu untuk berbagi dan mencari informasi pekerjaan,8,8,"['sangat', 'membantu', 'untuk', 'berbagi', 'dan', 'mencari', 'informasi', 'pekerjaan']","['membantu', 'berbagi', 'mencari', 'informasi', 'pekerjaan']",8,5,3,bantu bagi cari informasi kerja,5,5
"Sangat membantu dalam mencari kerja, aplikasi yg keren",positif,2021-11-25,2021,sangat membantu dalam mencari kerja aplikasi yg keren,8,8,sangat membantu dalam mencari kerja aplikasi yang keren,8,8,"['sangat', 'membantu', 'dalam', 'mencari', 'kerja', 'aplikasi', 'yang', 'keren']","['membantu', 'mencari', 'kerja', 'aplikasi', 'keren']",8,5,3,bantu cari kerja aplikasi keren,5,5
Aplikasi yang sangat membantu di semua bidang dalam memperluas jejaring sosial baik dalam maupun luar negeri..thank you linkedin,positif,2022-02-06,2022,aplikasi yang sangat membantu di semua bidang dalam memperluas jejaring sosial baik dalam maupun luar negeri thank you linkedin,18,19,aplikasi yang sangat membantu di semua bidang dalam memperluas jejaring sosial baik dalam maupun luar negeri terima kasih you linkedin,19,20,"['aplikasi', 'yang', 'sangat', 'membantu', 'di', 'semua', 'bidang', 'dalam', 'memperluas', 'jejaring', 'sosial', 'baik', 'dalam', 'maupun', 'luar', 'negeri', 'terima', 'kasih', 'you', 'linkedin']","['aplikasi', 'membantu', 'bidang', 'memperluas', 'jejaring', 'sosial', 'negeri', 'terima', 'kasih', 'you', 'linkedin']",20,11,9,aplikasi bantu bidang luas jejaring sosial negeri terima kasih you linkedin,11,11
"Tiba2 pencarian tidak keluar yang mau di tuju, Mau liat postingan juga gabisa",negatif,2022-09-07,2022,tiba pencarian tidak keluar yang mau di tuju mau liat postingan juga gabisa,13,13,tiba pencarian tidak keluar yang mau di tuju mau lihat postingan juga tidak bisa,13,14,"['tiba', 'pencarian', 'tidak', 'keluar', 'yang', 'mau', 'di', 'tuju', 'mau', 'lihat', 'postingan', 'juga', 'tidak', 'bisa']","['pencarian', 'tidak', 'tuju', 'lihat', 'postingan', 'tidak']",14,6,8,cari tidak tuju lihat postingan tidak,6,6
"Auto Uinstall,,,,, gue gak tau siapa yang bodoh,gue yang bodoh atau aplikasi nya yang bodoh,,,,,gak bisa masuk kehalaman utama nya nih aplikasi binatang menghadap keatas 🖕",negatif,2023-01-03,2023,auto uinstall gue gak tau siapa yang bodoh gue yang bodoh atau aplikasi nya yang bodoh gak bisa masuk kehalaman utama nya nih aplikasi binatang menghadap keatas,26,27,otomatis uinstall saya tidak tahu siapa yang bodoh saya yang bodoh atau aplikasi nya yang bodoh tidak bisa masuk kehalaman utama nya nih aplikasi binatang menghadap keatas,27,27,"['otomatis', 'uinstall', 'saya', 'tidak', 'tahu', 'siapa', 'yang', 'bodoh', 'saya', 'yang', 'bodoh', 'atau', 'aplikasi', 'nya', 'yang', 'bodoh', 'tidak', 'bisa', 'masuk', 'kehalaman', 'utama', 'nya', 'nih', 'aplikasi', 'binatang', 'menghadap', 'keatas']","['otomatis', 'uinstall', 'tidak', 'bodoh', 'bodoh', 'aplikasi', 'nya', 'bodoh', 'tidak', 'masuk', 'kehalaman', 'utama', 'nya', 'nih', 'aplikasi', 'binatang', 'menghadap', 'keatas']",27,18,9,otomatis uinstall tidak bodoh bodoh aplikasi nya bodoh tidak masuk halaman utama nya nih aplikasi binatang hadap atas,18,18
"Aplikasi yang sangat membantu, dalam koneksi pekerjaan dan bisnis.",positif,2022-11-10,2022,aplikasi yang sangat membantu dalam koneksi pekerjaan dan bisnis,9,9,aplikasi yang sangat membantu dalam koneksi pekerjaan dan bisnis,9,9,"['aplikasi', 'yang', 'sangat', 'membantu', 'dalam', 'koneksi', 'pekerjaan', 'dan', 'bisnis']","['aplikasi', 'membantu', 'koneksi', 'pekerjaan', 'bisnis']",9,5,4,aplikasi bantu koneksi kerja bisnis,5,5
Login ga jelas eror mulu dan ngulang2 padahal keterangan sudah terverifikasi,negatif,2023-05-28,2023,login ga jelas eror mulu dan ngulang padahal keterangan sudah terverifikasi,11,11,login tidak jelas error mulu dan mengulang padahal keterangan sudah terverifikasi,11,11,"['login', 'tidak', 'jelas', 'error', 'mulu', 'dan', 'mengulang', 'padahal', 'keterangan', 'sudah', 'terverifikasi']","['login', 'tidak', 'error', 'mulu', 'mengulang', 'keterangan', 'terverifikasi']",11,7,4,login tidak error mulu ulang terang verifikasi,7,7
hemm bagus sih update nya lebih makin cakep dan makin berkembang the best,positif,2020-10-31,2020,hemm bagus sih update nya lebih makin cakep dan makin berkembang the best,13,13,hemm bagus sih diperbarui nya lebih makin cakep dan makin berkembang the terbaik,13,13,"['hemm', 'bagus', 'sih', 'diperbarui', 'nya', 'lebih', 'makin', 'cakep', 'dan', 'makin', 'berkembang', 'the', 'terbaik']","['hemm', 'bagus', 'sih', 'diperbarui', 'nya', 'cakep', 'berkembang', 'the', 'terbaik']",13,9,4,hemm bagus sih baru nya cakep kembang the baik,9,9
"Gk bisa buat log in,ganti pasword malah ditolak secara permanen,ribet",negatif,2023-03-01,2023,gk bisa buat log in ganti pasword malah ditolak secara permanen ribet,10,12,tidak bisa buat log in ganti pasword bahkan ditolak secara permanen rumit,12,12,"['tidak', 'bisa', 'buat', 'log', 'in', 'ganti', 'pasword', 'bahkan', 'ditolak', 'secara', 'permanen', 'rumit']","['tidak', 'log', 'in', 'ganti', 'pasword', 'ditolak', 'permanen', 'rumit']",12,8,4,tidak log in ganti pasword tolak permanen rumit,8,8
Bukannya mencari pekerjaan malah tes gambar yang menghadap keatas,negatif,2021-09-15,2021,bukannya mencari pekerjaan malah tes gambar yang menghadap keatas,9,9,bukannya mencari pekerjaan bahkan tes gambar yang menghadap keatas,9,9,"['bukannya', 'mencari', 'pekerjaan', 'bahkan', 'tes', 'gambar', 'yang', 'menghadap', 'keatas']","['mencari', 'pekerjaan', 'tes', 'gambar', 'menghadap', 'keatas']",9,6,3,cari kerja tes gambar hadap atas,6,6
Maaf cuman ngasih bintang 1 aplikasinya kenapa ya dari tadi disuruh pemeriksa keamanan cepat soalnya saya sudah memiliki akun terlebih dahulu. Mohon penjelasannya. Terima kasih.,negatif,2021-04-03,2021,maaf cuman ngasih bintang aplikasinya kenapa ya dari tadi disuruh pemeriksa keamanan cepat soalnya saya sudah memiliki akun terlebih dahulu mohon penjelasannya terima kasih,25,24,maaf cuman memberikan bintang aplikasi nya kenapa ya dari tadi disuruh pemeriksa keamanan cepat soalnya saya sudah memiliki akun terlebih dahulu mohon penjelasannya terima kasih,24,25,"['maaf', 'cuman', 'memberikan', 'bintang', 'aplikasi', 'nya', 'kenapa', 'ya', 'dari', 'tadi', 'disuruh', 'pemeriksa', 'keamanan', 'cepat', 'soalnya', 'saya', 'sudah', 'memiliki', 'akun', 'terlebih', 'dahulu', 'mohon', 'penjelasannya', 'terima', 'kasih']","['maaf', 'cuman', 'bintang', 'aplikasi', 'nya', 'ya', 'disuruh', 'pemeriksa', 'keamanan', 'cepat', 'memiliki', 'akun', 'mohon', 'penjelasannya', 'terima', 'kasih']",25,16,9,maaf cuman bintang aplikasi nya ya suruh periksa aman cepat milik akun mohon jelas terima kasih,16,16
"Verifikasi teka teki nyaa aneh, dah dijawab pun yang benar tetap aja salah, ga jelas",negatif,2022-07-14,2022,verifikasi teka teki nyaa aneh dah dijawab pun yang benar tetap aja salah ga jelas,15,15,verifikasi teka teki nyaa aneh sudah dijawab pun yang benar tetap saja salah tidak jelas,15,15,"['verifikasi', 'teka', 'teki', 'nyaa', 'aneh', 'sudah', 'dijawab', 'pun', 'yang', 'benar', 'tetap', 'saja', 'salah', 'tidak', 'jelas']","['verifikasi', 'teka', 'teki', 'nyaa', 'aneh', 'salah', 'tidak']",15,7,8,verifikasi teka teki nyaa aneh salah tidak,7,7
"Perbaiki proses buat akunnya, error terus kode verifikasi tidak terkirim",negatif,2023-06-04,2023,perbaiki proses buat akunnya error terus kode verifikasi tidak terkirim,10,10,perbaikan proses buat akunnya error terus kode verifikasi tidak terkirim,10,10,"['perbaikan', 'proses', 'buat', 'akunnya', 'error', 'terus', 'kode', 'verifikasi', 'tidak', 'terkirim']","['perbaikan', 'proses', 'akunnya', 'error', 'kode', 'verifikasi', 'tidak', 'terkirim']",10,8,2,baik proses akun error kode verifikasi tidak kirim,8,8
Buat login sangat payah! tidak bisa untuk login.,negatif,2023-11-05,2023,buat login sangat payah tidak bisa untuk login,8,8,buat login sangat payah tidak bisa untuk login,8,8,"['buat', 'login', 'sangat', 'payah', 'tidak', 'bisa', 'untuk', 'login']","['login', 'payah', 'tidak', 'login']",8,4,4,login payah tidak login,4,4
Kenapa kalau login harus tebak2 gambar ya?? Kan email dan password saya sesuai,negatif,2022-09-04,2022,kenapa kalau login harus tebak gambar ya kan email dan password saya sesuai,13,13,kenapa kalau login harus tebak gambar ya akan email dan password saya sesuai,13,13,"['kenapa', 'kalau', 'login', 'harus', 'tebak', 'gambar', 'ya', 'akan', 'email', 'dan', 'password', 'saya', 'sesuai']","['login', 'tebak', 'gambar', 'ya', 'email', 'password', 'sesuai']",13,7,6,login tebak gambar ya email password sesuai,7,7
Apk yg cukup membantu dimusim pendemi seperti in untuk mncri info kerja.,positif,2021-04-19,2021,apk yg cukup membantu dimusim pendemi seperti in untuk mncri info kerja,12,12,aplikasi yang cukup membantu dimusim pendemi seperti in untuk mncri informasi kerja,12,12,"['aplikasi', 'yang', 'cukup', 'membantu', 'dimusim', 'pendemi', 'seperti', 'in', 'untuk', 'mncri', 'informasi', 'kerja']","['aplikasi', 'membantu', 'dimusim', 'pendemi', 'in', 'mncri', 'informasi', 'kerja']",12,8,4,aplikasi bantu musim demi in mncri informasi kerja,8,8
"Aplikasi yang sangat membantu, salah satu yang terbaik dalam hal mencari pekerjaan",positif,2023-10-31,2023,aplikasi yang sangat membantu salah satu yang terbaik dalam hal mencari pekerjaan,12,12,aplikasi yang sangat membantu salah satu yang terbaik dalam hal mencari pekerjaan,12,12,"['aplikasi', 'yang', 'sangat', 'membantu', 'salah', 'satu', 'yang', 'terbaik', 'dalam', 'hal', 'mencari', 'pekerjaan']","['aplikasi', 'membantu', 'salah', 'terbaik', 'mencari', 'pekerjaan']",12,6,6,aplikasi bantu salah baik cari kerja,6,6
"Aplikasi yg positif. No sara, dan memotivasi job seeker",positif,2020-12-01,2020,aplikasi yg positif no sara dan memotivasi job seeker,9,9,aplikasi yang positif nomor sara dan memotivasi kerja seeker,9,9,"['aplikasi', 'yang', 'positif', 'nomor', 'sara', 'dan', 'memotivasi', 'kerja', 'seeker']","['aplikasi', 'positif', 'nomor', 'sara', 'memotivasi', 'kerja', 'seeker']",9,7,2,aplikasi positif nomor sara motivasi kerja seeker,7,7
Bad sekali. Mau login susah. Ternyata di komen yg lain jg sama.,negatif,2023-07-22,2023,bad sekali mau login susah ternyata di komen yg lain jg sama,12,12,bad sekali mau login susah ternyata di komen yang lain juga sama,12,12,"['bad', 'sekali', 'mau', 'login', 'susah', 'ternyata', 'di', 'komen', 'yang', 'lain', 'juga', 'sama']","['bad', 'login', 'susah', 'komen']",12,4,8,bad login susah komen,4,4
gabisa di log in karna kebanyakan syarat ga jelas,negatif,2024-02-03,2024,gabisa di log in karna kebanyakan syarat ga jelas,9,9,tidak bisa di log in karena kebanyakan syarat tidak jelas,9,10,"['tidak', 'bisa', 'di', 'log', 'in', 'karena', 'kebanyakan', 'syarat', 'tidak', 'jelas']","['tidak', 'log', 'in', 'kebanyakan', 'syarat', 'tidak']",10,6,4,tidak log in banyak syarat tidak,6,6
2 kali buat akun linkedin. 2 kali juga akun saya di nonaktifkan. Apk tidak mambantu ini. Malas sekali sya hapus aja.,negatif,2020-10-15,2020,kali buat akun linkedin kali juga akun saya di nonaktifkan apk tidak mambantu ini malas sekali sya hapus aja,21,19,kali buat akun linkedin kali juga akun saya di nonaktifkan aplikasi tidak membantu ini malas sekali saya hapus saja,19,19,"['kali', 'buat', 'akun', 'linkedin', 'kali', 'juga', 'akun', 'saya', 'di', 'nonaktifkan', 'aplikasi', 'tidak', 'membantu', 'ini', 'malas', 'sekali', 'saya', 'hapus', 'saja']","['kali', 'akun', 'linkedin', 'kali', 'akun', 'nonaktifkan', 'aplikasi', 'tidak', 'membantu', 'malas', 'hapus']",19,11,8,kali akun linkedin kali akun nonaktif aplikasi tidak bantu malas hapus,11,11
sangat bagus untuk info pekerjaan dan aktivitas kerja yang relevan dengan teman,positif,2021-10-20,2021,sangat bagus untuk info pekerjaan dan aktivitas kerja yang relevan dengan teman,12,12,sangat bagus untuk informasi pekerjaan dan aktivitas kerja yang relevan dengan teman,12,12,"['sangat', 'bagus', 'untuk', 'informasi', 'pekerjaan', 'dan', 'aktivitas', 'kerja', 'yang', 'relevan', 'dengan', 'teman']","['bagus', 'informasi', 'pekerjaan', 'aktivitas', 'kerja', 'relevan', 'teman']",12,7,5,bagus informasi kerja aktivitas kerja relevan teman,7,7
Ini aplikasi kena hack apa gimana yak? 2 hari nyoba buat login stelah verifikasi ktemu nya malah ganti2 sandi doang aneh,negatif,2023-05-09,2023,ini aplikasi kena hack apa gimana yak hari nyoba buat login stelah verifikasi ktemu nya malah ganti sandi doang aneh,21,20,ini aplikasi kena hack apa bagaimana yak hari mencoba buat login setelah verifikasi ktemu nya bahkan ganti sandi saja aneh,20,20,"['ini', 'aplikasi', 'kena', 'hack', 'apa', 'bagaimana', 'yak', 'hari', 'mencoba', 'buat', 'login', 'setelah', 'verifikasi', 'ktemu', 'nya', 'bahkan', 'ganti', 'sandi', 'saja', 'aneh']","['aplikasi', 'kena', 'hack', 'yak', 'mencoba', 'login', 'verifikasi', 'ktemu', 'nya', 'ganti', 'sandi', 'aneh']",20,12,8,aplikasi kena hack yak coba login verifikasi ktemu nya ganti sandi aneh,12,12
"Apk anjing, habis-habiskan paket. Minta update tapi toh gk bisa login.",negatif,2021-01-13,2021,apk anjing habis habiskan paket minta update tapi toh gk bisa login,11,12,aplikasi anjing habis habiskan paket minta diperbarui tapi toh tidak bisa login,12,12,"['aplikasi', 'anjing', 'habis', 'habiskan', 'paket', 'minta', 'diperbarui', 'tapi', 'toh', 'tidak', 'bisa', 'login']","['aplikasi', 'anjing', 'habis', 'habiskan', 'paket', 'diperbarui', 'tidak', 'login']",12,8,4,aplikasi anjing habis habis paket baru tidak login,8,8
"Koq kita tdk bisa tau mana di tolak atau mana proses dan kita di suruh kirim pesen ke perusahaan sedang kita ga tau link atau no contac perusahaan tersebut,tolong di buat simple dan para pelamar bisa mudah ngelamar dan tau status lamaran kita dan klo di tolak berarti kita sudah tdk boleh ngelamar lagi di perusahaan itu",negatif,2021-04-07,2021,koq kita tdk bisa tau mana di tolak atau mana proses dan kita di suruh kirim pesen ke perusahaan sedang kita ga tau link atau no contac perusahaan tersebut tolong di buat simple dan para pelamar bisa mudah ngelamar dan tau status lamaran kita dan klo di tolak berarti kita sudah tdk boleh ngelamar lagi di perusahaan itu,57,58,kok kita tidak bisa tahu mana di tolak atau mana proses dan kita di suruh kirim pesan ke perusahaan sedang kita tidak tahu link atau nomor contac perusahaan tersebut tolong di buat simpel dan para pelamar bisa mudah ngelamar dan tahu status lamaran kita dan kalau di tolak berarti kita sudah tidak boleh ngelamar lagi di perusahaan itu,58,58,"['kok', 'kita', 'tidak', 'bisa', 'tahu', 'mana', 'di', 'tolak', 'atau', 'mana', 'proses', 'dan', 'kita', 'di', 'suruh', 'kirim', 'pesan', 'ke', 'perusahaan', 'sedang', 'kita', 'tidak', 'tahu', 'link', 'atau', 'nomor', 'contac', 'perusahaan', 'tersebut', 'tolong', 'di', 'buat', 'simpel', 'dan', 'para', 'pelamar', 'bisa', 'mudah', 'ngelamar', 'dan', 'tahu', 'status', 'lamaran', 'kita', 'dan', 'kalau', 'di', 'tolak', 'berarti', 'kita', 'sudah', 'tidak', 'boleh', 'ngelamar', 'lagi', 'di', 'perusahaan', 'itu']","['tidak', 'tolak', 'proses', 'suruh', 'kirim', 'pesan', 'perusahaan', 'tidak', 'link', 'nomor', 'contac', 'perusahaan', 'tolong', 'simpel', 'pelamar', 'mudah', 'ngelamar', 'status', 'lamaran', 'tolak', 'tidak', 'ngelamar', 'perusahaan']",58,23,35,tidak tolak proses suruh kirim pesan usaha tidak link nomor contac usaha tolong simpel lamar mudah ngelamar status lamar tolak tidak ngelamar usaha,23,23
"Ikuti kuisnya tidak ada versi bahasa indonesia nya, tak bisa saya menjawab nya..",negatif,2021-10-06,2021,ikuti kuisnya tidak ada versi bahasa indonesia nya tak bisa saya menjawab nya,13,13,ikuti kuisnya tidak ada versi bahasa indonesia nya tidak bisa saya menjawab nya,13,13,"['ikuti', 'kuisnya', 'tidak', 'ada', 'versi', 'bahasa', 'indonesia', 'nya', 'tidak', 'bisa', 'saya', 'menjawab', 'nya']","['ikuti', 'kuisnya', 'tidak', 'versi', 'bahasa', 'indonesia', 'nya', 'tidak', 'nya']",13,9,4,ikut kuis tidak versi bahasa indonesia nya tidak nya,9,9
Terlalu banyak iklan,negatif,2024-06-02,2024,terlalu banyak iklan,3,3,terlalu banyak iklan,3,3,"['terlalu', 'banyak', 'iklan']",['iklan'],3,1,2,iklan,1,1
login ribet sekali ... terlalu ketat,negatif,2024-03-07,2024,login ribet sekali terlalu ketat,6,5,login rumit sekali terlalu ketat,5,5,"['login', 'rumit', 'sekali', 'terlalu', 'ketat']","['login', 'rumit', 'ketat']",5,3,2,login rumit ketat,3,3
Aplikasi ini sangat bagus bagi para profesional Mohon ada penambahan fitur-fitur baru semisal dark mode di aplikasi LinkedIn ini,positif,2021-01-01,2021,aplikasi ini sangat bagus bagi para profesional mohon ada penambahan fitur fitur baru semisal dark mode di aplikasi linkedin ini,19,20,aplikasi ini sangat bagus bagi para profesional mohon ada penambahan fitur fitur baru semisal dark mode di aplikasi linkedin ini,20,20,"['aplikasi', 'ini', 'sangat', 'bagus', 'bagi', 'para', 'profesional', 'mohon', 'ada', 'penambahan', 'fitur', 'fitur', 'baru', 'semisal', 'dark', 'mode', 'di', 'aplikasi', 'linkedin', 'ini']","['aplikasi', 'bagus', 'profesional', 'mohon', 'penambahan', 'fitur', 'fitur', 'dark', 'mode', 'aplikasi', 'linkedin']",20,11,9,aplikasi bagus profesional mohon tambah fitur fitur dark mode aplikasi linkedin,11,11
"Sangat rekomendasi sekali, bagus utk membangun karir...👍",positif,2022-02-17,2022,sangat rekomendasi sekali bagus utk membangun karir,7,7,sangat rekomendasi sekali bagus untuk membangun karir,7,7,"['sangat', 'rekomendasi', 'sekali', 'bagus', 'untuk', 'membangun', 'karir']","['rekomendasi', 'bagus', 'membangun', 'karir']",7,4,3,rekomendasi bagus bangun karir,4,4
"Keren,mudah mencari link pekerjaan",positif,2020-07-07,2020,keren mudah mencari link pekerjaan,4,5,keren mudah mencari link pekerjaan,5,5,"['keren', 'mudah', 'mencari', 'link', 'pekerjaan']","['keren', 'mudah', 'mencari', 'link', 'pekerjaan']",5,5,0,keren mudah cari link kerja,5,5
Verifikasi kode SMS nya lama banget tidak terkirim,negatif,2023-05-30,2023,verifikasi kode sms nya lama banget tidak terkirim,8,8,verifikasi kode sms nya lama banget tidak terkirim,8,8,"['verifikasi', 'kode', 'sms', 'nya', 'lama', 'banget', 'tidak', 'terkirim']","['verifikasi', 'kode', 'sms', 'nya', 'banget', 'tidak', 'terkirim']",8,7,1,verifikasi kode sms nya banget tidak kirim,7,7
Kenapa saldo dana saya terdebit atas transaksi yg tidak saya lakukan sebesar 1juta. Tolong bantu proses refund dananya,negatif,2023-11-01,2023,kenapa saldo dana saya terdebit atas transaksi yg tidak saya lakukan sebesar juta tolong bantu proses refund dananya,18,18,kenapa saldo dana saya terdebit atas transaksi yang tidak saya lakukan sebesar juta tolong bantu proses refund dananya,18,18,"['kenapa', 'saldo', 'dana', 'saya', 'terdebit', 'atas', 'transaksi', 'yang', 'tidak', 'saya', 'lakukan', 'sebesar', 'juta', 'tolong', 'bantu', 'proses', 'refund', 'dananya']","['saldo', 'dana', 'terdebit', 'transaksi', 'tidak', 'lakukan', 'juta', 'tolong', 'bantu', 'proses', 'refund', 'dananya']",18,12,6,saldo dana debit transaksi tidak laku juta tolong bantu proses refund dana,12,12
"Update terbaru deeplinknya eror, login juga eror",negatif,2022-07-15,2022,update terbaru deeplinknya eror login juga eror,7,7,diperbarui terbaru deeplinknya error login juga error,7,7,"['diperbarui', 'terbaru', 'deeplinknya', 'error', 'login', 'juga', 'error']","['diperbarui', 'terbaru', 'deeplinknya', 'error', 'login', 'error']",7,6,1,baru baru deeplinknya error login error,6,6
"Sangat membantu utk mencari apa yang dibutuhkan disini, serta menambah wawasann",positif,2020-11-12,2020,sangat membantu utk mencari apa yang dibutuhkan disini serta menambah wawasann,11,11,sangat membantu untuk mencari apa yang dibutuhkan disini serta menambah wawasann,11,11,"['sangat', 'membantu', 'untuk', 'mencari', 'apa', 'yang', 'dibutuhkan', 'disini', 'serta', 'menambah', 'wawasann']","['membantu', 'mencari', 'dibutuhkan', 'menambah', 'wawasann']",11,5,6,bantu cari butuh tambah wawasann,5,5
Mau psoting status di Lindkedln selalu gagal terus. Mohon bantuannya. Mohon untuk di perbaiki lagi trimakasih.,negatif,2023-06-30,2023,mau psoting status di lindkedln selalu gagal terus mohon bantuannya mohon untuk di perbaiki lagi trimakasih,16,16,mau psoting status di lindkedln selalu gagal terus mohon bantuannya mohon untuk di perbaikan lagi terima kasih,16,17,"['mau', 'psoting', 'status', 'di', 'lindkedln', 'selalu', 'gagal', 'terus', 'mohon', 'bantuannya', 'mohon', 'untuk', 'di', 'perbaikan', 'lagi', 'terima', 'kasih']","['psoting', 'status', 'lindkedln', 'gagal', 'mohon', 'bantuannya', 'mohon', 'perbaikan', 'terima', 'kasih']",17,10,7,psoting status lindkedln gagal mohon bantu mohon baik terima kasih,10,10
"Wah banyak komentar kurang enak , knapa enggak ada pilihan tolak pembaharuan . Klo ada saya pilih tolak",negatif,2021-03-31,2021,wah banyak komentar kurang enak knapa enggak ada pilihan tolak pembaharuan klo ada saya pilih tolak,18,16,wah banyak komentar kurang enak kenapa enggak ada pilihan tolak pembaharuan kalau ada saya pilih tolak,16,16,"['wah', 'banyak', 'komentar', 'kurang', 'enak', 'kenapa', 'enggak', 'ada', 'pilihan', 'tolak', 'pembaharuan', 'kalau', 'ada', 'saya', 'pilih', 'tolak']","['komentar', 'enak', 'pilihan', 'tolak', 'pembaharuan', 'pilih', 'tolak']",16,7,9,komentar enak pilih tolak baharu pilih tolak,7,7
Wah bagus saya mau mengembangkan Poto kampung Inggris tempirai Pali di Apk Linkedln Terimakasih Linkedln...,positif,2021-08-16,2021,wah bagus saya mau mengembangkan poto kampung inggris tempirai pali di apk linkedln terimakasih linkedln,15,15,wah bagus saya mau mengembangkan poto kampung inggris tempirai pali di aplikasi linkedln terima kasih linkedln,15,16,"['wah', 'bagus', 'saya', 'mau', 'mengembangkan', 'poto', 'kampung', 'inggris', 'tempirai', 'pali', 'di', 'aplikasi', 'linkedln', 'terima', 'kasih', 'linkedln']","['bagus', 'mengembangkan', 'poto', 'kampung', 'inggris', 'tempirai', 'pali', 'aplikasi', 'linkedln', 'terima', 'kasih', 'linkedln']",16,12,4,bagus kembang poto kampung inggris tempirai pali aplikasi linkedln terima kasih linkedln,12,12
"aneh banget, ga ada halaman buat ganti profil",negatif,2023-12-14,2023,aneh banget ga ada halaman buat ganti profil,8,8,aneh banget tidak ada halaman buat ganti profil,8,8,"['aneh', 'banget', 'tidak', 'ada', 'halaman', 'buat', 'ganti', 'profil']","['aneh', 'banget', 'tidak', 'halaman', 'ganti', 'profil']",8,6,2,aneh banget tidak halaman ganti profil,6,6
"tidak bisa menambahkan alamat email, bug segera di fix dong",negatif,2023-11-06,2023,tidak bisa menambahkan alamat email bug segera di fix dong,10,10,tidak bisa menambahkan alamat email bug segera di fix dong,10,10,"['tidak', 'bisa', 'menambahkan', 'alamat', 'email', 'bug', 'segera', 'di', 'fix', 'dong']","['tidak', 'alamat', 'email', 'bug', 'fix']",10,5,5,tidak alamat email bug fix,5,5
Sangat membantu dalam mencari pekerjaan apalagi sesuai dgn pengalaman kerja,positif,2022-10-10,2022,sangat membantu dalam mencari pekerjaan apalagi sesuai dgn pengalaman kerja,10,10,sangat membantu dalam mencari pekerjaan apalagi sesuai dengan pengalaman kerja,10,10,"['sangat', 'membantu', 'dalam', 'mencari', 'pekerjaan', 'apalagi', 'sesuai', 'dengan', 'pengalaman', 'kerja']","['membantu', 'mencari', 'pekerjaan', 'sesuai', 'pengalaman', 'kerja']",10,6,4,bantu cari kerja sesuai alam kerja,6,6
Semoga membantu masalah pekerjaan apapun dalam segala hal yg positif ingat harus tetap amanah kolaborasi dan harus tetap istikomah,positif,2021-06-05,2021,semoga membantu masalah pekerjaan apapun dalam segala hal yg positif ingat harus tetap amanah kolaborasi dan harus tetap istikomah,19,19,semoga membantu masalah pekerjaan apapun dalam segala hal yang positif ingat harus tetap amanah kolaborasi dan harus tetap istikomah,19,19,"['semoga', 'membantu', 'masalah', 'pekerjaan', 'apapun', 'dalam', 'segala', 'hal', 'yang', 'positif', 'ingat', 'harus', 'tetap', 'amanah', 'kolaborasi', 'dan', 'harus', 'tetap', 'istikomah']","['semoga', 'membantu', 'pekerjaan', 'apapun', 'positif', 'amanah', 'kolaborasi', 'istikomah']",19,8,11,moga bantu kerja apa positif amanah kolaborasi istikomah,8,8
Aplikasi banyak error sama kayak website nya. Menjijikkan,negatif,2023-09-22,2023,aplikasi banyak error sama kayak website nya menjijikkan,8,8,aplikasi banyak error sama kayak website nya menjijikkan,8,8,"['aplikasi', 'banyak', 'error', 'sama', 'kayak', 'website', 'nya', 'menjijikkan']","['aplikasi', 'error', 'kayak', 'website', 'nya', 'menjijikkan']",8,6,2,aplikasi error kayak website nya jijik,6,6
"Aplikasi gajelas, masuk aja tes ribet banget berkali kali gabisa juga",negatif,2021-04-19,2021,aplikasi gajelas masuk aja tes ribet banget berkali kali gabisa juga,11,11,aplikasi tidak jelas masuk saja tes rumit banget berkali kali tidak bisa juga,11,13,"['aplikasi', 'tidak', 'jelas', 'masuk', 'saja', 'tes', 'rumit', 'banget', 'berkali', 'kali', 'tidak', 'bisa', 'juga']","['aplikasi', 'tidak', 'masuk', 'tes', 'rumit', 'banget', 'berkali', 'kali', 'tidak']",13,9,4,aplikasi tidak masuk tes rumit banget kali kali tidak,9,9
Sangat membantu untuk cari loker ke masa depanya,positif,2022-07-21,2022,sangat membantu untuk cari loker ke masa depanya,8,8,sangat membantu untuk cari loker ke masa depanya,8,8,"['sangat', 'membantu', 'untuk', 'cari', 'loker', 'ke', 'masa', 'depanya']","['membantu', 'cari', 'loker', 'depanya']",8,4,4,bantu cari loker depa,4,4
Sangat membantu utk memberikan informasi mengenai perkembangan di dunia kerja,positif,2020-02-20,2020,sangat membantu utk memberikan informasi mengenai perkembangan di dunia kerja,10,10,sangat membantu untuk memberikan informasi mengenai perkembangan di dunia kerja,10,10,"['sangat', 'membantu', 'untuk', 'memberikan', 'informasi', 'mengenai', 'perkembangan', 'di', 'dunia', 'kerja']","['membantu', 'informasi', 'perkembangan', 'dunia', 'kerja']",10,5,5,bantu informasi kembang dunia kerja,5,5
"Aplikasi tolol, mau kirim pesan aja harus berlangganan, mending kalo murah, ban aja nih aplikasi ga guna....!!!",negatif,2022-12-26,2022,aplikasi tolol mau kirim pesan aja harus berlangganan mending kalo murah ban aja nih aplikasi ga guna,17,17,aplikasi tolol mau kirim pesan saja harus berlangganan mending kalau murah ban saja nih aplikasi tidak guna,17,17,"['aplikasi', 'tolol', 'mau', 'kirim', 'pesan', 'saja', 'harus', 'berlangganan', 'mending', 'kalau', 'murah', 'ban', 'saja', 'nih', 'aplikasi', 'tidak', 'guna']","['aplikasi', 'tolol', 'kirim', 'pesan', 'berlangganan', 'mending', 'murah', 'ban', 'nih', 'aplikasi', 'tidak']",17,11,6,aplikasi tolol kirim pesan langgan mending murah ban nih aplikasi tidak,11,11
Mau login kok gak masuk2 sih ... Mentok cumam sampai tanya pekerjaan trakhir.. tolong diperbaiki,negatif,2022-05-03,2022,mau login kok gak masuk sih mentok cumam sampai tanya pekerjaan trakhir tolong diperbaiki,15,14,mau login kok tidak masuk sih mentok cumam sampai tanya pekerjaan trakhir tolong di perbaiki,14,15,"['mau', 'login', 'kok', 'tidak', 'masuk', 'sih', 'mentok', 'cumam', 'sampai', 'tanya', 'pekerjaan', 'trakhir', 'tolong', 'di', 'perbaiki']","['login', 'tidak', 'masuk', 'sih', 'mentok', 'cumam', 'pekerjaan', 'trakhir', 'tolong', 'perbaiki']",15,10,5,login tidak masuk sih mentok cumam kerja trakhir tolong baik,10,10
Kenapa akun saya tiba -tiba logout dan tidak bisa login dengan di linkedin 😪😪😪😪 please back my account,negatif,2022-10-20,2022,kenapa akun saya tiba tiba logout dan tidak bisa login dengan di linkedin please back my account,18,17,kenapa akun saya tiba tiba logout dan tidak bisa login dengan di linkedin please back my akun,17,17,"['kenapa', 'akun', 'saya', 'tiba', 'tiba', 'logout', 'dan', 'tidak', 'bisa', 'login', 'dengan', 'di', 'linkedin', 'please', 'back', 'my', 'akun']","['akun', 'logout', 'tidak', 'login', 'linkedin', 'please', 'back', 'my', 'akun']",17,9,8,akun logout tidak login linkedin please back my akun,9,9
"Kenapa verifikasi log in nya ribet, memastikan manusia, ga make sense lagi",negatif,2022-09-30,2022,kenapa verifikasi log in nya ribet memastikan manusia ga make sense lagi,12,12,kenapa verifikasi log in nya rumit memastikan manusia tidak make sense lagi,12,12,"['kenapa', 'verifikasi', 'log', 'in', 'nya', 'rumit', 'memastikan', 'manusia', 'tidak', 'make', 'sense', 'lagi']","['verifikasi', 'log', 'in', 'nya', 'rumit', 'manusia', 'tidak', 'make', 'sense']",12,9,3,verifikasi log in nya rumit manusia tidak make sense,9,9
Sangat membantu dalam pencarian lapangan pekerjaan.,positif,2020-02-25,2020,sangat membantu dalam pencarian lapangan pekerjaan,6,6,sangat membantu dalam pencarian lapangan pekerjaan,6,6,"['sangat', 'membantu', 'dalam', 'pencarian', 'lapangan', 'pekerjaan']","['membantu', 'pencarian', 'lapangan', 'pekerjaan']",6,4,2,bantu cari lapang kerja,4,4
"Makasii LinkedIn, selain aku dapat pekerjaan via apps ini, ku pun bertemu jodoh ku disini juga hihi ♥️",positif,2023-01-18,2023,makasii linkedin selain aku dapat pekerjaan via apps ini ku pun bertemu jodoh ku disini juga hihi,18,17,terima kasih linkedin selain aku dapat pekerjaan melalui aplikasi ini saya pun bertemu jodoh saya disini juga hihi,17,18,"['terima', 'kasih', 'linkedin', 'selain', 'aku', 'dapat', 'pekerjaan', 'melalui', 'aplikasi', 'ini', 'saya', 'pun', 'bertemu', 'jodoh', 'saya', 'disini', 'juga', 'hihi']","['terima', 'kasih', 'linkedin', 'pekerjaan', 'aplikasi', 'bertemu', 'jodoh', 'hihi']",18,8,10,terima kasih linkedin kerja aplikasi temu jodoh hihi,8,8
"Gak bisa masuk, verifikasinya ngulang2 disitu terus.",negatif,2023-06-25,2023,gak bisa masuk verifikasinya ngulang disitu terus,7,7,tidak bisa masuk verifikasinya mengulang disitu terus,7,7,"['tidak', 'bisa', 'masuk', 'verifikasinya', 'mengulang', 'disitu', 'terus']","['tidak', 'masuk', 'verifikasinya', 'mengulang', 'disitu']",7,5,2,tidak masuk verifikasi ulang situ,5,5
Aplikasi yg sangat menguntungkan bagi para pencari kerja,positif,2020-01-26,2020,aplikasi yg sangat menguntungkan bagi para pencari kerja,8,8,aplikasi yang sangat menguntungkan bagi para pencari kerja,8,8,"['aplikasi', 'yang', 'sangat', 'menguntungkan', 'bagi', 'para', 'pencari', 'kerja']","['aplikasi', 'menguntungkan', 'pencari', 'kerja']",8,4,4,aplikasi untung cari kerja,4,4
Mantap nih aplikasi nya sangat membantu pasang iklan,negatif,2021-07-23,2021,mantap nih aplikasi nya sangat membantu pasang iklan,8,8,mantap nih aplikasi nya sangat membantu pasang iklan,8,8,"['mantap', 'nih', 'aplikasi', 'nya', 'sangat', 'membantu', 'pasang', 'iklan']","['mantap', 'nih', 'aplikasi', 'nya', 'membantu', 'pasang', 'iklan']",8,7,1,mantap nih aplikasi nya bantu pasang iklan,7,7
"Recomended untuk jobsekers , asal telaten buat nambahin connection .",positif,2020-04-05,2020,recomended untuk jobsekers asal telaten buat nambahin connection,10,8,rekomendasi untuk jobsekers asal telaten buat nambahin connection,8,8,"['rekomendasi', 'untuk', 'jobsekers', 'asal', 'telaten', 'buat', 'nambahin', 'connection']","['rekomendasi', 'jobsekers', 'telaten', 'nambahin', 'connection']",8,5,3,rekomendasi jobsekers telaten nambahin connection,5,5
Sangat membantu saya,positif,2024-03-20,2024,sangat membantu saya,3,3,sangat membantu saya,3,3,"['sangat', 'membantu', 'saya']",['membantu'],3,1,2,bantu,1,1
"Kgk guna di perbaruhi,bukannya makin bagus malah makin jelek dan susah di gunakan",negatif,2022-06-13,2022,kgk guna di perbaruhi bukannya makin bagus malah makin jelek dan susah di gunakan,13,14,tidak guna di perbaruhi bukannya makin bagus bahkan makin jelek dan susah di gunakan,14,14,"['tidak', 'guna', 'di', 'perbaruhi', 'bukannya', 'makin', 'bagus', 'bahkan', 'makin', 'jelek', 'dan', 'susah', 'di', 'gunakan']","['tidak', 'perbaruhi', 'bagus', 'jelek', 'susah']",14,5,9,tidak baruh bagus jelek susah,5,5
Saya coba dulu kasih bintang 3 semoga aplikasi ini bisa membatu saya untuk mencari pekerjaan yang lebih baik...,negatif,2021-06-19,2021,saya coba dulu kasih bintang semoga aplikasi ini bisa membatu saya untuk mencari pekerjaan yang lebih baik,18,17,saya coba dahulu kasih bintang semoga aplikasi ini bisa membantu saya untuk mencari pekerjaan yang lebih baik,17,17,"['saya', 'coba', 'dahulu', 'kasih', 'bintang', 'semoga', 'aplikasi', 'ini', 'bisa', 'membantu', 'saya', 'untuk', 'mencari', 'pekerjaan', 'yang', 'lebih', 'baik']","['coba', 'kasih', 'bintang', 'semoga', 'aplikasi', 'membantu', 'mencari', 'pekerjaan']",17,8,9,coba kasih bintang moga aplikasi bantu cari kerja,8,8
"Saya tidak tau kenapa akun saya setelah di login keluar sendiri dan saat saya amu login tidak bisa, tolong bantuannya",negatif,2024-03-06,2024,saya tidak tau kenapa akun saya setelah di login keluar sendiri dan saat saya amu login tidak bisa tolong bantuannya,20,20,saya tidak tahu kenapa akun saya setelah di login keluar sendiri dan saat saya amu login tidak bisa tolong bantuannya,20,20,"['saya', 'tidak', 'tahu', 'kenapa', 'akun', 'saya', 'setelah', 'di', 'login', 'keluar', 'sendiri', 'dan', 'saat', 'saya', 'amu', 'login', 'tidak', 'bisa', 'tolong', 'bantuannya']","['tidak', 'akun', 'login', 'amu', 'login', 'tidak', 'tolong', 'bantuannya']",20,8,12,tidak akun login amu login tidak tolong bantu,8,8
"Mengapa Setelah di upadate tidak bisa melihat gambar, dan foto",negatif,2021-08-05,2021,mengapa setelah di upadate tidak bisa melihat gambar dan foto,10,10,mengapa setelah di upadate tidak bisa melihat gambar dan foto,10,10,"['mengapa', 'setelah', 'di', 'upadate', 'tidak', 'bisa', 'melihat', 'gambar', 'dan', 'foto']","['upadate', 'tidak', 'gambar', 'foto']",10,4,6,upadate tidak gambar foto,4,4
Membantu banget untuk tambah jaringan di seluruh wilayah Indonesia,positif,2020-09-16,2020,membantu banget untuk tambah jaringan di seluruh wilayah indonesia,9,9,membantu banget untuk tambah jaringan di seluruh wilayah indonesia,9,9,"['membantu', 'banget', 'untuk', 'tambah', 'jaringan', 'di', 'seluruh', 'wilayah', 'indonesia']","['membantu', 'banget', 'jaringan', 'wilayah', 'indonesia']",9,5,4,bantu banget jaring wilayah indonesia,5,5
Gabisa nambah email ga bisa login via web aplikasi aneh,negatif,2023-11-07,2023,gabisa nambah email ga bisa login via web aplikasi aneh,10,10,tidak bisa nambah email tidak bisa login melalui web aplikasi aneh,10,11,"['tidak', 'bisa', 'nambah', 'email', 'tidak', 'bisa', 'login', 'melalui', 'web', 'aplikasi', 'aneh']","['tidak', 'nambah', 'email', 'tidak', 'login', 'web', 'aplikasi', 'aneh']",11,8,3,tidak nambah email tidak login web aplikasi aneh,8,8
Perguruan tinggi tempat saya kuliah tidak terdaftar di LinkedIn. Jadi waktu mau menuliskan universitasnya ga ada. Jadinya susah buat move ke kolom yang lainnya.,negatif,2020-02-27,2020,perguruan tinggi tempat saya kuliah tidak terdaftar di linkedin jadi waktu mau menuliskan universitasnya ga ada jadinya susah buat move ke kolom yang lainnya,24,24,perguruan tinggi tempat saya kuliah tidak terdaftar di linkedin jadi waktu mau menuliskan universitasnya tidak ada jadinya susah buat move ke kolom yang lainnya,24,24,"['perguruan', 'tinggi', 'tempat', 'saya', 'kuliah', 'tidak', 'terdaftar', 'di', 'linkedin', 'jadi', 'waktu', 'mau', 'menuliskan', 'universitasnya', 'tidak', 'ada', 'jadinya', 'susah', 'buat', 'move', 'ke', 'kolom', 'yang', 'lainnya']","['perguruan', 'kuliah', 'tidak', 'terdaftar', 'linkedin', 'menuliskan', 'universitasnya', 'tidak', 'susah', 'move', 'kolom']",24,11,13,guru kuliah tidak daftar linkedin tulis universitas tidak susah move kolom,11,11
Astaga kenapa susah betul mau login ni captcha security nya ribet amat susah gk jelas.,negatif,2023-09-12,2023,astaga kenapa susah betul mau login ni captcha security nya ribet amat susah gk jelas,15,15,astaga kenapa susah betul mau login ini captcha security nya rumit amat susah tidak jelas,15,15,"['astaga', 'kenapa', 'susah', 'betul', 'mau', 'login', 'ini', 'captcha', 'security', 'nya', 'rumit', 'amat', 'susah', 'tidak', 'jelas']","['astaga', 'susah', 'login', 'captcha', 'security', 'nya', 'rumit', 'susah', 'tidak']",15,9,6,astaga susah login captcha security nya rumit susah tidak,9,9
Tolong info nya.. cara masukin berkas lamaran ke aplikasi ini cara nya gmna?? Ko ga bisa bisa ya.. mohon info nya..,negatif,2021-08-22,2021,tolong info nya cara masukin berkas lamaran ke aplikasi ini cara nya gmna ko ga bisa bisa ya mohon info nya,21,21,tolong informasi nya cara masukkan berkas lamaran ke aplikasi ini cara nya bagaimana kok tidak bisa bisa ya mohon informasi nya,21,21,"['tolong', 'informasi', 'nya', 'cara', 'masukkan', 'berkas', 'lamaran', 'ke', 'aplikasi', 'ini', 'cara', 'nya', 'bagaimana', 'kok', 'tidak', 'bisa', 'bisa', 'ya', 'mohon', 'informasi', 'nya']","['tolong', 'informasi', 'nya', 'masukkan', 'berkas', 'lamaran', 'aplikasi', 'nya', 'tidak', 'ya', 'mohon', 'informasi', 'nya']",21,13,8,tolong informasi nya masuk berkas lamar aplikasi nya tidak ya mohon informasi nya,13,13
Membuat banyak link n jaringan yg sangat bermanfaat,positif,2022-07-01,2022,membuat banyak link n jaringan yg sangat bermanfaat,8,8,membuat banyak link dan jaringan yang sangat bermanfaat,8,8,"['membuat', 'banyak', 'link', 'dan', 'jaringan', 'yang', 'sangat', 'bermanfaat']","['link', 'jaringan', 'bermanfaat']",8,3,5,link jaring manfaat,3,3
Sangat bermanfaat untuk menambah persahabatan dan lowongan pekerjaan,positif,2020-06-23,2020,sangat bermanfaat untuk menambah persahabatan dan lowongan pekerjaan,8,8,sangat bermanfaat untuk menambah persahabatan dan lowongan pekerjaan,8,8,"['sangat', 'bermanfaat', 'untuk', 'menambah', 'persahabatan', 'dan', 'lowongan', 'pekerjaan']","['bermanfaat', 'menambah', 'persahabatan', 'lowongan', 'pekerjaan']",8,5,3,manfaat tambah sahabat lowong kerja,5,5
Sumpah kesel bgt udah 3 akun kali buat linkedin tapi ke log out sendiri. App gajelas!!!,negatif,2023-08-17,2023,sumpah kesel bgt udah akun kali buat linkedin tapi ke log out sendiri app gajelas,16,15,sumpah kesel banget sudah akun kali buat linkedin tapi ke log out sendiri aplikasi tidak jelas,15,16,"['sumpah', 'kesel', 'banget', 'sudah', 'akun', 'kali', 'buat', 'linkedin', 'tapi', 'ke', 'log', 'out', 'sendiri', 'aplikasi', 'tidak', 'jelas']","['sumpah', 'kesel', 'banget', 'akun', 'kali', 'linkedin', 'log', 'out', 'aplikasi', 'tidak']",16,10,6,sumpah kesel banget akun kali linkedin log out aplikasi tidak,10,10
Verifikasi chapta udah bener tapi ngulang terus gk selesai selesai.,negatif,2023-04-19,2023,verifikasi chapta udah bener tapi ngulang terus gk selesai selesai,10,10,verifikasi chapta sudah benar tapi mengulang terus tidak selesai selesai,10,10,"['verifikasi', 'chapta', 'sudah', 'benar', 'tapi', 'mengulang', 'terus', 'tidak', 'selesai', 'selesai']","['verifikasi', 'chapta', 'mengulang', 'tidak', 'selesai', 'selesai']",10,6,4,verifikasi chapta ulang tidak selesai selesai,6,6
Good Job dan tepat pada sasaran untuk para pencari kerja,positif,2020-08-23,2020,good job dan tepat pada sasaran untuk para pencari kerja,10,10,bagus kerja dan tepat pada sasaran untuk para pencari kerja,10,10,"['bagus', 'kerja', 'dan', 'tepat', 'pada', 'sasaran', 'untuk', 'para', 'pencari', 'kerja']","['bagus', 'kerja', 'sasaran', 'pencari', 'kerja']",10,5,5,bagus kerja sasar cari kerja,5,5
"padahal email udah ku masukkan pasword udah ku masukkan,udah ku konpirmasihkan gmail ku masa minta konpirmasihkan lagi,tolong dong di perbaikin",negatif,2020-10-22,2020,padahal email udah ku masukkan pasword udah ku masukkan udah ku konpirmasihkan gmail ku masa minta konpirmasihkan lagi tolong dong di perbaikin,20,22,padahal email sudah saya masukkan pasword sudah saya masukkan sudah saya konpirmasihkan gmail saya masa minta konpirmasihkan lagi tolong dong di perbaikin,22,22,"['padahal', 'email', 'sudah', 'saya', 'masukkan', 'pasword', 'sudah', 'saya', 'masukkan', 'sudah', 'saya', 'konpirmasihkan', 'gmail', 'saya', 'masa', 'minta', 'konpirmasihkan', 'lagi', 'tolong', 'dong', 'di', 'perbaikin']","['email', 'masukkan', 'pasword', 'masukkan', 'konpirmasihkan', 'gmail', 'konpirmasihkan', 'tolong', 'perbaikin']",22,9,13,email masuk pasword masuk konpirmasihkan gmail konpirmasihkan tolong perbaikin,9,9
Sudah berapa kali login tidak bisa juga padahal sudah ngikutin arahan,negatif,2024-03-01,2024,sudah berapa kali login tidak bisa juga padahal sudah ngikutin arahan,11,11,sudah berapa kali login tidak bisa juga padahal sudah ngikutin arahan,11,11,"['sudah', 'berapa', 'kali', 'login', 'tidak', 'bisa', 'juga', 'padahal', 'sudah', 'ngikutin', 'arahan']","['kali', 'login', 'tidak', 'ngikutin', 'arahan']",11,5,6,kali login tidak ngikutin arah,5,5
"tanpa alasan yang jelas akun saya terblokir, setelah di suruh verifikasi kartu ID katanya gak cocok, capek ladenin bot digmail,",negatif,2021-04-04,2021,tanpa alasan yang jelas akun saya terblokir setelah di suruh verifikasi kartu id katanya gak cocok capek ladenin bot digmail,20,20,tanpa alasan yang jelas akun saya terblokir setelah di suruh verifikasi kartu id katanya tidak cocok capek ladenin bot digmail,20,20,"['tanpa', 'alasan', 'yang', 'jelas', 'akun', 'saya', 'terblokir', 'setelah', 'di', 'suruh', 'verifikasi', 'kartu', 'id', 'katanya', 'tidak', 'cocok', 'capek', 'ladenin', 'bot', 'digmail']","['alasan', 'akun', 'terblokir', 'suruh', 'verifikasi', 'kartu', 'id', 'tidak', 'cocok', 'capek', 'ladenin', 'bot', 'digmail']",20,13,7,alas akun blokir suruh verifikasi kartu id tidak cocok capek ladenin bot digmail,13,13
Apk bermasalah Mulu klo mau apply,negatif,2024-05-28,2024,apk bermasalah mulu klo mau apply,6,6,aplikasi bermasalah mulu kalau mau apply,6,6,"['aplikasi', 'bermasalah', 'mulu', 'kalau', 'mau', 'apply']","['aplikasi', 'bermasalah', 'mulu', 'apply']",6,4,2,aplikasi masalah mulu apply,4,4
Oke ditingkatkan lgi untuk sistem pencarian nya. Thanks.,positif,2022-09-07,2022,oke ditingkatkan lgi untuk sistem pencarian nya thanks,8,8,oke ditingkatkan lagi untuk sistem pencarian nya terima kasih,8,9,"['oke', 'ditingkatkan', 'lagi', 'untuk', 'sistem', 'pencarian', 'nya', 'terima', 'kasih']","['oke', 'ditingkatkan', 'sistem', 'pencarian', 'nya', 'terima', 'kasih']",9,7,2,oke tingkat sistem cari nya terima kasih,7,7
Sangat recomended untuk orang yang mau kerja di perusahaan dalam maupun luar negeri,positif,2021-12-16,2021,sangat recomended untuk orang yang mau kerja di perusahaan dalam maupun luar negeri,13,13,sangat rekomendasi untuk orang yang mau kerja di perusahaan dalam maupun luar negeri,13,13,"['sangat', 'rekomendasi', 'untuk', 'orang', 'yang', 'mau', 'kerja', 'di', 'perusahaan', 'dalam', 'maupun', 'luar', 'negeri']","['rekomendasi', 'orang', 'kerja', 'perusahaan', 'negeri']",13,5,8,rekomendasi orang kerja usaha negeri,5,5
Verification gk jelas,negatif,2024-03-22,2024,verification gk jelas,3,3,verification tidak jelas,3,3,"['verification', 'tidak', 'jelas']","['verification', 'tidak']",3,2,1,verification tidak,2,2
"Loker nya yang banyak lah tambah masa itu itu mulu ga berubah ga dipanggil """,negatif,2022-08-27,2022,loker nya yang banyak lah tambah masa itu itu mulu ga berubah ga dipanggil,15,14,loker nya yang banyak lah tambah masa itu itu mulu tidak berubah tidak dipanggil,14,14,"['loker', 'nya', 'yang', 'banyak', 'lah', 'tambah', 'masa', 'itu', 'itu', 'mulu', 'tidak', 'berubah', 'tidak', 'dipanggil']","['loker', 'nya', 'mulu', 'tidak', 'berubah', 'tidak', 'dipanggil']",14,7,7,loker nya mulu tidak ubah tidak panggil,7,7
Terlalu banya yang di jumplink ke aplikasi/website lain. Hampir semuanya sekarang.,negatif,2023-01-01,2023,terlalu banya yang di jumplink ke aplikasi website lain hampir semuanya sekarang,11,12,terlalu banya yang di jumplink ke aplikasi website lain hampir semuanya sekarang,12,12,"['terlalu', 'banya', 'yang', 'di', 'jumplink', 'ke', 'aplikasi', 'website', 'lain', 'hampir', 'semuanya', 'sekarang']","['banya', 'jumplink', 'aplikasi', 'website']",12,4,8,banya jumplink aplikasi website,4,4
Sangat baik dan sangat membantu buat yang membutuhkan pekerjaan,positif,2022-02-23,2022,sangat baik dan sangat membantu buat yang membutuhkan pekerjaan,9,9,sangat baik dan sangat membantu buat yang membutuhkan pekerjaan,9,9,"['sangat', 'baik', 'dan', 'sangat', 'membantu', 'buat', 'yang', 'membutuhkan', 'pekerjaan']","['membantu', 'membutuhkan', 'pekerjaan']",9,3,6,bantu butuh kerja,3,3
Cukup membantu saat adanya kecurigaan tentang kebenaran sebuah perusahaan Semoga bisa lebih baik lagi #linkedln,positif,2021-11-11,2021,cukup membantu saat adanya kecurigaan tentang kebenaran sebuah perusahaan semoga bisa lebih baik lagi linkedln,15,15,cukup membantu saat adanya kecurigaan tentang kebenaran sebuah perusahaan semoga bisa lebih baik lagi linkedln,15,15,"['cukup', 'membantu', 'saat', 'adanya', 'kecurigaan', 'tentang', 'kebenaran', 'sebuah', 'perusahaan', 'semoga', 'bisa', 'lebih', 'baik', 'lagi', 'linkedln']","['membantu', 'kecurigaan', 'kebenaran', 'perusahaan', 'semoga', 'linkedln']",15,6,9,bantu curiga benar usaha moga linkedln,6,6
"bagaimana saya bisa melihat akun saya karena saya tidak bisa login kembali, sedangkan dalam akun saya sebelumnya berisi data pribadi saya",negatif,2022-05-02,2022,bagaimana saya bisa melihat akun saya karena saya tidak bisa login kembali sedangkan dalam akun saya sebelumnya berisi data pribadi saya,21,21,bagaimana saya bisa melihat akun saya karena saya tidak bisa login kembali sedangkan dalam akun saya sebelumnya berisi data pribadi saya,21,21,"['bagaimana', 'saya', 'bisa', 'melihat', 'akun', 'saya', 'karena', 'saya', 'tidak', 'bisa', 'login', 'kembali', 'sedangkan', 'dalam', 'akun', 'saya', 'sebelumnya', 'berisi', 'data', 'pribadi', 'saya']","['akun', 'tidak', 'login', 'akun', 'berisi', 'data', 'pribadi']",21,7,14,akun tidak login akun isi data pribadi,7,7
"Aplikasi bodoh, gw daftar ratusan kali gabisa bisa, pake google dll, tolong lah benerin jangan sampe ini apk jadi dead apk tlol",negatif,2021-05-06,2021,aplikasi bodoh gw daftar ratusan kali gabisa bisa pake google dll tolong lah benerin jangan sampe ini apk jadi dead apk tlol,22,22,aplikasi bodoh saya daftar ratusan kali tidak bisa bisa pakai google dan lain lain tolong lah benerin jangan sampai ini aplikasi jadi dead aplikasi tlol,22,25,"['aplikasi', 'bodoh', 'saya', 'daftar', 'ratusan', 'kali', 'tidak', 'bisa', 'bisa', 'pakai', 'google', 'dan', 'lain', 'lain', 'tolong', 'lah', 'benerin', 'jangan', 'sampai', 'ini', 'aplikasi', 'jadi', 'dead', 'aplikasi', 'tlol']","['aplikasi', 'bodoh', 'daftar', 'ratusan', 'kali', 'tidak', 'pakai', 'google', 'tolong', 'benerin', 'aplikasi', 'dead', 'aplikasi', 'tlol']",25,14,11,aplikasi bodoh daftar ratus kali tidak pakai google tolong benerin aplikasi dead aplikasi tlol,14,14
Memper mudah mencari lowongan pekerjaan,positif,2023-07-24,2023,memper mudah mencari lowongan pekerjaan,5,5,memper mudah mencari lowongan pekerjaan,5,5,"['memper', 'mudah', 'mencari', 'lowongan', 'pekerjaan']","['memper', 'mudah', 'mencari', 'lowongan', 'pekerjaan']",5,5,0,memper mudah cari lowong kerja,5,5
"Kenapa profil saya tidak bisa pakai foto, padahal upload berkali2",negatif,2020-07-13,2020,kenapa profil saya tidak bisa pakai foto padahal upload berkali,10,10,kenapa profil saya tidak bisa pakai foto padahal unggah berkali,10,10,"['kenapa', 'profil', 'saya', 'tidak', 'bisa', 'pakai', 'foto', 'padahal', 'unggah', 'berkali']","['profil', 'tidak', 'pakai', 'foto', 'unggah', 'berkali']",10,6,4,profil tidak pakai foto unggah kali,6,6
Sdah bagus hanya trus berivasi agar linkedin bisah bersaing dengan aplikasi lain.,positif,2020-09-10,2020,sdah bagus hanya trus berivasi agar linkedin bisah bersaing dengan aplikasi lain,12,12,sdah bagus hanya terus berivasi agar linkedin bisah bersaing dengan aplikasi lain,12,12,"['sdah', 'bagus', 'hanya', 'terus', 'berivasi', 'agar', 'linkedin', 'bisah', 'bersaing', 'dengan', 'aplikasi', 'lain']","['sdah', 'bagus', 'berivasi', 'linkedin', 'bisah', 'bersaing', 'aplikasi']",12,7,5,sdah bagus berivasi linkedin bisah saing aplikasi,7,7
"Bagus sekali, mempercepat jalan meniti karier dan kesuksesan",positif,2020-07-27,2020,bagus sekali mempercepat jalan meniti karier dan kesuksesan,8,8,bagus sekali mempercepat jalan meniti karier dan kesuksesan,8,8,"['bagus', 'sekali', 'mempercepat', 'jalan', 'meniti', 'karier', 'dan', 'kesuksesan']","['bagus', 'mempercepat', 'jalan', 'meniti', 'karier', 'kesuksesan']",8,6,2,bagus cepat jalan titi karier sukses,6,6
Saya suka aplikasi ini.,positif,2024-04-18,2024,saya suka aplikasi ini,4,4,saya suka aplikasi ini,4,4,"['saya', 'suka', 'aplikasi', 'ini']","['suka', 'aplikasi']",4,2,2,suka aplikasi,2,2
Sangat membantu dalam menjalin komunikasi di pekerjaan..thank so much,positif,2020-06-23,2020,sangat membantu dalam menjalin komunikasi di pekerjaan thank so much,9,10,sangat membantu dalam menjalin komunikasi di pekerjaan terima kasih so much,10,11,"['sangat', 'membantu', 'dalam', 'menjalin', 'komunikasi', 'di', 'pekerjaan', 'terima', 'kasih', 'so', 'much']","['membantu', 'menjalin', 'komunikasi', 'pekerjaan', 'terima', 'kasih', 'so', 'much']",11,8,3,bantu jalin komunikasi kerja terima kasih so much,8,8
"Dengan adanya applikasi ini,aku lebih leluasa mengetahui semua informasi tentang lowongan pekerjaan. Semoga applikasi ini tambah sukses.",positif,2023-07-22,2023,dengan adanya applikasi ini aku lebih leluasa mengetahui semua informasi tentang lowongan pekerjaan semoga applikasi ini tambah sukses,17,18,dengan adanya aplikasi ini aku lebih leluasa mengetahui semua informasi tentang lowongan pekerjaan semoga aplikasi ini tambah sukses,18,18,"['dengan', 'adanya', 'aplikasi', 'ini', 'aku', 'lebih', 'leluasa', 'mengetahui', 'semua', 'informasi', 'tentang', 'lowongan', 'pekerjaan', 'semoga', 'aplikasi', 'ini', 'tambah', 'sukses']","['aplikasi', 'leluasa', 'informasi', 'lowongan', 'pekerjaan', 'semoga', 'aplikasi', 'sukses']",18,8,10,aplikasi leluasa informasi lowong kerja moga aplikasi sukses,8,8
Maaf aku kasih bintang 1 soalnya akun aku dinonaktifkan tanpa alasan yang jelas. Dan saat mau dipulihkan lagi tetep ngga bisa.,negatif,2021-10-08,2021,maaf aku kasih bintang soalnya akun aku dinonaktifkan tanpa alasan yang jelas dan saat mau dipulihkan lagi tetep ngga bisa,21,20,maaf aku kasih bintang soalnya akun aku dinonaktifkan tanpa alasan yang jelas dan saat mau dipulihkan lagi tetap tidak bisa,20,20,"['maaf', 'aku', 'kasih', 'bintang', 'soalnya', 'akun', 'aku', 'dinonaktifkan', 'tanpa', 'alasan', 'yang', 'jelas', 'dan', 'saat', 'mau', 'dipulihkan', 'lagi', 'tetap', 'tidak', 'bisa']","['maaf', 'kasih', 'bintang', 'akun', 'dinonaktifkan', 'alasan', 'dipulihkan', 'tidak']",20,8,12,maaf kasih bintang akun nonaktif alas pulih tidak,8,8
"Saya tidak bisa upload foto di LinkedIn setelah update, mohon penjelasannya",negatif,2021-11-05,2021,saya tidak bisa upload foto di linkedin setelah update mohon penjelasannya,11,11,saya tidak bisa unggah foto di linkedin setelah diperbarui mohon penjelasannya,11,11,"['saya', 'tidak', 'bisa', 'unggah', 'foto', 'di', 'linkedin', 'setelah', 'diperbarui', 'mohon', 'penjelasannya']","['tidak', 'unggah', 'foto', 'linkedin', 'diperbarui', 'mohon', 'penjelasannya']",11,7,4,tidak unggah foto linkedin baru mohon jelas,7,7
"respon captcha nya nyusahin nih, gagal masuk akun lama terus, tolong perbaiki",negatif,2023-07-29,2023,respon captcha nya nyusahin nih gagal masuk akun lama terus tolong perbaiki,12,12,respons captcha nya nyusahin nih gagal masuk akun lama terus tolong perbaikan,12,12,"['respons', 'captcha', 'nya', 'nyusahin', 'nih', 'gagal', 'masuk', 'akun', 'lama', 'terus', 'tolong', 'perbaikan']","['respons', 'captcha', 'nya', 'nyusahin', 'nih', 'gagal', 'masuk', 'akun', 'tolong', 'perbaikan']",12,10,2,respons captcha nya nyusahin nih gagal masuk akun tolong baik,10,10
Aplikasi yang sangat membantu pencari kerja di Indonesia,positif,2022-07-19,2022,aplikasi yang sangat membantu pencari kerja di indonesia,8,8,aplikasi yang sangat membantu pencari kerja di indonesia,8,8,"['aplikasi', 'yang', 'sangat', 'membantu', 'pencari', 'kerja', 'di', 'indonesia']","['aplikasi', 'membantu', 'pencari', 'kerja', 'indonesia']",8,5,3,aplikasi bantu cari kerja indonesia,5,5
"Verifikasi captcha yg sangat buruk, udah nebak yg bener tetep salah.",negatif,2023-08-08,2023,verifikasi captcha yg sangat buruk udah nebak yg bener tetep salah,11,11,verifikasi captcha yang sangat buruk sudah nebak yang benar tetap salah,11,11,"['verifikasi', 'captcha', 'yang', 'sangat', 'buruk', 'sudah', 'nebak', 'yang', 'benar', 'tetap', 'salah']","['verifikasi', 'captcha', 'buruk', 'nebak', 'salah']",11,5,6,verifikasi captcha buruk nebak salah,5,5
Sangat tidak recomend.. Aplikasi yang ribet sulit dan sungguh buruk🖕,negatif,2023-01-12,2023,sangat tidak recomend aplikasi yang ribet sulit dan sungguh buruk,10,10,sangat tidak rekomendasi aplikasi yang rumit sulit dan sungguh buruk,10,10,"['sangat', 'tidak', 'rekomendasi', 'aplikasi', 'yang', 'rumit', 'sulit', 'dan', 'sungguh', 'buruk']","['tidak', 'rekomendasi', 'aplikasi', 'rumit', 'sulit', 'sungguh', 'buruk']",10,7,3,tidak rekomendasi aplikasi rumit sulit sungguh buruk,7,7
Great app. Good app terbaik pisan . Lebih bermanfaat untuk jobseeker,positif,2020-09-08,2020,great app good app terbaik pisan lebih bermanfaat untuk jobseeker,11,10,great aplikasi bagus aplikasi terbaik pisan lebih bermanfaat untuk jobseeker,10,10,"['great', 'aplikasi', 'bagus', 'aplikasi', 'terbaik', 'pisan', 'lebih', 'bermanfaat', 'untuk', 'jobseeker']","['great', 'aplikasi', 'bagus', 'aplikasi', 'terbaik', 'pisan', 'bermanfaat', 'jobseeker']",10,8,2,great aplikasi bagus aplikasi baik pis manfaat jobseeker,8,8
"Verifikasinya kurang susah, bisa di susahin lagi gak? Ini aja udah susah banget loh",negatif,2023-07-31,2023,verifikasinya kurang susah bisa di susahin lagi gak ini aja udah susah banget loh,14,14,verifikasinya kurang susah bisa di susahin lagi tidak ini saja sudah susah banget loh,14,14,"['verifikasinya', 'kurang', 'susah', 'bisa', 'di', 'susahin', 'lagi', 'tidak', 'ini', 'saja', 'sudah', 'susah', 'banget', 'loh']","['verifikasinya', 'susah', 'susahin', 'tidak', 'susah', 'banget', 'loh']",14,7,7,verifikasi susah susahin tidak susah banget loh,7,7
"Sangat Bagus, saling share information hard work seluruh negara.🙏👍👍",positif,2021-07-22,2021,sangat bagus saling share information hard work seluruh negara,9,9,sangat bagus saling share information hard work seluruh negara,9,9,"['sangat', 'bagus', 'saling', 'share', 'information', 'hard', 'work', 'seluruh', 'negara']","['bagus', 'share', 'information', 'hard', 'work', 'negara']",9,6,3,bagus share information hard work negara,6,6
Bertualang didunia internet mencari job yang terbaik buat saya.Makasih Linkedln!,negatif,2020-02-14,2020,bertualang didunia internet mencari job yang terbaik buat saya makasih linkedln,10,11,bertualang didunia internet mencari kerja yang terbaik buat saya terima kasih linkedln,11,12,"['bertualang', 'didunia', 'internet', 'mencari', 'kerja', 'yang', 'terbaik', 'buat', 'saya', 'terima', 'kasih', 'linkedln']","['bertualang', 'didunia', 'internet', 'mencari', 'kerja', 'terbaik', 'terima', 'kasih', 'linkedln']",12,9,3,tualang dunia internet cari kerja baik terima kasih linkedln,9,9
Sangat bermanfaat untuk karir dan koneksi di dunia profesional,positif,2023-10-30,2023,sangat bermanfaat untuk karir dan koneksi di dunia profesional,9,9,sangat bermanfaat untuk karir dan koneksi di dunia profesional,9,9,"['sangat', 'bermanfaat', 'untuk', 'karir', 'dan', 'koneksi', 'di', 'dunia', 'profesional']","['bermanfaat', 'karir', 'koneksi', 'dunia', 'profesional']",9,5,4,manfaat karir koneksi dunia profesional,5,5
"Aplikasi ribet ,bukan mempermudah malah mempersulit",negatif,2022-07-13,2022,aplikasi ribet bukan mempermudah malah mempersulit,6,6,aplikasi rumit bukan mempermudah bahkan mempersulit,6,6,"['aplikasi', 'rumit', 'bukan', 'mempermudah', 'bahkan', 'mempersulit']","['aplikasi', 'rumit', 'mempermudah', 'mempersulit']",6,4,2,aplikasi rumit mudah sulit,4,4
mau masuk harus update kalau gak update gak bisa masuk,negatif,2022-10-28,2022,mau masuk harus update kalau gak update gak bisa masuk,10,10,mau masuk harus diperbarui kalau tidak diperbarui tidak bisa masuk,10,10,"['mau', 'masuk', 'harus', 'diperbarui', 'kalau', 'tidak', 'diperbarui', 'tidak', 'bisa', 'masuk']","['masuk', 'diperbarui', 'tidak', 'diperbarui', 'tidak', 'masuk']",10,6,4,masuk baru tidak baru tidak masuk,6,6
Oke bagus. Bisa untuk menyimpan CV yg berguna untuk masa mendatang,positif,2022-07-21,2022,oke bagus bisa untuk menyimpan cv yg berguna untuk masa mendatang,11,11,oke bagus bisa untuk menyimpan cv yang berguna untuk masa mendatang,11,11,"['oke', 'bagus', 'bisa', 'untuk', 'menyimpan', 'cv', 'yang', 'berguna', 'untuk', 'masa', 'mendatang']","['oke', 'bagus', 'menyimpan', 'cv', 'berguna']",11,5,6,oke bagus simpan cv guna,5,5
Aplikasi yang bagus dan bermanfaat untuk pekerja atau student,positif,2022-10-22,2022,aplikasi yang bagus dan bermanfaat untuk pekerja atau student,9,9,aplikasi yang bagus dan bermanfaat untuk yang kerja atau student,9,10,"['aplikasi', 'yang', 'bagus', 'dan', 'bermanfaat', 'untuk', 'yang', 'kerja', 'atau', 'student']","['aplikasi', 'bagus', 'bermanfaat', 'kerja', 'student']",10,5,5,aplikasi bagus manfaat kerja student,5,5
"Sangat membantu, tapi ini kenapa saya tidak bisa memasukkan pengalaman saya ya? Padahal di linkedIn punya teman-teman saya pada bisa. Mohon bantuannya",positif,2022-11-04,2022,sangat membantu tapi ini kenapa saya tidak bisa memasukkan pengalaman saya ya padahal di linkedin punya teman teman saya pada bisa mohon bantuannya,22,23,sangat membantu tapi ini kenapa saya tidak bisa memasukkan pengalaman saya ya padahal di linkedin punya teman teman saya pada bisa mohon bantuannya,23,23,"['sangat', 'membantu', 'tapi', 'ini', 'kenapa', 'saya', 'tidak', 'bisa', 'memasukkan', 'pengalaman', 'saya', 'ya', 'padahal', 'di', 'linkedin', 'punya', 'teman', 'teman', 'saya', 'pada', 'bisa', 'mohon', 'bantuannya']","['membantu', 'tidak', 'memasukkan', 'pengalaman', 'ya', 'linkedin', 'teman', 'teman', 'mohon', 'bantuannya']",23,10,13,bantu tidak masuk alam ya linkedin teman teman mohon bantu,10,10
Sangat mudah di gunakan,positif,2024-06-11,2024,sangat mudah di gunakan,4,4,sangat mudah di gunakan,4,4,"['sangat', 'mudah', 'di', 'gunakan']",['mudah'],4,1,3,mudah,1,1
Apaan sih verifikasi aja terus sampe mampus!! Bikin aplikasi sampah banget,negatif,2024-03-04,2024,apaan sih verifikasi aja terus sampe mampus bikin aplikasi sampah banget,11,11,apa sih verifikasi saja terus sampai mampus bikin aplikasi sampah banget,11,11,"['apa', 'sih', 'verifikasi', 'saja', 'terus', 'sampai', 'mampus', 'bikin', 'aplikasi', 'sampah', 'banget']","['sih', 'verifikasi', 'mampus', 'bikin', 'aplikasi', 'sampah', 'banget']",11,7,4,sih verifikasi mampus bikin aplikasi sampah banget,7,7
Aplikasi simple Verifikasi juga simple Pokoknya serba simple 👍💪✌️🐈,positif,2022-06-29,2022,aplikasi simple verifikasi juga simple pokoknya serba simple,9,8,aplikasi simpel verifikasi juga simpel pokoknya serba simpel,8,8,"['aplikasi', 'simpel', 'verifikasi', 'juga', 'simpel', 'pokoknya', 'serba', 'simpel']","['aplikasi', 'simpel', 'verifikasi', 'simpel', 'pokoknya', 'serba', 'simpel']",8,7,1,aplikasi simpel verifikasi simpel pokok serba simpel,7,7
Sangat membantu para pencari kerja di dalam negeri dan di luar negeri,positif,2022-10-01,2022,sangat membantu para pencari kerja di dalam negeri dan di luar negeri,12,12,sangat membantu para pencari kerja di dalam negeri dan di luar negeri,12,12,"['sangat', 'membantu', 'para', 'pencari', 'kerja', 'di', 'dalam', 'negeri', 'dan', 'di', 'luar', 'negeri']","['membantu', 'pencari', 'kerja', 'negeri', 'negeri']",12,5,7,bantu cari kerja negeri negeri,5,5
"Bagus, untuk mempermudah mencari pekerjaan dengan dipertemukan orang2 yang 1 circle dengan kita",positif,2021-09-27,2021,bagus untuk mempermudah mencari pekerjaan dengan dipertemukan orang yang circle dengan kita,13,12,bagus untuk mempermudah mencari pekerjaan dengan dipertemukan orang yang circle dengan kita,12,12,"['bagus', 'untuk', 'mempermudah', 'mencari', 'pekerjaan', 'dengan', 'dipertemukan', 'orang', 'yang', 'circle', 'dengan', 'kita']","['bagus', 'mempermudah', 'mencari', 'pekerjaan', 'dipertemukan', 'orang', 'circle']",12,7,5,bagus mudah cari kerja temu orang circle,7,7
Mohon kembalikan uang saya karna saya tidak memakai fitur premiumnya harganya sangat mahal sampai 4 juta sangat merugikan bagi saya 😡,negatif,2022-03-25,2022,mohon kembalikan uang saya karna saya tidak memakai fitur premiumnya harganya sangat mahal sampai juta sangat merugikan bagi saya,21,19,mohon kembalikan uang saya karena saya tidak memakai fitur premiumnya harganya sangat mahal sampai juta sangat merugikan bagi saya,19,19,"['mohon', 'kembalikan', 'uang', 'saya', 'karena', 'saya', 'tidak', 'memakai', 'fitur', 'premiumnya', 'harganya', 'sangat', 'mahal', 'sampai', 'juta', 'sangat', 'merugikan', 'bagi', 'saya']","['mohon', 'kembalikan', 'uang', 'tidak', 'memakai', 'fitur', 'premiumnya', 'harganya', 'mahal', 'juta', 'merugikan']",19,11,8,mohon kembali uang tidak pakai fitur premium harga mahal juta rugi,11,11
Sangat membantu untuk jaringan pencari kerja,positif,2020-05-10,2020,sangat membantu untuk jaringan pencari kerja,6,6,sangat membantu untuk jaringan pencari kerja,6,6,"['sangat', 'membantu', 'untuk', 'jaringan', 'pencari', 'kerja']","['membantu', 'jaringan', 'pencari', 'kerja']",6,4,2,bantu jaring cari kerja,4,4
Aplikasi ini banyak membantu saya dalam mencari kerja serta banyak juga memperoleh ilmu dari para praktisi HRD melalui ulasan nya yang bermanfaat.,positif,2021-02-08,2021,aplikasi ini banyak membantu saya dalam mencari kerja serta banyak juga memperoleh ilmu dari para praktisi hrd melalui ulasan nya yang bermanfaat,22,22,aplikasi ini banyak membantu saya dalam mencari kerja serta banyak juga memperoleh ilmu dari para praktisi hrd melalui ulasan nya yang bermanfaat,22,22,"['aplikasi', 'ini', 'banyak', 'membantu', 'saya', 'dalam', 'mencari', 'kerja', 'serta', 'banyak', 'juga', 'memperoleh', 'ilmu', 'dari', 'para', 'praktisi', 'hrd', 'melalui', 'ulasan', 'nya', 'yang', 'bermanfaat']","['aplikasi', 'membantu', 'mencari', 'kerja', 'memperoleh', 'ilmu', 'praktisi', 'hrd', 'ulasan', 'nya', 'bermanfaat']",22,11,11,aplikasi bantu cari kerja oleh ilmu praktisi hrd ulas nya manfaat,11,11
"Repot amat masuk ke akun sndri udh set jam lebih nggk masuk"" invalid mulu",negatif,2024-01-02,2024,repot amat masuk ke akun sndri udh set jam lebih nggk masuk invalid mulu,14,14,repot amat masuk ke akun sendiri sudah set jam lebih tidak masuk invalid mulu,14,14,"['repot', 'amat', 'masuk', 'ke', 'akun', 'sendiri', 'sudah', 'set', 'jam', 'lebih', 'tidak', 'masuk', 'invalid', 'mulu']","['repot', 'masuk', 'akun', 'set', 'jam', 'tidak', 'masuk', 'invalid', 'mulu']",14,9,5,repot masuk akun set jam tidak masuk invalid mulu,9,9
"Yoss, auto uninstall.. Dev lu mau ngabantu orang apa mempersulit orang? Di awal mau masuk disuruh verfikasi aja dipersulit, gk jelas banget",negatif,2021-09-28,2021,yoss auto uninstall dev lu mau ngabantu orang apa mempersulit orang di awal mau masuk disuruh verfikasi aja dipersulit gk jelas banget,22,22,yoss otomatis uninstall dev lu mau ngabantu orang apa mempersulit orang di awal mau masuk disuruh verfikasi saja dipersulit tidak jelas banget,22,22,"['yoss', 'otomatis', 'uninstall', 'dev', 'lu', 'mau', 'ngabantu', 'orang', 'apa', 'mempersulit', 'orang', 'di', 'awal', 'mau', 'masuk', 'disuruh', 'verfikasi', 'saja', 'dipersulit', 'tidak', 'jelas', 'banget']","['yoss', 'otomatis', 'uninstall', 'dev', 'lu', 'ngabantu', 'orang', 'mempersulit', 'orang', 'masuk', 'disuruh', 'verfikasi', 'dipersulit', 'tidak', 'banget']",22,15,7,yoss otomatis uninstall dev lu ngabantu orang sulit orang masuk suruh verfikasi sulit tidak banget,15,15
alhamdulillah aplikasi ini sangat membantu. saya bisa mendapatkan pekerjaan lewat aplikasi ini.. terima kasih,positif,2021-04-21,2021,alhamdulillah aplikasi ini sangat membantu saya bisa mendapatkan pekerjaan lewat aplikasi ini terima kasih,14,14,alhamdulillah aplikasi ini sangat membantu saya bisa mendapatkan pekerjaan lewat aplikasi ini terima kasih,14,14,"['alhamdulillah', 'aplikasi', 'ini', 'sangat', 'membantu', 'saya', 'bisa', 'mendapatkan', 'pekerjaan', 'lewat', 'aplikasi', 'ini', 'terima', 'kasih']","['alhamdulillah', 'aplikasi', 'membantu', 'pekerjaan', 'aplikasi', 'terima', 'kasih']",14,7,7,alhamdulillah aplikasi bantu kerja aplikasi terima kasih,7,7
Banyak memberikan informasi yg bagus dari dunia teknologi maupun lowongan pekerjaan,positif,2024-03-02,2024,banyak memberikan informasi yg bagus dari dunia teknologi maupun lowongan pekerjaan,11,11,banyak memberikan informasi yang bagus dari dunia teknologi maupun lowongan pekerjaan,11,11,"['banyak', 'memberikan', 'informasi', 'yang', 'bagus', 'dari', 'dunia', 'teknologi', 'maupun', 'lowongan', 'pekerjaan']","['informasi', 'bagus', 'dunia', 'teknologi', 'lowongan', 'pekerjaan']",11,6,5,informasi bagus dunia teknologi lowong kerja,6,6
"Verifikasi nya ngga jelas, setiap tahap akhir verifikasi selalu salah.",negatif,2021-08-26,2021,verifikasi nya ngga jelas setiap tahap akhir verifikasi selalu salah,10,10,verifikasi nya tidak jelas setiap tahap akhir verifikasi selalu salah,10,10,"['verifikasi', 'nya', 'tidak', 'jelas', 'setiap', 'tahap', 'akhir', 'verifikasi', 'selalu', 'salah']","['verifikasi', 'nya', 'tidak', 'tahap', 'verifikasi', 'salah']",10,6,4,verifikasi nya tidak tahap verifikasi salah,6,6
"Bikin tes keamanan kenapa ribet amat :'), saya mau cari kerja malah gabisa lewatin tes tebak gambar gajelas gini.",negatif,2022-06-03,2022,bikin tes keamanan kenapa ribet amat saya mau cari kerja malah gabisa lewatin tes tebak gambar gajelas gini,19,18,bikin tes keamanan kenapa rumit amat saya mau cari kerja bahkan tidak bisa lewatin tes tebak gambar tidak jelas begini,18,20,"['bikin', 'tes', 'keamanan', 'kenapa', 'rumit', 'amat', 'saya', 'mau', 'cari', 'kerja', 'bahkan', 'tidak', 'bisa', 'lewatin', 'tes', 'tebak', 'gambar', 'tidak', 'jelas', 'begini']","['bikin', 'tes', 'keamanan', 'rumit', 'cari', 'kerja', 'tidak', 'lewatin', 'tes', 'tebak', 'gambar', 'tidak']",20,12,8,bikin tes aman rumit cari kerja tidak lewatin tes tebak gambar tidak,12,12
"Trimakasi sangat membantu dlm mencari pekerjaan, dan sudah dipertemukan dgn org"" yg profesional",positif,2020-06-12,2020,trimakasi sangat membantu dlm mencari pekerjaan dan sudah dipertemukan dgn org yg profesional,13,13,trimakasi sangat membantu dalam mencari pekerjaan dan sudah dipertemukan dengan orang yang profesional,13,13,"['trimakasi', 'sangat', 'membantu', 'dalam', 'mencari', 'pekerjaan', 'dan', 'sudah', 'dipertemukan', 'dengan', 'orang', 'yang', 'profesional']","['trimakasi', 'membantu', 'mencari', 'pekerjaan', 'dipertemukan', 'orang', 'profesional']",13,7,6,trimakasi bantu cari kerja temu orang profesional,7,7
Sangat membantu memudahkan mencari pekerjaan bagi yg benar benar membutuhkan,positif,2020-04-06,2020,sangat membantu memudahkan mencari pekerjaan bagi yg benar benar membutuhkan,10,10,sangat membantu memudahkan mencari pekerjaan bagi yang benar benar membutuhkan,10,10,"['sangat', 'membantu', 'memudahkan', 'mencari', 'pekerjaan', 'bagi', 'yang', 'benar', 'benar', 'membutuhkan']","['membantu', 'memudahkan', 'mencari', 'pekerjaan', 'membutuhkan']",10,5,5,bantu mudah cari kerja butuh,5,5
Verifikasi linkedln sangat menyusahkan harus memilih kucing menghadap keatas.,negatif,2022-03-01,2022,verifikasi linkedln sangat menyusahkan harus memilih kucing menghadap keatas,9,9,verifikasi linkedln sangat menyusahkan harus memilih kucing menghadap keatas,9,9,"['verifikasi', 'linkedln', 'sangat', 'menyusahkan', 'harus', 'memilih', 'kucing', 'menghadap', 'keatas']","['verifikasi', 'linkedln', 'menyusahkan', 'memilih', 'kucing', 'menghadap', 'keatas']",9,7,2,verifikasi linkedln susah pilih kucing hadap atas,7,7
Menghubungan banyak orang,positif,2024-07-01,2024,menghubungan banyak orang,3,3,menghubungan banyak orang,3,3,"['menghubungan', 'banyak', 'orang']","['menghubungan', 'orang']",3,2,1,hubung orang,2,2
Tidak kompatibel di perangkat saya,negatif,2024-08-29,2024,tidak kompatibel di perangkat saya,5,5,tidak kompatibel di perangkat saya,5,5,"['tidak', 'kompatibel', 'di', 'perangkat', 'saya']","['tidak', 'kompatibel', 'perangkat']",5,3,2,tidak kompatibel perangkat,3,3
Gimana mau login coba kalo disuruh pecahkan teka teki mulu jawaban nya ga ada yg bener sm sekali...,negatif,2021-02-18,2021,gimana mau login coba kalo disuruh pecahkan teka teki mulu jawaban nya ga ada yg bener sm sekali,18,18,bagaimana mau login coba kalau disuruh pecahkan teka teki mulu jawaban nya tidak ada yang benar sama sekali,18,18,"['bagaimana', 'mau', 'login', 'coba', 'kalau', 'disuruh', 'pecahkan', 'teka', 'teki', 'mulu', 'jawaban', 'nya', 'tidak', 'ada', 'yang', 'benar', 'sama', 'sekali']","['login', 'coba', 'disuruh', 'pecahkan', 'teka', 'teki', 'mulu', 'nya', 'tidak']",18,9,9,login coba suruh pecah teka teki mulu nya tidak,9,9
Applikasi bagus untuk pencari kerja dn sebaliknya,positif,2023-09-23,2023,applikasi bagus untuk pencari kerja dn sebaliknya,7,7,aplikasi bagus untuk pencari kerja dan sebaliknya,7,7,"['aplikasi', 'bagus', 'untuk', 'pencari', 'kerja', 'dan', 'sebaliknya']","['aplikasi', 'bagus', 'pencari', 'kerja']",7,4,3,aplikasi bagus cari kerja,4,4
"Banyak informasi yg bermanfaat,peluang karir perusahaan , sangat bagus",positif,2021-04-24,2021,banyak informasi yg bermanfaat peluang karir perusahaan sangat bagus,9,9,banyak informasi yang bermanfaat peluang karir perusahaan sangat bagus,9,9,"['banyak', 'informasi', 'yang', 'bermanfaat', 'peluang', 'karir', 'perusahaan', 'sangat', 'bagus']","['informasi', 'bermanfaat', 'peluang', 'karir', 'perusahaan', 'bagus']",9,6,3,informasi manfaat peluang karir usaha bagus,6,6
sangat membantu memperluas jaringan pekerjaan,positif,2020-07-22,2020,sangat membantu memperluas jaringan pekerjaan,5,5,sangat membantu memperluas jaringan pekerjaan,5,5,"['sangat', 'membantu', 'memperluas', 'jaringan', 'pekerjaan']","['membantu', 'memperluas', 'jaringan', 'pekerjaan']",5,4,1,bantu luas jaring kerja,4,4
Tolong buat kan tes kuis nya.. Bahasa indonesia.. Tq,negatif,2020-11-25,2020,tolong buat kan tes kuis nya bahasa indonesia tq,9,9,tolong buat akan tes kuis nya bahasa indonesia terima kasih,9,10,"['tolong', 'buat', 'akan', 'tes', 'kuis', 'nya', 'bahasa', 'indonesia', 'terima', 'kasih']","['tolong', 'tes', 'kuis', 'nya', 'bahasa', 'indonesia', 'terima', 'kasih']",10,8,2,tolong tes kuis nya bahasa indonesia terima kasih,8,8
Aplikasi yang sangat mendukung buar pencari kerja,positif,2023-05-20,2023,aplikasi yang sangat mendukung buar pencari kerja,7,7,aplikasi yang sangat mendukung buar pencari kerja,7,7,"['aplikasi', 'yang', 'sangat', 'mendukung', 'buar', 'pencari', 'kerja']","['aplikasi', 'mendukung', 'buar', 'pencari', 'kerja']",7,5,2,aplikasi dukung buar cari kerja,5,5
Apk gak guna mendingan di hapus saja dari apps store/playstore sampah kek gini masih ada,negatif,2022-11-07,2022,apk gak guna mendingan di hapus saja dari apps store playstore sampah kek gini masih ada,15,16,aplikasi tidak guna mendingan di hapus saja dari aplikasi store playstore sampah seperti begini masih ada,16,16,"['aplikasi', 'tidak', 'guna', 'mendingan', 'di', 'hapus', 'saja', 'dari', 'aplikasi', 'store', 'playstore', 'sampah', 'seperti', 'begini', 'masih', 'ada']","['aplikasi', 'tidak', 'mendingan', 'hapus', 'aplikasi', 'store', 'playstore', 'sampah']",16,8,8,aplikasi tidak mending hapus aplikasi store playstore sampah,8,8
Tolong dong. Kok saya login-login tidak pernah bisa 😭😭😭😭,negatif,2020-05-24,2020,tolong dong kok saya login login tidak pernah bisa,9,9,tolong dong kok saya login login tidak pernah bisa,9,9,"['tolong', 'dong', 'kok', 'saya', 'login', 'login', 'tidak', 'pernah', 'bisa']","['tolong', 'login', 'login', 'tidak']",9,4,5,tolong login login tidak,4,4
Aplikasi selalu error pada waktu verifikasi,negatif,2023-08-11,2023,aplikasi selalu error pada waktu verifikasi,6,6,aplikasi selalu error pada waktu verifikasi,6,6,"['aplikasi', 'selalu', 'error', 'pada', 'waktu', 'verifikasi']","['aplikasi', 'error', 'verifikasi']",6,3,3,aplikasi error verifikasi,3,3
Aplikasi bodong penipuan anjg Jan ad yg instal ntar nyesel sumpah,negatif,2020-04-11,2020,aplikasi bodong penipuan anjg jan ad yg instal ntar nyesel sumpah,11,11,aplikasi bodong penipuan anjg jangan ada yang memasang entar menyesal sumpah,11,11,"['aplikasi', 'bodong', 'penipuan', 'anjg', 'jangan', 'ada', 'yang', 'memasang', 'entar', 'menyesal', 'sumpah']","['aplikasi', 'bodong', 'penipuan', 'anjg', 'memasang', 'entar', 'menyesal', 'sumpah']",11,8,3,aplikasi bodong tipu anjg pasang entar sesal sumpah,8,8
Sangat membantu dalam mencari pekerjaan dan relasi 😉,positif,2023-05-30,2023,sangat membantu dalam mencari pekerjaan dan relasi,8,7,sangat membantu dalam mencari pekerjaan dan relasi,7,7,"['sangat', 'membantu', 'dalam', 'mencari', 'pekerjaan', 'dan', 'relasi']","['membantu', 'mencari', 'pekerjaan', 'relasi']",7,4,3,bantu cari kerja relasi,4,4
Kok saya gabisa masuk ke akun Dan stuck di puzzle gmna ya?,negatif,2024-03-30,2024,kok saya gabisa masuk ke akun dan stuck di puzzle gmna ya,12,12,kok saya tidak bisa masuk ke akun dan stuck di puzzle bagaimana ya,12,13,"['kok', 'saya', 'tidak', 'bisa', 'masuk', 'ke', 'akun', 'dan', 'stuck', 'di', 'puzzle', 'bagaimana', 'ya']","['tidak', 'masuk', 'akun', 'stuck', 'puzzle', 'ya']",13,6,7,tidak masuk akun stuck puzzle ya,6,6
Keren sangat membantu dan menolong jobless!,positif,2022-09-13,2022,keren sangat membantu dan menolong jobless,6,6,keren sangat membantu dan menolong jobless,6,6,"['keren', 'sangat', 'membantu', 'dan', 'menolong', 'jobless']","['keren', 'membantu', 'menolong', 'jobless']",6,4,2,keren bantu tolong jobless,4,4
Indahnya info yg sya trima... Terima kasih atas bantuannya... Nanti akn sya instal kembali saat perangkat sya membaik...,positif,2020-05-18,2020,indahnya info yg sya trima terima kasih atas bantuannya nanti akn sya instal kembali saat perangkat sya membaik,18,18,indahnya informasi yang saya terima terima kasih atas bantuannya nanti akan saya memasang kembali saat perangkat saya membaik,18,18,"['indahnya', 'informasi', 'yang', 'saya', 'terima', 'terima', 'kasih', 'atas', 'bantuannya', 'nanti', 'akan', 'saya', 'memasang', 'kembali', 'saat', 'perangkat', 'saya', 'membaik']","['indahnya', 'informasi', 'terima', 'terima', 'kasih', 'bantuannya', 'memasang', 'perangkat', 'membaik']",18,9,9,indah informasi terima terima kasih bantu pasang perangkat baik,9,9
Sangat bagus dan membantu untuk membangun CV kita,positif,2020-10-28,2020,sangat bagus dan membantu untuk membangun cv kita,8,8,sangat bagus dan membantu untuk membangun cv kita,8,8,"['sangat', 'bagus', 'dan', 'membantu', 'untuk', 'membangun', 'cv', 'kita']","['bagus', 'membantu', 'membangun', 'cv']",8,4,4,bagus bantu bangun cv,4,4
Verifikasi susah minta ampun auto unistal sampah,negatif,2024-06-01,2024,verifikasi susah minta ampun auto unistal sampah,7,7,verifikasi susah minta ampun otomatis unistal sampah,7,7,"['verifikasi', 'susah', 'minta', 'ampun', 'otomatis', 'unistal', 'sampah']","['verifikasi', 'susah', 'ampun', 'otomatis', 'unistal', 'sampah']",7,6,1,verifikasi susah ampun otomatis unistal sampah,6,6
Bagus sekali,positif,2024-07-02,2024,bagus sekali,2,2,bagus sekali,2,2,"['bagus', 'sekali']",['bagus'],2,1,1,bagus,1,1
"Sangat membantu n semakin banyak teman yg profesional,terima kasih",positif,2021-04-26,2021,sangat membantu n semakin banyak teman yg profesional terima kasih,9,10,sangat membantu dan semakin banyak teman yang profesional terima kasih,10,10,"['sangat', 'membantu', 'dan', 'semakin', 'banyak', 'teman', 'yang', 'profesional', 'terima', 'kasih']","['membantu', 'teman', 'profesional', 'terima', 'kasih']",10,5,5,bantu teman profesional terima kasih,5,5
Terlalu bertele tele. Kebanyakan verifikasi dan ga jelas.,negatif,2023-05-22,2023,terlalu bertele tele kebanyakan verifikasi dan ga jelas,8,8,terlalu bertele tele kebanyakan verifikasi dan tidak jelas,8,8,"['terlalu', 'bertele', 'tele', 'kebanyakan', 'verifikasi', 'dan', 'tidak', 'jelas']","['bertele', 'tele', 'kebanyakan', 'verifikasi', 'tidak']",8,5,3,tele tele banyak verifikasi tidak,5,5
Aplikasi yang sangat berguna untuk mencari pekerjaan 😇💐,positif,2024-01-03,2024,aplikasi yang sangat berguna untuk mencari pekerjaan,8,7,aplikasi yang sangat berguna untuk mencari pekerjaan,7,7,"['aplikasi', 'yang', 'sangat', 'berguna', 'untuk', 'mencari', 'pekerjaan']","['aplikasi', 'berguna', 'mencari', 'pekerjaan']",7,4,3,aplikasi guna cari kerja,4,4
Saya tidak bisa login akun. Susah sekali skarang login g kayak dulu lagi.,negatif,2023-05-08,2023,saya tidak bisa login akun susah sekali skarang login g kayak dulu lagi,13,13,saya tidak bisa login akun susah sekali sekarang login tidak kayak dahulu lagi,13,13,"['saya', 'tidak', 'bisa', 'login', 'akun', 'susah', 'sekali', 'sekarang', 'login', 'tidak', 'kayak', 'dahulu', 'lagi']","['tidak', 'login', 'akun', 'susah', 'login', 'tidak', 'kayak']",13,7,6,tidak login akun susah login tidak kayak,7,7
Verifikasi ga jls 😖😖😖,negatif,2024-06-27,2024,verifikasi ga jls,4,3,verifikasi tidak jls,3,3,"['verifikasi', 'tidak', 'jls']","['verifikasi', 'tidak', 'jls']",3,3,0,verifikasi tidak jls,3,3
Crash melulu baru juga di buka uda keluar lg dg sendirinya.,negatif,2023-10-03,2023,crash melulu baru juga di buka uda keluar lg dg sendirinya,11,11,crash melulu baru juga di buka sudah keluar lagi dengan sendirinya,11,11,"['crash', 'melulu', 'baru', 'juga', 'di', 'buka', 'sudah', 'keluar', 'lagi', 'dengan', 'sendirinya']","['crash', 'melulu', 'buka']",11,3,8,crash melulu buka,3,3
Sangat membantu dalam sebuah informasi dan pemberdayaan masyarakat.,positif,2020-11-04,2020,sangat membantu dalam sebuah informasi dan pemberdayaan masyarakat,8,8,sangat membantu dalam sebuah informasi dan pemberdayaan masyarakat,8,8,"['sangat', 'membantu', 'dalam', 'sebuah', 'informasi', 'dan', 'pemberdayaan', 'masyarakat']","['membantu', 'informasi', 'pemberdayaan', 'masyarakat']",8,4,4,bantu informasi daya masyarakat,4,4
Aplikasi terbaik untuk membuka cara berfikir dan memperbanyak sahabat juga saudara.,positif,2022-07-27,2022,aplikasi terbaik untuk membuka cara berfikir dan memperbanyak sahabat juga saudara,11,11,aplikasi terbaik untuk membuka cara berfikir dan memperbanyak sahabat juga saudara,11,11,"['aplikasi', 'terbaik', 'untuk', 'membuka', 'cara', 'berfikir', 'dan', 'memperbanyak', 'sahabat', 'juga', 'saudara']","['aplikasi', 'terbaik', 'membuka', 'berfikir', 'memperbanyak', 'sahabat', 'saudara']",11,7,4,aplikasi baik buka berfikir banyak sahabat saudara,7,7
"lumayan banyak sih loker, tapi blm begitu puas",positif,2021-02-21,2021,lumayan banyak sih loker tapi blm begitu puas,8,8,lumayan banyak sih loker tapi belum begitu puas,8,8,"['lumayan', 'banyak', 'sih', 'loker', 'tapi', 'belum', 'begitu', 'puas']","['lumayan', 'sih', 'loker', 'puas']",8,4,4,lumayan sih loker puas,4,4
"teka teki yg sulit di pahami , udah coba 1 1 juga salah bingung sama teka teki verifikasi",negatif,2022-06-03,2022,teka teki yg sulit di pahami udah coba juga salah bingung sama teka teki verifikasi,18,15,teka teki yang sulit di pahami sudah coba juga salah bingung sama teka teki verifikasi,15,15,"['teka', 'teki', 'yang', 'sulit', 'di', 'pahami', 'sudah', 'coba', 'juga', 'salah', 'bingung', 'sama', 'teka', 'teki', 'verifikasi']","['teka', 'teki', 'sulit', 'pahami', 'coba', 'salah', 'bingung', 'teka', 'teki', 'verifikasi']",15,10,5,teka teki sulit paham coba salah bingung teka teki verifikasi,10,10
Sangat baik dan membantu informasi dalam lowongan pekerjaan,positif,2022-07-05,2022,sangat baik dan membantu informasi dalam lowongan pekerjaan,8,8,sangat baik dan membantu informasi dalam lowongan pekerjaan,8,8,"['sangat', 'baik', 'dan', 'membantu', 'informasi', 'dalam', 'lowongan', 'pekerjaan']","['membantu', 'informasi', 'lowongan', 'pekerjaan']",8,4,4,bantu informasi lowong kerja,4,4
Sangat bagus mempertemukan banyak orang dan berbagi informasi,positif,2020-11-20,2020,sangat bagus mempertemukan banyak orang dan berbagi informasi,8,8,sangat bagus mempertemukan banyak orang dan berbagi informasi,8,8,"['sangat', 'bagus', 'mempertemukan', 'banyak', 'orang', 'dan', 'berbagi', 'informasi']","['bagus', 'mempertemukan', 'orang', 'berbagi', 'informasi']",8,5,3,bagus temu orang bagi informasi,5,5
Sangat membantu dalam pencarian pekerjaan,positif,2023-03-02,2023,sangat membantu dalam pencarian pekerjaan,5,5,sangat membantu dalam pencarian pekerjaan,5,5,"['sangat', 'membantu', 'dalam', 'pencarian', 'pekerjaan']","['membantu', 'pencarian', 'pekerjaan']",5,3,2,bantu cari kerja,3,3
Aplikasi eror udh verifikasi TPI dibilang respons kode captcha belom diisi dan tidak valid,negatif,2024-01-21,2024,aplikasi eror udh verifikasi tpi dibilang respons kode captcha belom diisi dan tidak valid,14,14,aplikasi error sudah verifikasi tetapi dibilang respons kode captcha belum diisi dan tidak valid,14,14,"['aplikasi', 'error', 'sudah', 'verifikasi', 'tetapi', 'dibilang', 'respons', 'kode', 'captcha', 'belum', 'diisi', 'dan', 'tidak', 'valid']","['aplikasi', 'error', 'verifikasi', 'dibilang', 'respons', 'kode', 'captcha', 'diisi', 'tidak', 'valid']",14,10,4,aplikasi error verifikasi bilang respons kode captcha isi tidak valid,10,10
Sangat membantu mendapatkan akses kedunia luar berbagi pengalaman dan mencari sesuatu untuk pengembangan diri dan kegiatan usaha,positif,2021-09-20,2021,sangat membantu mendapatkan akses kedunia luar berbagi pengalaman dan mencari sesuatu untuk pengembangan diri dan kegiatan usaha,17,17,sangat membantu mendapatkan akses kedunia luar berbagi pengalaman dan mencari sesuatu untuk pengembangan diri dan kegiatan usaha,17,17,"['sangat', 'membantu', 'mendapatkan', 'akses', 'kedunia', 'luar', 'berbagi', 'pengalaman', 'dan', 'mencari', 'sesuatu', 'untuk', 'pengembangan', 'diri', 'dan', 'kegiatan', 'usaha']","['membantu', 'akses', 'kedunia', 'berbagi', 'pengalaman', 'mencari', 'pengembangan', 'kegiatan', 'usaha']",17,9,8,bantu akses dunia bagi alam cari kembang giat usaha,9,9
"buruk saya login gabisa"" pdhl semua data aktif malah suruh verifikasi",negatif,2023-11-24,2023,buruk saya login gabisa pdhl semua data aktif malah suruh verifikasi,11,11,buruk saya login tidak bisa padahal semua data aktif bahkan suruh verifikasi,11,12,"['buruk', 'saya', 'login', 'tidak', 'bisa', 'padahal', 'semua', 'data', 'aktif', 'bahkan', 'suruh', 'verifikasi']","['buruk', 'login', 'tidak', 'data', 'aktif', 'suruh', 'verifikasi']",12,7,5,buruk login tidak data aktif suruh verifikasi,7,7
Bagus dan nambah wawasan untuk pencari kerja juga teman.,positif,2023-03-20,2023,bagus dan nambah wawasan untuk pencari kerja juga teman,9,9,bagus dan nambah wawasan untuk pencari kerja juga teman,9,9,"['bagus', 'dan', 'nambah', 'wawasan', 'untuk', 'pencari', 'kerja', 'juga', 'teman']","['bagus', 'nambah', 'wawasan', 'pencari', 'kerja', 'teman']",9,6,3,bagus nambah wawas cari kerja teman,6,6
"Tidak bisa ganti kata sandi,, selalu minta kode autentifikasi",negatif,2022-06-08,2022,tidak bisa ganti kata sandi selalu minta kode autentifikasi,9,9,tidak bisa ganti kata sandi selalu minta kode autentifikasi,9,9,"['tidak', 'bisa', 'ganti', 'kata', 'sandi', 'selalu', 'minta', 'kode', 'autentifikasi']","['tidak', 'ganti', 'sandi', 'kode', 'autentifikasi']",9,5,4,tidak ganti sandi kode autentifikasi,5,5
"Untuk melamar harus masuk ke link lain lagi, dan susah untuk mengaksesnya.",negatif,2021-06-04,2021,untuk melamar harus masuk ke link lain lagi dan susah untuk mengaksesnya,12,12,untuk melamar harus masuk ke link lain lagi dan susah untuk mengaksesnya,12,12,"['untuk', 'melamar', 'harus', 'masuk', 'ke', 'link', 'lain', 'lagi', 'dan', 'susah', 'untuk', 'mengaksesnya']","['melamar', 'masuk', 'link', 'susah', 'mengaksesnya']",12,5,7,lamar masuk link susah akses,5,5
Aplikasi yang bagus untuk mendapatkan insight dan relasi,positif,2022-08-15,2022,aplikasi yang bagus untuk mendapatkan insight dan relasi,8,8,aplikasi yang bagus untuk mendapatkan insight dan relasi,8,8,"['aplikasi', 'yang', 'bagus', 'untuk', 'mendapatkan', 'insight', 'dan', 'relasi']","['aplikasi', 'bagus', 'insight', 'relasi']",8,4,4,aplikasi bagus insight relasi,4,4
Buat terbaik untuk pelayanan untuk loker yg membutuhkan dan akurat,positif,2020-07-17,2020,buat terbaik untuk pelayanan untuk loker yg membutuhkan dan akurat,10,10,buat terbaik untuk pelayanan untuk loker yang membutuhkan dan akurat,10,10,"['buat', 'terbaik', 'untuk', 'pelayanan', 'untuk', 'loker', 'yang', 'membutuhkan', 'dan', 'akurat']","['terbaik', 'pelayanan', 'loker', 'membutuhkan', 'akurat']",10,5,5,baik layan loker butuh akurat,5,5
Semoga dengan menggunakan aplikasi ini dapat membantu saya dalam mempelajari macam macam pengetahuan digital.,positif,2022-01-30,2022,semoga dengan menggunakan aplikasi ini dapat membantu saya dalam mempelajari macam macam pengetahuan digital,14,14,semoga dengan menggunakan aplikasi ini dapat membantu saya dalam mempelajari macam macam pengetahuan digital,14,14,"['semoga', 'dengan', 'menggunakan', 'aplikasi', 'ini', 'dapat', 'membantu', 'saya', 'dalam', 'mempelajari', 'macam', 'macam', 'pengetahuan', 'digital']","['semoga', 'aplikasi', 'membantu', 'mempelajari', 'pengetahuan', 'digital']",14,6,8,moga aplikasi bantu ajar tahu digital,6,6
"Berguna sekali,bagi mereka yg baru memulai mencari karier, menambah wawasan,.",positif,2022-04-12,2022,berguna sekali bagi mereka yg baru memulai mencari karier menambah wawasan,10,11,berguna sekali bagi mereka yang baru memulai mencari karier menambah wawasan,11,11,"['berguna', 'sekali', 'bagi', 'mereka', 'yang', 'baru', 'memulai', 'mencari', 'karier', 'menambah', 'wawasan']","['berguna', 'mencari', 'karier', 'menambah', 'wawasan']",11,5,6,guna cari karier tambah wawas,5,5
"Gambar tidak jelas verifikasi gagal teruuuuus,",negatif,2022-06-19,2022,gambar tidak jelas verifikasi gagal teruuuuus,6,6,gambar tidak jelas verifikasi gagal teruuuuus,6,6,"['gambar', 'tidak', 'jelas', 'verifikasi', 'gagal', 'teruuuuus']","['gambar', 'tidak', 'verifikasi', 'gagal', 'teruuuuus']",6,5,1,gambar tidak verifikasi gagal teruuuuus,5,5
"Susah mau daftar akun, verifikasinya lama banget salah mulu",negatif,2022-05-09,2022,susah mau daftar akun verifikasinya lama banget salah mulu,9,9,susah mau daftar akun verifikasinya lama banget salah mulu,9,9,"['susah', 'mau', 'daftar', 'akun', 'verifikasinya', 'lama', 'banget', 'salah', 'mulu']","['susah', 'daftar', 'akun', 'verifikasinya', 'banget', 'salah', 'mulu']",9,7,2,susah daftar akun verifikasi banget salah mulu,7,7
Saya kok ga bs update status ya.. Padahal dah update aplikasi,negatif,2020-08-03,2020,saya kok ga bs update status ya padahal dah update aplikasi,11,11,saya kok tidak bisa diperbarui status ya padahal sudah diperbarui aplikasi,11,11,"['saya', 'kok', 'tidak', 'bisa', 'diperbarui', 'status', 'ya', 'padahal', 'sudah', 'diperbarui', 'aplikasi']","['tidak', 'diperbarui', 'status', 'ya', 'diperbarui', 'aplikasi']",11,6,5,tidak baru status ya baru aplikasi,6,6
"Sangat mudah dan cepat membantu.., terima kasih 🙏🙏🙏 LinkedIn Ok is the best 👍👍👍",positif,2022-08-29,2022,sangat mudah dan cepat membantu terima kasih linkedin ok is the best,14,12,sangat mudah dan cepat membantu terima kasih linkedin oke is the terbaik,12,12,"['sangat', 'mudah', 'dan', 'cepat', 'membantu', 'terima', 'kasih', 'linkedin', 'oke', 'is', 'the', 'terbaik']","['mudah', 'cepat', 'membantu', 'terima', 'kasih', 'linkedin', 'oke', 'is', 'the', 'terbaik']",12,10,2,mudah cepat bantu terima kasih linkedin oke is the baik,10,10
Sangat membantu bagi pencari kerja.Terima kasih,positif,2021-08-23,2021,sangat membantu bagi pencari kerja terima kasih,6,7,sangat membantu bagi pencari kerja terima kasih,7,7,"['sangat', 'membantu', 'bagi', 'pencari', 'kerja', 'terima', 'kasih']","['membantu', 'pencari', 'kerja', 'terima', 'kasih']",7,5,2,bantu cari kerja terima kasih,5,5
"Sangat bermanfaat, sukses selalu Linkedln.",positif,2022-11-09,2022,sangat bermanfaat sukses selalu linkedln,5,5,sangat bermanfaat sukses selalu linkedln,5,5,"['sangat', 'bermanfaat', 'sukses', 'selalu', 'linkedln']","['bermanfaat', 'sukses', 'linkedln']",5,3,2,manfaat sukses linkedln,3,3
Sangat membantu dalam proses mencari pekerjaan,positif,2022-10-20,2022,sangat membantu dalam proses mencari pekerjaan,6,6,sangat membantu dalam proses mencari pekerjaan,6,6,"['sangat', 'membantu', 'dalam', 'proses', 'mencari', 'pekerjaan']","['membantu', 'proses', 'mencari', 'pekerjaan']",6,4,2,bantu proses cari kerja,4,4
Sangat sulit dapatkan lowongan kerja untuk tamatan SMA.,negatif,2022-10-22,2022,sangat sulit dapatkan lowongan kerja untuk tamatan sma,8,8,sangat sulit dapatkan lowongan kerja untuk tamatan sama,8,8,"['sangat', 'sulit', 'dapatkan', 'lowongan', 'kerja', 'untuk', 'tamatan', 'sama']","['sulit', 'dapatkan', 'lowongan', 'kerja', 'tamatan']",8,5,3,sulit dapat lowong kerja tamat,5,5
Rusak tampilan login tidak bisa,negatif,2023-10-12,2023,rusak tampilan login tidak bisa,5,5,rusak tampilan login tidak bisa,5,5,"['rusak', 'tampilan', 'login', 'tidak', 'bisa']","['rusak', 'tampilan', 'login', 'tidak']",5,4,1,rusak tampil login tidak,4,4
"Status lamaran dilihat doang, ga ada proses lanjutan",negatif,2023-08-31,2023,status lamaran dilihat doang ga ada proses lanjutan,8,8,status lamaran dilihat saja tidak ada proses lanjutan,8,8,"['status', 'lamaran', 'dilihat', 'saja', 'tidak', 'ada', 'proses', 'lanjutan']","['status', 'lamaran', 'tidak', 'proses', 'lanjutan']",8,5,3,status lamar tidak proses lanjut,5,5
Cukup kecewa dengan aplikasi ini sudah 2 kali akun saya di nonaktifkan tanpa pemberitahuan,negatif,2021-06-30,2021,cukup kecewa dengan aplikasi ini sudah kali akun saya di nonaktifkan tanpa pemberitahuan,14,13,cukup kecewa dengan aplikasi ini sudah kali akun saya di nonaktifkan tanpa pemberitahuan,13,13,"['cukup', 'kecewa', 'dengan', 'aplikasi', 'ini', 'sudah', 'kali', 'akun', 'saya', 'di', 'nonaktifkan', 'tanpa', 'pemberitahuan']","['kecewa', 'aplikasi', 'kali', 'akun', 'nonaktifkan', 'pemberitahuan']",13,6,7,kecewa aplikasi kali akun nonaktif pemberitahuan,6,6
Mempermudah dalam mencari pekerjaan dan menambah ilmu,positif,2023-06-09,2023,mempermudah dalam mencari pekerjaan dan menambah ilmu,7,7,mempermudah dalam mencari pekerjaan dan menambah ilmu,7,7,"['mempermudah', 'dalam', 'mencari', 'pekerjaan', 'dan', 'menambah', 'ilmu']","['mempermudah', 'mencari', 'pekerjaan', 'menambah', 'ilmu']",7,5,2,mudah cari kerja tambah ilmu,5,5
Sangat membantu bagi para pemula juga profesional,positif,2020-05-29,2020,sangat membantu bagi para pemula juga profesional,7,7,sangat membantu bagi para pemula juga profesional,7,7,"['sangat', 'membantu', 'bagi', 'para', 'pemula', 'juga', 'profesional']","['membantu', 'pemula', 'profesional']",7,3,4,bantu mula profesional,3,3
"Info lebih kumunikasi, linkedln, td nya sulit jadi mudah, order jd lancar",negatif,2021-02-18,2021,info lebih kumunikasi linkedln td nya sulit jadi mudah order jd lancar,12,12,informasi lebih kumunikasi linkedln tadi nya sulit jadi mudah pesan jadi lancar,12,12,"['informasi', 'lebih', 'kumunikasi', 'linkedln', 'tadi', 'nya', 'sulit', 'jadi', 'mudah', 'pesan', 'jadi', 'lancar']","['informasi', 'kumunikasi', 'linkedln', 'nya', 'sulit', 'mudah', 'pesan', 'lancar']",12,8,4,informasi kumunikasi linkedln nya sulit mudah pesan lancar,8,8
Banyak banget lowongan kerja yang bagus bagus,positif,2020-10-21,2020,banyak banget lowongan kerja yang bagus bagus,7,7,banyak banget lowongan kerja yang bagus bagus,7,7,"['banyak', 'banget', 'lowongan', 'kerja', 'yang', 'bagus', 'bagus']","['banget', 'lowongan', 'kerja', 'bagus', 'bagus']",7,5,2,banget lowong kerja bagus bagus,5,5
Mudah mudahan bagus dan dapat info peluang kerja,positif,2021-05-20,2021,mudah mudahan bagus dan dapat info peluang kerja,8,8,mudah mudahan bagus dan dapat informasi peluang kerja,8,8,"['mudah', 'mudahan', 'bagus', 'dan', 'dapat', 'informasi', 'peluang', 'kerja']","['mudah', 'mudahan', 'bagus', 'informasi', 'peluang', 'kerja']",8,6,2,mudah mudah bagus informasi peluang kerja,6,6
Ok lanjut terus. Lah pokoknya buat kalian yang gak punya linkedin buruan instal aplikasinya yaaaa...,positif,2023-01-18,2023,ok lanjut terus lah pokoknya buat kalian yang gak punya linkedin buruan instal aplikasinya yaaaa,15,15,oke lanjut terus lah pokoknya buat kalian yang tidak punya linkedin buruan memasang aplikasi nya yaaaa,15,16,"['oke', 'lanjut', 'terus', 'lah', 'pokoknya', 'buat', 'kalian', 'yang', 'tidak', 'punya', 'linkedin', 'buruan', 'memasang', 'aplikasi', 'nya', 'yaaaa']","['oke', 'pokoknya', 'tidak', 'linkedin', 'buruan', 'memasang', 'aplikasi', 'nya', 'yaaaa']",16,9,7,oke pokok tidak linkedin buru pasang aplikasi nya yaaaa,9,9
"Bengek banget nih, nggak bisa ganti foto profil.",negatif,2021-07-17,2021,bengek banget nih nggak bisa ganti foto profil,8,8,bengek banget nih tidak bisa ganti foto profil,8,8,"['bengek', 'banget', 'nih', 'tidak', 'bisa', 'ganti', 'foto', 'profil']","['bengek', 'banget', 'nih', 'tidak', 'ganti', 'foto', 'profil']",8,7,1,bengek banget nih tidak ganti foto profil,7,7
Semoga Lebih Mudah Cari Pekerjaan Dengan Adanya Aplikasi ini,positif,2020-09-28,2020,semoga lebih mudah cari pekerjaan dengan adanya aplikasi ini,9,9,semoga lebih mudah cari pekerjaan dengan adanya aplikasi ini,9,9,"['semoga', 'lebih', 'mudah', 'cari', 'pekerjaan', 'dengan', 'adanya', 'aplikasi', 'ini']","['semoga', 'mudah', 'cari', 'pekerjaan', 'aplikasi']",9,5,4,moga mudah cari kerja aplikasi,5,5
Aplikasi ini mempermudah orang untuk mendapatkan pekerjaan sesuai dengan yang dinginkan,positif,2022-07-02,2022,aplikasi ini mempermudah orang untuk mendapatkan pekerjaan sesuai dengan yang dinginkan,11,11,aplikasi ini mempermudah orang untuk mendapatkan pekerjaan sesuai dengan yang dinginkan,11,11,"['aplikasi', 'ini', 'mempermudah', 'orang', 'untuk', 'mendapatkan', 'pekerjaan', 'sesuai', 'dengan', 'yang', 'dinginkan']","['aplikasi', 'mempermudah', 'orang', 'pekerjaan', 'sesuai', 'dinginkan']",11,6,5,aplikasi mudah orang kerja sesuai dingin,6,6
"Sangat membantu sekali,,, Mohon linkedin untuk menyaring lowongan yang bohong",positif,2021-06-27,2021,sangat membantu sekali mohon linkedin untuk menyaring lowongan yang bohong,10,10,sangat membantu sekali mohon linkedin untuk menyaring lowongan yang bohong,10,10,"['sangat', 'membantu', 'sekali', 'mohon', 'linkedin', 'untuk', 'menyaring', 'lowongan', 'yang', 'bohong']","['membantu', 'mohon', 'linkedin', 'menyaring', 'lowongan', 'bohong']",10,6,4,bantu mohon linkedin nyaring lowong bohong,6,6
LinkedIn sangat membantu dan bermanfaat dalam mencari loker dan menambah link dalam dunia kerja,positif,2020-05-11,2020,linkedin sangat membantu dan bermanfaat dalam mencari loker dan menambah link dalam dunia kerja,14,14,linkedin sangat membantu dan bermanfaat dalam mencari loker dan menambah link dalam dunia kerja,14,14,"['linkedin', 'sangat', 'membantu', 'dan', 'bermanfaat', 'dalam', 'mencari', 'loker', 'dan', 'menambah', 'link', 'dalam', 'dunia', 'kerja']","['linkedin', 'membantu', 'bermanfaat', 'mencari', 'loker', 'menambah', 'link', 'dunia', 'kerja']",14,9,5,linkedin bantu manfaat cari loker tambah link dunia kerja,9,9
"Menambah, memperbesar link dan insight",positif,2021-08-10,2021,menambah memperbesar link dan insight,5,5,menambah memperbesar link dan insight,5,5,"['menambah', 'memperbesar', 'link', 'dan', 'insight']","['menambah', 'memperbesar', 'link', 'insight']",5,4,1,tambah besar link insight,4,4
"Repot harus instal lagi padahal sudah daftar,hapus sekalian...",negatif,2020-04-20,2020,repot harus instal lagi padahal sudah daftar hapus sekalian,8,9,repot harus memasang lagi padahal sudah daftar hapus sekalian,9,9,"['repot', 'harus', 'memasang', 'lagi', 'padahal', 'sudah', 'daftar', 'hapus', 'sekalian']","['repot', 'memasang', 'daftar', 'hapus']",9,4,5,repot pasang daftar hapus,4,4
Kenapa setiap kali ingin login selalu gagal dan sandi selalu salah dan harus masuk lagi ubah sandi lagi,negatif,2021-04-16,2021,kenapa setiap kali ingin login selalu gagal dan sandi selalu salah dan harus masuk lagi ubah sandi lagi,18,18,kenapa setiap kali ingin login selalu gagal dan sandi selalu salah dan harus masuk lagi ubah sandi lagi,18,18,"['kenapa', 'setiap', 'kali', 'ingin', 'login', 'selalu', 'gagal', 'dan', 'sandi', 'selalu', 'salah', 'dan', 'harus', 'masuk', 'lagi', 'ubah', 'sandi', 'lagi']","['kali', 'login', 'gagal', 'sandi', 'salah', 'masuk', 'ubah', 'sandi']",18,8,10,kali login gagal sandi salah masuk ubah sandi,8,8
Untuk yg lg cari peluang pekerjaan sangat bagus,positif,2020-04-14,2020,untuk yg lg cari peluang pekerjaan sangat bagus,8,8,untuk yang lagi cari peluang pekerjaan sangat bagus,8,8,"['untuk', 'yang', 'lagi', 'cari', 'peluang', 'pekerjaan', 'sangat', 'bagus']","['cari', 'peluang', 'pekerjaan', 'bagus']",8,4,4,cari peluang kerja bagus,4,4
Aplikasi yang sangat penting dalam dunia cari pekerjaan,positif,2022-10-13,2022,aplikasi yang sangat penting dalam dunia cari pekerjaan,8,8,aplikasi yang sangat penting dalam dunia cari pekerjaan,8,8,"['aplikasi', 'yang', 'sangat', 'penting', 'dalam', 'dunia', 'cari', 'pekerjaan']","['aplikasi', 'dunia', 'cari', 'pekerjaan']",8,4,4,aplikasi dunia cari kerja,4,4
Sangat membantu parapencari kerja,positif,2021-02-18,2021,sangat membantu parapencari kerja,4,4,sangat membantu parapencari kerja,4,4,"['sangat', 'membantu', 'parapencari', 'kerja']","['membantu', 'parapencari', 'kerja']",4,3,1,bantu parapencari kerja,3,3
Koneksi Dan Informasi Yang Sangat Bermanfaat,positif,2022-01-19,2022,koneksi dan informasi yang sangat bermanfaat,6,6,koneksi dan informasi yang sangat bermanfaat,6,6,"['koneksi', 'dan', 'informasi', 'yang', 'sangat', 'bermanfaat']","['koneksi', 'informasi', 'bermanfaat']",6,3,3,koneksi informasi manfaat,3,3
Sangat mudah dan informatif.,positif,2020-10-30,2020,sangat mudah dan informatif,4,4,sangat mudah dan informatif,4,4,"['sangat', 'mudah', 'dan', 'informatif']","['mudah', 'informatif']",4,2,2,mudah informatif,2,2
Aplikasi yang membantu banget cari pekerjaan.,positif,2023-08-06,2023,aplikasi yang membantu banget cari pekerjaan,6,6,aplikasi yang membantu banget cari pekerjaan,6,6,"['aplikasi', 'yang', 'membantu', 'banget', 'cari', 'pekerjaan']","['aplikasi', 'membantu', 'banget', 'cari', 'pekerjaan']",6,5,1,aplikasi bantu banget cari kerja,5,5
"Bagus, informatif untuk para profesional",positif,2020-09-29,2020,bagus informatif untuk para profesional,5,5,bagus informatif untuk para profesional,5,5,"['bagus', 'informatif', 'untuk', 'para', 'profesional']","['bagus', 'informatif', 'profesional']",5,3,2,bagus informatif profesional,3,3
Bagus sih. Hanya perusahaan di tempat ku tinggal tidak ada yg pakai ini app.. haha,positif,2020-09-14,2020,bagus sih hanya perusahaan di tempat ku tinggal tidak ada yg pakai ini app haha,15,15,bagus sih hanya perusahaan di tempat saya tinggal tidak ada yang pakai ini aplikasi haha,15,15,"['bagus', 'sih', 'hanya', 'perusahaan', 'di', 'tempat', 'saya', 'tinggal', 'tidak', 'ada', 'yang', 'pakai', 'ini', 'aplikasi', 'haha']","['bagus', 'sih', 'perusahaan', 'tinggal', 'tidak', 'pakai', 'aplikasi', 'haha']",15,8,7,bagus sih usaha tinggal tidak pakai aplikasi haha,8,8
"Akun saya diretas, verifikasi tidak merespon, login tidak bisa, saya sangat kecewa.",negatif,2023-05-21,2023,akun saya diretas verifikasi tidak merespon login tidak bisa saya sangat kecewa,12,12,akun saya diretas verifikasi tidak merespons login tidak bisa saya sangat kecewa,12,12,"['akun', 'saya', 'diretas', 'verifikasi', 'tidak', 'merespons', 'login', 'tidak', 'bisa', 'saya', 'sangat', 'kecewa']","['akun', 'diretas', 'verifikasi', 'tidak', 'merespons', 'login', 'tidak', 'kecewa']",12,8,4,akun retas verifikasi tidak respons login tidak kecewa,8,8
"Bikin akun gabisa, kalo bisa jadi gabisa login gtu aja trs",negatif,2021-09-05,2021,bikin akun gabisa kalo bisa jadi gabisa login gtu aja trs,11,11,bikin akun tidak bisa kalau bisa jadi tidak bisa login begitu saja terus,11,13,"['bikin', 'akun', 'tidak', 'bisa', 'kalau', 'bisa', 'jadi', 'tidak', 'bisa', 'login', 'begitu', 'saja', 'terus']","['bikin', 'akun', 'tidak', 'tidak', 'login']",13,5,8,bikin akun tidak tidak login,5,5
heran gabisa diakses kalo blm di update,negatif,2022-09-07,2022,heran gabisa diakses kalo blm di update,7,7,heran tidak bisa diakses kalau belum di diperbarui,7,8,"['heran', 'tidak', 'bisa', 'diakses', 'kalau', 'belum', 'di', 'diperbarui']","['heran', 'tidak', 'diakses', 'diperbarui']",8,4,4,heran tidak akses baru,4,4
"Kaga bisa login,tumben bgt biasanya lancar"" . Kalo misalkan di hack kenapa ga ada notif nya?",negatif,2023-09-05,2023,kaga bisa login tumben bgt biasanya lancar kalo misalkan di hack kenapa ga ada notif nya,16,16,tidak bisa login tumben banget biasanya lancar kalau misalkan di hack kenapa tidak ada notif nya,16,16,"['tidak', 'bisa', 'login', 'tumben', 'banget', 'biasanya', 'lancar', 'kalau', 'misalkan', 'di', 'hack', 'kenapa', 'tidak', 'ada', 'notif', 'nya']","['tidak', 'login', 'tumben', 'banget', 'lancar', 'hack', 'tidak', 'notif', 'nya']",16,9,7,tidak login tumben banget lancar hack tidak notif nya,9,9
Verifikasi sudah diisi tetapi gagal terus,negatif,2023-05-05,2023,verifikasi sudah diisi tetapi gagal terus,6,6,verifikasi sudah diisi tetapi gagal terus,6,6,"['verifikasi', 'sudah', 'diisi', 'tetapi', 'gagal', 'terus']","['verifikasi', 'diisi', 'gagal']",6,3,3,verifikasi isi gagal,3,3
Sangat membantu dalam mencari relasi bisnis yang lebih luas,positif,2021-02-06,2021,sangat membantu dalam mencari relasi bisnis yang lebih luas,9,9,sangat membantu dalam mencari relasi bisnis yang lebih luas,9,9,"['sangat', 'membantu', 'dalam', 'mencari', 'relasi', 'bisnis', 'yang', 'lebih', 'luas']","['membantu', 'mencari', 'relasi', 'bisnis', 'luas']",9,5,4,bantu cari relasi bisnis luas,5,5
Kenapa pas download susah banget ya. Berhenti diangka 93%,negatif,2020-05-21,2020,kenapa pas download susah banget ya berhenti diangka,9,8,kenapa pas unduh susah banget ya berhenti diangka,8,8,"['kenapa', 'pas', 'unduh', 'susah', 'banget', 'ya', 'berhenti', 'diangka']","['pas', 'unduh', 'susah', 'banget', 'ya', 'berhenti', 'diangka']",8,7,1,pas unduh susah banget ya henti angka,7,7
Sangat membantu untuk para pencari kerja,positif,2020-09-02,2020,sangat membantu untuk para pencari kerja,6,6,sangat membantu untuk para pencari kerja,6,6,"['sangat', 'membantu', 'untuk', 'para', 'pencari', 'kerja']","['membantu', 'pencari', 'kerja']",6,3,3,bantu cari kerja,3,3
"Crash pas quis lencana udah nomor 10 lebih, mantep bgt",negatif,2021-07-28,2021,crash pas quis lencana udah nomor lebih mantep bgt,10,9,crash pas quis lencana sudah nomor lebih mantap banget,9,9,"['crash', 'pas', 'quis', 'lencana', 'sudah', 'nomor', 'lebih', 'mantap', 'banget']","['crash', 'pas', 'quis', 'lencana', 'nomor', 'mantap', 'banget']",9,7,2,crash pas quis lencana nomor mantap banget,7,7
Sangat membantu sekali terutama buat cari pekerjaan 👍,positif,2020-03-25,2020,sangat membantu sekali terutama buat cari pekerjaan,8,7,sangat membantu sekali terutama buat cari pekerjaan,7,7,"['sangat', 'membantu', 'sekali', 'terutama', 'buat', 'cari', 'pekerjaan']","['membantu', 'cari', 'pekerjaan']",7,3,4,bantu cari kerja,3,3
"Suka sekali app ini, sharing dan nambah wawasan ... sgt OK 👍",positif,2020-01-31,2020,suka sekali app ini sharing dan nambah wawasan sgt ok,12,10,suka sekali aplikasi ini sharing dan nambah wawasan sangat oke,10,10,"['suka', 'sekali', 'aplikasi', 'ini', 'sharing', 'dan', 'nambah', 'wawasan', 'sangat', 'oke']","['suka', 'aplikasi', 'sharing', 'nambah', 'wawasan', 'oke']",10,6,4,suka aplikasi sharing nambah wawas oke,6,6
Ini gimana ya mau login verifikasi saja susah banget,negatif,2021-11-15,2021,ini gimana ya mau login verifikasi saja susah banget,9,9,ini bagaimana ya mau login verifikasi saja susah banget,9,9,"['ini', 'bagaimana', 'ya', 'mau', 'login', 'verifikasi', 'saja', 'susah', 'banget']","['ya', 'login', 'verifikasi', 'susah', 'banget']",9,5,4,ya login verifikasi susah banget,5,5
Aneh sama nih aplikasi eror terus pas dibuka,negatif,2023-09-29,2023,aneh sama nih aplikasi eror terus pas dibuka,8,8,aneh sama nih aplikasi error terus pas dibuka,8,8,"['aneh', 'sama', 'nih', 'aplikasi', 'error', 'terus', 'pas', 'dibuka']","['aneh', 'nih', 'aplikasi', 'error', 'pas', 'dibuka']",8,6,2,aneh nih aplikasi error pas buka,6,6
Susah banget mau login. Ini applikasi buruk banget,negatif,2023-11-09,2023,susah banget mau login ini applikasi buruk banget,8,8,susah banget mau login ini aplikasi buruk banget,8,8,"['susah', 'banget', 'mau', 'login', 'ini', 'aplikasi', 'buruk', 'banget']","['susah', 'banget', 'login', 'aplikasi', 'buruk', 'banget']",8,6,2,susah banget login aplikasi buruk banget,6,6
"Bermanfaat dan mudah di Linkedln, Terima kasih Linkedln",positif,2020-09-01,2020,bermanfaat dan mudah di linkedln terima kasih linkedln,8,8,bermanfaat dan mudah di linkedln terima kasih linkedln,8,8,"['bermanfaat', 'dan', 'mudah', 'di', 'linkedln', 'terima', 'kasih', 'linkedln']","['bermanfaat', 'mudah', 'linkedln', 'terima', 'kasih', 'linkedln']",8,6,2,manfaat mudah linkedln terima kasih linkedln,6,6
Sangat membntu dalam pengembangan jejaring dan portofolio,negatif,2020-07-07,2020,sangat membntu dalam pengembangan jejaring dan portofolio,7,7,sangat membntu dalam pengembangan jejaring dan portofolio,7,7,"['sangat', 'membntu', 'dalam', 'pengembangan', 'jejaring', 'dan', 'portofolio']","['membntu', 'pengembangan', 'jejaring', 'portofolio']",7,4,3,membntu kembang jejaring portofolio,4,4
Kenapa suka eror saat di buka tidak mau dan tidak respon..sangat kecewa si,negatif,2021-09-24,2021,kenapa suka eror saat di buka tidak mau dan tidak respon sangat kecewa si,13,14,kenapa suka error saat di buka tidak mau dan tidak respons sangat kecewa sih,14,14,"['kenapa', 'suka', 'error', 'saat', 'di', 'buka', 'tidak', 'mau', 'dan', 'tidak', 'respons', 'sangat', 'kecewa', 'sih']","['suka', 'error', 'buka', 'tidak', 'tidak', 'respons', 'kecewa', 'sih']",14,8,6,suka error buka tidak tidak respons kecewa sih,8,8
Sangat bermanfaat bagi yang mencari pekerjaan,positif,2022-01-11,2022,sangat bermanfaat bagi yang mencari pekerjaan,6,6,sangat bermanfaat bagi yang mencari pekerjaan,6,6,"['sangat', 'bermanfaat', 'bagi', 'yang', 'mencari', 'pekerjaan']","['bermanfaat', 'mencari', 'pekerjaan']",6,3,3,manfaat cari kerja,3,3
Sangat membantu untuk mencari relasi kerja,positif,2021-10-19,2021,sangat membantu untuk mencari relasi kerja,6,6,sangat membantu untuk mencari relasi kerja,6,6,"['sangat', 'membantu', 'untuk', 'mencari', 'relasi', 'kerja']","['membantu', 'mencari', 'relasi', 'kerja']",6,4,2,bantu cari relasi kerja,4,4
Sangt membantu untuk para pencari kerja. Terimakasih,positif,2023-11-06,2023,sangt membantu untuk para pencari kerja terimakasih,7,7,sangt membantu untuk para pencari kerja terima kasih,7,8,"['sangt', 'membantu', 'untuk', 'para', 'pencari', 'kerja', 'terima', 'kasih']","['sangt', 'membantu', 'pencari', 'kerja', 'terima', 'kasih']",8,6,2,sangt bantu cari kerja terima kasih,6,6
"Mantap, simple n cepat..",positif,2020-03-20,2020,mantap simple n cepat,4,4,mantap simpel dan cepat,4,4,"['mantap', 'simpel', 'dan', 'cepat']","['mantap', 'simpel', 'cepat']",4,3,1,mantap simpel cepat,3,3
ok mksh infony,positif,2024-06-25,2024,ok mksh infony,3,3,oke terima kasih infony,3,4,"['oke', 'terima', 'kasih', 'infony']","['oke', 'terima', 'kasih', 'infony']",4,4,0,oke terima kasih infony,4,4
"Gak bisa login, verifikasi gagal mulu di akhir.",negatif,2024-02-05,2024,gak bisa login verifikasi gagal mulu di akhir,8,8,tidak bisa login verifikasi gagal mulu di akhir,8,8,"['tidak', 'bisa', 'login', 'verifikasi', 'gagal', 'mulu', 'di', 'akhir']","['tidak', 'login', 'verifikasi', 'gagal', 'mulu']",8,5,3,tidak login verifikasi gagal mulu,5,5
Bagus & Sangat Membantu informasi lowongan kerja,positif,2021-02-26,2021,bagus sangat membantu informasi lowongan kerja,7,6,bagus sangat membantu informasi lowongan kerja,6,6,"['bagus', 'sangat', 'membantu', 'informasi', 'lowongan', 'kerja']","['bagus', 'membantu', 'informasi', 'lowongan', 'kerja']",6,5,1,bagus bantu informasi lowong kerja,5,5
"Looping di login, tlg di perbaiki..",negatif,2023-10-25,2023,looping di login tlg di perbaiki,6,6,looping di login tlg di perbaikan,6,6,"['looping', 'di', 'login', 'tlg', 'di', 'perbaikan']","['looping', 'login', 'tlg', 'perbaikan']",6,4,2,looping login tlg baik,4,4
Saya sangat terbantu dengan aplikasi ini karena dapat mencari pekerjaan lebih mudah,positif,2020-09-11,2020,saya sangat terbantu dengan aplikasi ini karena dapat mencari pekerjaan lebih mudah,12,12,saya sangat membantu dengan aplikasi ini karena dapat mencari pekerjaan lebih mudah,12,12,"['saya', 'sangat', 'membantu', 'dengan', 'aplikasi', 'ini', 'karena', 'dapat', 'mencari', 'pekerjaan', 'lebih', 'mudah']","['membantu', 'aplikasi', 'mencari', 'pekerjaan', 'mudah']",12,5,7,bantu aplikasi cari kerja mudah,5,5
"Bagian verifikasi sumpah susah banget hewan gak punya leher suruh milih yang menghadap keatas, udah gitu dibalik"" Lagi",negatif,2022-12-23,2022,bagian verifikasi sumpah susah banget hewan gak punya leher suruh milih yang menghadap keatas udah gitu dibalik lagi,18,18,bagian verifikasi sumpah susah banget hewan tidak punya leher suruh memilih yang menghadap keatas sudah begitu dibalik lagi,18,18,"['bagian', 'verifikasi', 'sumpah', 'susah', 'banget', 'hewan', 'tidak', 'punya', 'leher', 'suruh', 'memilih', 'yang', 'menghadap', 'keatas', 'sudah', 'begitu', 'dibalik', 'lagi']","['verifikasi', 'sumpah', 'susah', 'banget', 'hewan', 'tidak', 'leher', 'suruh', 'memilih', 'menghadap', 'keatas', 'dibalik']",18,12,6,verifikasi sumpah susah banget hewan tidak leher suruh pilih hadap atas balik,12,12
Sangat membantu untuk mencari lowongan kerja yang diinginkan,positif,2023-11-03,2023,sangat membantu untuk mencari lowongan kerja yang diinginkan,8,8,sangat membantu untuk mencari lowongan kerja yang diinginkan,8,8,"['sangat', 'membantu', 'untuk', 'mencari', 'lowongan', 'kerja', 'yang', 'diinginkan']","['membantu', 'mencari', 'lowongan', 'kerja']",8,4,4,bantu cari lowong kerja,4,4
captcha tidak valid padahal sudah memilih jawaban yang benar,negatif,2023-11-15,2023,captcha tidak valid padahal sudah memilih jawaban yang benar,9,9,captcha tidak valid padahal sudah memilih jawaban yang benar,9,9,"['captcha', 'tidak', 'valid', 'padahal', 'sudah', 'memilih', 'jawaban', 'yang', 'benar']","['captcha', 'tidak', 'valid', 'memilih']",9,4,5,captcha tidak valid pilih,4,4
"Tidak bisa login, security check nya error",negatif,2023-09-12,2023,tidak bisa login security check nya error,7,7,tidak bisa login security cek nya error,7,7,"['tidak', 'bisa', 'login', 'security', 'cek', 'nya', 'error']","['tidak', 'login', 'security', 'cek', 'nya', 'error']",7,6,1,tidak login security cek nya error,6,6
bagus bs nambah teman & mudah mencari informasi serta mencari dan mendapatkan pekerjaan yang cocok dengan kemampuan saya,positif,2022-03-23,2022,bagus bs nambah teman mudah mencari informasi serta mencari dan mendapatkan pekerjaan yang cocok dengan kemampuan saya,18,17,bagus bisa nambah teman mudah mencari informasi serta mencari dan mendapatkan pekerjaan yang cocok dengan kemampuan saya,17,17,"['bagus', 'bisa', 'nambah', 'teman', 'mudah', 'mencari', 'informasi', 'serta', 'mencari', 'dan', 'mendapatkan', 'pekerjaan', 'yang', 'cocok', 'dengan', 'kemampuan', 'saya']","['bagus', 'nambah', 'teman', 'mudah', 'mencari', 'informasi', 'mencari', 'pekerjaan', 'cocok', 'kemampuan']",17,10,7,bagus nambah teman mudah cari informasi cari kerja cocok mampu,10,10
"Saya tidak bisa posting, padahal sudah ditefresh bahkan sampe ganti password",negatif,2023-08-16,2023,saya tidak bisa posting padahal sudah ditefresh bahkan sampe ganti password,11,11,saya tidak bisa posting padahal sudah ditefresh bahkan sampai ganti password,11,11,"['saya', 'tidak', 'bisa', 'posting', 'padahal', 'sudah', 'ditefresh', 'bahkan', 'sampai', 'ganti', 'password']","['tidak', 'posting', 'ditefresh', 'ganti', 'password']",11,5,6,tidak posting ditefresh ganti password,5,5
Keamanan terlalu ribet... Sudah beut cara buat akunnya. Bete ah.,negatif,2022-05-21,2022,keamanan terlalu ribet sudah beut cara buat akunnya bete ah,10,10,keamanan terlalu rumit sudah banget cara buat akunnya bosan ah,10,10,"['keamanan', 'terlalu', 'rumit', 'sudah', 'banget', 'cara', 'buat', 'akunnya', 'bosan', 'ah']","['keamanan', 'rumit', 'banget', 'akunnya', 'bosan', 'ah']",10,6,4,aman rumit banget akun bosan ah,6,6
Lumayan lancar setelah di update,positif,2021-09-23,2021,lumayan lancar setelah di update,5,5,lumayan lancar setelah di diperbarui,5,5,"['lumayan', 'lancar', 'setelah', 'di', 'diperbarui']","['lumayan', 'lancar', 'diperbarui']",5,3,2,lumayan lancar baru,3,3
"Ga bisa login ajg, padahal udah verifikasi berbagai macam ajg lah",negatif,2023-12-31,2023,ga bisa login ajg padahal udah verifikasi berbagai macam ajg lah,11,11,tidak bisa login ajg padahal sudah verifikasi berbagai macam ajg lah,11,11,"['tidak', 'bisa', 'login', 'ajg', 'padahal', 'sudah', 'verifikasi', 'berbagai', 'macam', 'ajg', 'lah']","['tidak', 'login', 'ajg', 'verifikasi', 'ajg']",11,5,6,tidak login ajg verifikasi ajg,5,5
"Simple, ringan dan bermanfaat,,",positif,2020-08-12,2020,simple ringan dan bermanfaat,4,4,simpel ringan dan bermanfaat,4,4,"['simpel', 'ringan', 'dan', 'bermanfaat']","['simpel', 'ringan', 'bermanfaat']",4,3,1,simpel ringan manfaat,3,3
Sangat bermanfaat dan mudah di gunakan,positif,2020-09-24,2020,sangat bermanfaat dan mudah di gunakan,6,6,sangat bermanfaat dan mudah di gunakan,6,6,"['sangat', 'bermanfaat', 'dan', 'mudah', 'di', 'gunakan']","['bermanfaat', 'mudah']",6,2,4,manfaat mudah,2,2
"Aplikasi yang sangat bagus, sangat membantu dalam mencari pekerjaan...",positif,2023-06-30,2023,aplikasi yang sangat bagus sangat membantu dalam mencari pekerjaan,9,9,aplikasi yang sangat bagus sangat membantu dalam mencari pekerjaan,9,9,"['aplikasi', 'yang', 'sangat', 'bagus', 'sangat', 'membantu', 'dalam', 'mencari', 'pekerjaan']","['aplikasi', 'bagus', 'membantu', 'mencari', 'pekerjaan']",9,5,4,aplikasi bagus bantu cari kerja,5,5
"Aplikasi ga jelas, masa nomor telpon ga bisa dipake semua di aplikasi ini",negatif,2023-12-01,2023,aplikasi ga jelas masa nomor telpon ga bisa dipake semua di aplikasi ini,13,13,aplikasi tidak jelas masa nomor telpon tidak bisa di pakai semua di aplikasi ini,13,14,"['aplikasi', 'tidak', 'jelas', 'masa', 'nomor', 'telpon', 'tidak', 'bisa', 'di', 'pakai', 'semua', 'di', 'aplikasi', 'ini']","['aplikasi', 'tidak', 'nomor', 'telpon', 'tidak', 'pakai', 'aplikasi']",14,7,7,aplikasi tidak nomor telpon tidak pakai aplikasi,7,7
Good 👍 harapan bisa dikembangkan utk mempermudah user 😁,positif,2022-05-27,2022,good harapan bisa dikembangkan utk mempermudah user,9,7,bagus harapan bisa dikembangkan untuk mempermudah user,7,7,"['bagus', 'harapan', 'bisa', 'dikembangkan', 'untuk', 'mempermudah', 'user']","['bagus', 'harapan', 'dikembangkan', 'mempermudah', 'user']",7,5,2,bagus harap kembang mudah user,5,5
Sangat bagus untuk yang nyari lowongan kerja,positif,2020-02-28,2020,sangat bagus untuk yang nyari lowongan kerja,7,7,sangat bagus untuk yang mencari lowongan kerja,7,7,"['sangat', 'bagus', 'untuk', 'yang', 'mencari', 'lowongan', 'kerja']","['bagus', 'mencari', 'lowongan', 'kerja']",7,4,3,bagus cari lowong kerja,4,4
Aplikasi yang bermanfaat untuk professional.,positif,2022-07-05,2022,aplikasi yang bermanfaat untuk professional,5,5,aplikasi yang bermanfaat untuk professional,5,5,"['aplikasi', 'yang', 'bermanfaat', 'untuk', 'professional']","['aplikasi', 'bermanfaat', 'professional']",5,3,2,aplikasi manfaat professional,3,3
Sangat membantu dalam proses pencarian kerja,positif,2020-10-21,2020,sangat membantu dalam proses pencarian kerja,6,6,sangat membantu dalam proses pencarian kerja,6,6,"['sangat', 'membantu', 'dalam', 'proses', 'pencarian', 'kerja']","['membantu', 'proses', 'pencarian', 'kerja']",6,4,2,bantu proses cari kerja,4,4
"Gak jelas nh aplikasi, udh benar pilih gambar,tapi tetap aja ngulang mulu verifikasi nya",negatif,2023-05-21,2023,gak jelas nh aplikasi udh benar pilih gambar tapi tetap aja ngulang mulu verifikasi nya,14,15,tidak jelas nih aplikasi sudah benar pilih gambar tapi tetap saja mengulang mulu verifikasi nya,15,15,"['tidak', 'jelas', 'nih', 'aplikasi', 'sudah', 'benar', 'pilih', 'gambar', 'tapi', 'tetap', 'saja', 'mengulang', 'mulu', 'verifikasi', 'nya']","['tidak', 'nih', 'aplikasi', 'pilih', 'gambar', 'mengulang', 'mulu', 'verifikasi', 'nya']",15,9,6,tidak nih aplikasi pilih gambar ulang mulu verifikasi nya,9,9
"Pelayanan sangat memuaskan, profesional",positif,2020-12-26,2020,pelayanan sangat memuaskan profesional,4,4,pelayanan sangat memuaskan profesional,4,4,"['pelayanan', 'sangat', 'memuaskan', 'profesional']","['pelayanan', 'memuaskan', 'profesional']",4,3,1,layan muas profesional,3,3
masih ada yang tipu2 buat lowongan 🙏 untung saya blm jd berangkat ke bali,negatif,2020-09-23,2020,masih ada yang tipu buat lowongan untung saya blm jd berangkat ke bali,14,13,masih ada yang tipu buat lowongan untung saya belum jadi berangkat ke bali,13,13,"['masih', 'ada', 'yang', 'tipu', 'buat', 'lowongan', 'untung', 'saya', 'belum', 'jadi', 'berangkat', 'ke', 'bali']","['tipu', 'lowongan', 'untung', 'berangkat', 'bali']",13,5,8,tipu lowong untung berangkat bal,5,5
Informasi dunia kerja dan berita umum sangat bagus,positif,2020-11-15,2020,informasi dunia kerja dan berita umum sangat bagus,8,8,informasi dunia kerja dan berita umum sangat bagus,8,8,"['informasi', 'dunia', 'kerja', 'dan', 'berita', 'umum', 'sangat', 'bagus']","['informasi', 'dunia', 'kerja', 'berita', 'bagus']",8,5,3,informasi dunia kerja berita bagus,5,5
Aplikasi bagus buat cari kerja di masa pandemi,positif,2020-08-14,2020,aplikasi bagus buat cari kerja di masa pandemi,8,8,aplikasi bagus buat cari kerja di masa pandemik,8,8,"['aplikasi', 'bagus', 'buat', 'cari', 'kerja', 'di', 'masa', 'pandemik']","['aplikasi', 'bagus', 'cari', 'kerja', 'pandemik']",8,5,3,aplikasi bagus cari kerja pandemik,5,5
Baguss dan sangt berguna untuk mencari pekerjaan,positif,2023-05-19,2023,baguss dan sangt berguna untuk mencari pekerjaan,7,7,bagus dan sangt berguna untuk mencari pekerjaan,7,7,"['bagus', 'dan', 'sangt', 'berguna', 'untuk', 'mencari', 'pekerjaan']","['bagus', 'sangt', 'berguna', 'mencari', 'pekerjaan']",7,5,2,bagus sangt guna cari kerja,5,5
Ini aplikasi kirim kode kok lama bener ya. Ini kalau mau daftar gimana 😔,negatif,2023-09-15,2023,ini aplikasi kirim kode kok lama bener ya ini kalau mau daftar gimana,14,13,ini aplikasi kirim kode kok lama benar ya ini kalau mau daftar bagaimana,13,13,"['ini', 'aplikasi', 'kirim', 'kode', 'kok', 'lama', 'benar', 'ya', 'ini', 'kalau', 'mau', 'daftar', 'bagaimana']","['aplikasi', 'kirim', 'kode', 'ya', 'daftar']",13,5,8,aplikasi kirim kode ya daftar,5,5
"Mohon perbaiki sistem verifikasi manusianya, sangat menyusahkan sekali",negatif,2024-02-06,2024,mohon perbaiki sistem verifikasi manusianya sangat menyusahkan sekali,8,8,mohon perbaikan sistem verifikasi manusianya sangat menyusahkan sekali,8,8,"['mohon', 'perbaikan', 'sistem', 'verifikasi', 'manusianya', 'sangat', 'menyusahkan', 'sekali']","['mohon', 'perbaikan', 'sistem', 'verifikasi', 'manusianya', 'menyusahkan']",8,6,2,mohon baik sistem verifikasi manusia susah,6,6
"Aplikasi yang bermanfaat, menjalin hubungan proffesional bagus disini",positif,2023-11-03,2023,aplikasi yang bermanfaat menjalin hubungan proffesional bagus disini,8,8,aplikasi yang bermanfaat menjalin hubungan proffesional bagus disini,8,8,"['aplikasi', 'yang', 'bermanfaat', 'menjalin', 'hubungan', 'proffesional', 'bagus', 'disini']","['aplikasi', 'bermanfaat', 'menjalin', 'hubungan', 'proffesional', 'bagus']",8,6,2,aplikasi manfaat jalin hubung proffesional bagus,6,6
Sangat bagus dan membantu mendapat peluang berkarir,positif,2022-07-28,2022,sangat bagus dan membantu mendapat peluang berkarir,7,7,sangat bagus dan membantu mendapat peluang berkarir,7,7,"['sangat', 'bagus', 'dan', 'membantu', 'mendapat', 'peluang', 'berkarir']","['bagus', 'membantu', 'peluang', 'berkarir']",7,4,3,bagus bantu peluang berkarir,4,4
Kenpa susah dptari pakaiy akun... Sudah berulang kali gagal trus masuk di alikasi ini... Apa ada yg bisa mmbntu,negatif,2020-03-10,2020,kenpa susah dptari pakaiy akun sudah berulang kali gagal trus masuk di alikasi ini apa ada yg bisa mmbntu,19,19,kenpa susah dptari pakaiy akun sudah berulang kali gagal terus masuk di alikasi ini apa ada yang bisa mmbntu,19,19,"['kenpa', 'susah', 'dptari', 'pakaiy', 'akun', 'sudah', 'berulang', 'kali', 'gagal', 'terus', 'masuk', 'di', 'alikasi', 'ini', 'apa', 'ada', 'yang', 'bisa', 'mmbntu']","['kenpa', 'susah', 'dptari', 'pakaiy', 'akun', 'berulang', 'kali', 'gagal', 'masuk', 'alikasi', 'mmbntu']",19,11,8,kenpa susah dptari pakaiy akun ulang kali gagal masuk alikasi mmbntu,11,11
Bagus karena membantu mencari kerja yg sesuai harapan!!!,positif,2021-04-19,2021,bagus karena membantu mencari kerja yg sesuai harapan,8,8,bagus karena membantu mencari kerja yang sesuai harapan,8,8,"['bagus', 'karena', 'membantu', 'mencari', 'kerja', 'yang', 'sesuai', 'harapan']","['bagus', 'membantu', 'mencari', 'kerja', 'sesuai', 'harapan']",8,6,2,bagus bantu cari kerja sesuai harap,6,6
"sangat membantu dalam mencari pekerjaan, tidak lagi mencari kepastian di forum forum yang kejelesanya masi di ragukan",positif,2022-08-01,2022,sangat membantu dalam mencari pekerjaan tidak lagi mencari kepastian di forum forum yang kejelesanya masi di ragukan,17,17,sangat membantu dalam mencari pekerjaan tidak lagi mencari kepastian di forum forum yang kejelesanya masih di ragukan,17,17,"['sangat', 'membantu', 'dalam', 'mencari', 'pekerjaan', 'tidak', 'lagi', 'mencari', 'kepastian', 'di', 'forum', 'forum', 'yang', 'kejelesanya', 'masih', 'di', 'ragukan']","['membantu', 'mencari', 'pekerjaan', 'tidak', 'mencari', 'kepastian', 'forum', 'forum', 'kejelesanya', 'ragukan']",17,10,7,bantu cari kerja tidak cari pasti forum forum kejelesanya ragu,10,10
Ada masalah di verifikasi nya ya tolong di perbaiki segera:),negatif,2023-05-06,2023,ada masalah di verifikasi nya ya tolong di perbaiki segera,10,10,ada masalah di verifikasi nya ya tolong di perbaikan segera,10,10,"['ada', 'masalah', 'di', 'verifikasi', 'nya', 'ya', 'tolong', 'di', 'perbaikan', 'segera']","['verifikasi', 'nya', 'ya', 'tolong', 'perbaikan']",10,5,5,verifikasi nya ya tolong baik,5,5
Membantu dalam menyajikan pasaran dan lowongan kerja,positif,2022-01-31,2022,membantu dalam menyajikan pasaran dan lowongan kerja,7,7,membantu dalam menyajikan pasaran dan lowongan kerja,7,7,"['membantu', 'dalam', 'menyajikan', 'pasaran', 'dan', 'lowongan', 'kerja']","['membantu', 'menyajikan', 'pasaran', 'lowongan', 'kerja']",7,5,2,bantu saji pasar lowong kerja,5,5
Sangat membantu untuk menambah wawasan,positif,2021-04-14,2021,sangat membantu untuk menambah wawasan,5,5,sangat membantu untuk menambah wawasan,5,5,"['sangat', 'membantu', 'untuk', 'menambah', 'wawasan']","['membantu', 'menambah', 'wawasan']",5,3,2,bantu tambah wawas,3,3
Haduuhh capek banget verifikasi captcha invalid mulu ngulang2 gk bisa masuk ini🤦,negatif,2024-02-29,2024,haduuhh capek banget verifikasi captcha invalid mulu ngulang gk bisa masuk ini,12,12,haduuhh capek banget verifikasi captcha invalid mulu mengulang tidak bisa masuk ini,12,12,"['haduuhh', 'capek', 'banget', 'verifikasi', 'captcha', 'invalid', 'mulu', 'mengulang', 'tidak', 'bisa', 'masuk', 'ini']","['haduuhh', 'capek', 'banget', 'verifikasi', 'captcha', 'invalid', 'mulu', 'mengulang', 'tidak', 'masuk']",12,10,2,haduuhh capek banget verifikasi captcha invalid mulu ulang tidak masuk,10,10
Aplikasi nya bagus utk belajar dan menambah relasi,positif,2021-02-07,2021,aplikasi nya bagus utk belajar dan menambah relasi,8,8,aplikasi nya bagus untuk belajar dan menambah relasi,8,8,"['aplikasi', 'nya', 'bagus', 'untuk', 'belajar', 'dan', 'menambah', 'relasi']","['aplikasi', 'nya', 'bagus', 'belajar', 'menambah', 'relasi']",8,6,2,aplikasi nya bagus ajar tambah relasi,6,6
"Ga bisa login, ga jelas, aplikasi aneh, t*l*l",negatif,2023-10-01,2023,ga bisa login ga jelas aplikasi aneh t l l,8,10,tidak bisa login tidak jelas aplikasi aneh t l l,10,10,"['tidak', 'bisa', 'login', 'tidak', 'jelas', 'aplikasi', 'aneh', 't', 'l', 'l']","['tidak', 'login', 'tidak', 'aplikasi', 'aneh', 't', 'l', 'l']",10,8,2,tidak login tidak aplikasi aneh t l l,8,8
Wawasan informasi job makin tambah lebih baik kedepannya,positif,2022-05-06,2022,wawasan informasi job makin tambah lebih baik kedepannya,8,8,wawasan informasi kerja makin tambah lebih baik kedepannya,8,8,"['wawasan', 'informasi', 'kerja', 'makin', 'tambah', 'lebih', 'baik', 'kedepannya']","['wawasan', 'informasi', 'kerja', 'kedepannya']",8,4,4,wawas informasi kerja depan,4,4
ini gimana siii gk bisa log in.. verifikasi salah terus..,negatif,2024-02-19,2024,ini gimana siii gk bisa log in verifikasi salah terus,10,10,ini bagaimana siii tidak bisa log in verifikasi salah terus,10,10,"['ini', 'bagaimana', 'siii', 'tidak', 'bisa', 'log', 'in', 'verifikasi', 'salah', 'terus']","['siii', 'tidak', 'log', 'in', 'verifikasi', 'salah']",10,6,4,siii tidak log in verifikasi salah,6,6
Verifikasi berkali-kali tidak bisa login,negatif,2024-01-26,2024,verifikasi berkali kali tidak bisa login,5,6,verifikasi berkali kali tidak bisa login,6,6,"['verifikasi', 'berkali', 'kali', 'tidak', 'bisa', 'login']","['verifikasi', 'berkali', 'kali', 'tidak', 'login']",6,5,1,verifikasi kali kali tidak login,5,5
"Tes dulu, dev. Kalo bagus tambah in bintangnya jadi 7*",positif,2024-01-31,2024,tes dulu dev kalo bagus tambah in bintangnya jadi,10,9,tes dahulu dev kalau bagus tambah in bintangnya jadi,9,9,"['tes', 'dahulu', 'dev', 'kalau', 'bagus', 'tambah', 'in', 'bintangnya', 'jadi']","['tes', 'dev', 'bagus', 'in', 'bintangnya']",9,5,4,tes dev bagus in bintang,5,5
Sangat membantu mencari informasi dan jaringan,positif,2020-09-09,2020,sangat membantu mencari informasi dan jaringan,6,6,sangat membantu mencari informasi dan jaringan,6,6,"['sangat', 'membantu', 'mencari', 'informasi', 'dan', 'jaringan']","['membantu', 'mencari', 'informasi', 'jaringan']",6,4,2,bantu cari informasi jaring,4,4
"Setiap verifikasi login selalu dikasih notifikasi "" respon kode noCAPTCHA anda tidak valid atau belum diisi""",negatif,2024-03-03,2024,setiap verifikasi login selalu dikasih notifikasi respon kode nocaptcha anda tidak valid atau belum diisi,16,15,setiap verifikasi login selalu dikasih notifikasi respons kode nocaptcha anda tidak valid atau belum diisi,15,15,"['setiap', 'verifikasi', 'login', 'selalu', 'dikasih', 'notifikasi', 'respons', 'kode', 'nocaptcha', 'anda', 'tidak', 'valid', 'atau', 'belum', 'diisi']","['verifikasi', 'login', 'dikasih', 'notifikasi', 'respons', 'kode', 'nocaptcha', 'tidak', 'valid', 'diisi']",15,10,5,verifikasi login kasih notifikasi respons kode nocaptcha tidak valid isi,10,10
Aplikasi yang bagus untuk pencari kerja. 👍👍👍,positif,2020-02-10,2020,aplikasi yang bagus untuk pencari kerja,7,6,aplikasi yang bagus untuk pencari kerja,6,6,"['aplikasi', 'yang', 'bagus', 'untuk', 'pencari', 'kerja']","['aplikasi', 'bagus', 'pencari', 'kerja']",6,4,2,aplikasi bagus cari kerja,4,4
baguss tapi masih perlu beberpa peningkatan,positif,2022-04-16,2022,baguss tapi masih perlu beberpa peningkatan,6,6,bagus tapi masih perlu beberpa peningkatan,6,6,"['bagus', 'tapi', 'masih', 'perlu', 'beberpa', 'peningkatan']","['bagus', 'beberpa', 'peningkatan']",6,3,3,bagus beberpa tingkat,3,3
Sangat bagus untuk menjalin kerja sama dg rekanan,positif,2020-01-05,2020,sangat bagus untuk menjalin kerja sama dg rekanan,8,8,sangat bagus untuk menjalin kerja sama dengan rekanan,8,8,"['sangat', 'bagus', 'untuk', 'menjalin', 'kerja', 'sama', 'dengan', 'rekanan']","['bagus', 'menjalin', 'kerja', 'rekanan']",8,4,4,bagus jalin kerja rekan,4,4
"Gk bsa ngpa""in .login gk bsa dftr bru gk bsa juga",negatif,2023-12-22,2023,gk bsa ngpa in login gk bsa dftr bru gk bsa juga,11,12,tidak bisa ngpa in login tidak bisa dftr baru tidak bisa juga,12,12,"['tidak', 'bisa', 'ngpa', 'in', 'login', 'tidak', 'bisa', 'dftr', 'baru', 'tidak', 'bisa', 'juga']","['tidak', 'ngpa', 'in', 'login', 'tidak', 'dftr', 'tidak']",12,7,5,tidak ngpa in login tidak dftr tidak,7,7
"Gajelas aplikasinya, keamanan terus ga bisa masukk, yg mau install dri pda marah2 mending jangan",negatif,2022-11-08,2022,gajelas aplikasinya keamanan terus ga bisa masukk yg mau install dri pda marah mending jangan,15,15,tidak jelas aplikasi nya keamanan terus tidak bisa masukk yang mau install dari pda marah mending jangan,15,17,"['tidak', 'jelas', 'aplikasi', 'nya', 'keamanan', 'terus', 'tidak', 'bisa', 'masukk', 'yang', 'mau', 'install', 'dari', 'pda', 'marah', 'mending', 'jangan']","['tidak', 'aplikasi', 'nya', 'keamanan', 'tidak', 'masukk', 'install', 'pda', 'marah', 'mending']",17,10,7,tidak aplikasi nya aman tidak masukk install pda marah mending,10,10
Kualitas ok untuk loker dan valid,positif,2023-01-28,2023,kualitas ok untuk loker dan valid,6,6,kualitas oke untuk loker dan valid,6,6,"['kualitas', 'oke', 'untuk', 'loker', 'dan', 'valid']","['kualitas', 'oke', 'loker', 'valid']",6,4,2,kualitas oke loker valid,4,4
Lebih berpengalaman dalam menjalin informasi yang menarik dari pembisnis...bila perlu informasi modal bisnis....,positif,2020-09-01,2020,lebih berpengalaman dalam menjalin informasi yang menarik dari pembisnis bila perlu informasi modal bisnis,13,14,lebih berpengalaman dalam menjalin informasi yang menarik dari pembisnis bila perlu informasi modal bisnis,14,14,"['lebih', 'berpengalaman', 'dalam', 'menjalin', 'informasi', 'yang', 'menarik', 'dari', 'pembisnis', 'bila', 'perlu', 'informasi', 'modal', 'bisnis']","['berpengalaman', 'menjalin', 'informasi', 'menarik', 'pembisnis', 'informasi', 'modal', 'bisnis']",14,8,6,alam jalin informasi tarik bisnis informasi modal bisnis,8,8
"Tidak bisa login, login selalu error",negatif,2023-06-22,2023,tidak bisa login login selalu error,6,6,tidak bisa login login selalu error,6,6,"['tidak', 'bisa', 'login', 'login', 'selalu', 'error']","['tidak', 'login', 'login', 'error']",6,4,2,tidak login login error,4,4
"Verifikasi ketika ingin masuk selalu GAGAL, ini menyebalkan.",negatif,2023-12-18,2023,verifikasi ketika ingin masuk selalu gagal ini menyebalkan,8,8,verifikasi ketika ingin masuk selalu gagal ini menyebalkan,8,8,"['verifikasi', 'ketika', 'ingin', 'masuk', 'selalu', 'gagal', 'ini', 'menyebalkan']","['verifikasi', 'masuk', 'gagal', 'menyebalkan']",8,4,4,verifikasi masuk gagal sebal,4,4
"""Respon kode noCAPTCHA Anda tidak valid atau belum diisi"" Padahal saya sudah mengisi dengan benar",negatif,2023-08-02,2023,respon kode nocaptcha anda tidak valid atau belum diisi padahal saya sudah mengisi dengan benar,15,15,respons kode nocaptcha anda tidak valid atau belum diisi padahal saya sudah mengisi dengan benar,15,15,"['respons', 'kode', 'nocaptcha', 'anda', 'tidak', 'valid', 'atau', 'belum', 'diisi', 'padahal', 'saya', 'sudah', 'mengisi', 'dengan', 'benar']","['respons', 'kode', 'nocaptcha', 'tidak', 'valid', 'diisi', 'mengisi']",15,7,8,respons kode nocaptcha tidak valid isi isi,7,7
"Kok gabisa download ya, gagal terus. Ada yang tau solusinya gmn ga?",negatif,2022-05-16,2022,kok gabisa download ya gagal terus ada yang tau solusinya gmn ga,12,12,kok tidak bisa unduh ya gagal terus ada yang tahu solusinya bagaimana tidak,12,13,"['kok', 'tidak', 'bisa', 'unduh', 'ya', 'gagal', 'terus', 'ada', 'yang', 'tahu', 'solusinya', 'bagaimana', 'tidak']","['tidak', 'unduh', 'ya', 'gagal', 'solusinya', 'tidak']",13,6,7,tidak unduh ya gagal solusi tidak,6,6
Verifikasi gagal terus tidak bisa masuk,negatif,2023-08-02,2023,verifikasi gagal terus tidak bisa masuk,6,6,verifikasi gagal terus tidak bisa masuk,6,6,"['verifikasi', 'gagal', 'terus', 'tidak', 'bisa', 'masuk']","['verifikasi', 'gagal', 'tidak', 'masuk']",6,4,2,verifikasi gagal tidak masuk,4,4
Aplikasi bagus untuk menunjang profesionalitas profesi,positif,2021-08-12,2021,aplikasi bagus untuk menunjang profesionalitas profesi,6,6,aplikasi bagus untuk menunjang profesionalitas profesi,6,6,"['aplikasi', 'bagus', 'untuk', 'menunjang', 'profesionalitas', 'profesi']","['aplikasi', 'bagus', 'menunjang', 'profesionalitas', 'profesi']",6,5,1,aplikasi bagus tunjang profesionalitas profesi,5,5
Susah sekali masuknya.kayak kita nyuri aja.Bintang 1 pun ga layak.kesal,negatif,2022-09-19,2022,susah sekali masuknya kayak kita nyuri aja bintang pun ga layak kesal,10,12,susah sekali masuknya kayak kita nyuri saja bintang pun tidak layak kesal,12,12,"['susah', 'sekali', 'masuknya', 'kayak', 'kita', 'nyuri', 'saja', 'bintang', 'pun', 'tidak', 'layak', 'kesal']","['susah', 'masuknya', 'kayak', 'nyuri', 'bintang', 'tidak', 'layak', 'kesal']",12,8,4,susah masuk kayak nyuri bintang tidak layak kesal,8,8
"Aplikasi ini membantu saya berinteraksi dengan calon atasan saya, dan membantu saya untuk mendaptkan pekerjaan",positif,2023-10-02,2023,aplikasi ini membantu saya berinteraksi dengan calon atasan saya dan membantu saya untuk mendaptkan pekerjaan,15,15,aplikasi ini membantu saya berinteraksi dengan calon atasan saya dan membantu saya untuk mendaptkan pekerjaan,15,15,"['aplikasi', 'ini', 'membantu', 'saya', 'berinteraksi', 'dengan', 'calon', 'atasan', 'saya', 'dan', 'membantu', 'saya', 'untuk', 'mendaptkan', 'pekerjaan']","['aplikasi', 'membantu', 'berinteraksi', 'calon', 'atasan', 'membantu', 'mendaptkan', 'pekerjaan']",15,8,7,aplikasi bantu interaksi calon atas bantu mendaptkan kerja,8,8
Sangat membantu saat ingin mencari informasi kerja,positif,2020-08-30,2020,sangat membantu saat ingin mencari informasi kerja,7,7,sangat membantu saat ingin mencari informasi kerja,7,7,"['sangat', 'membantu', 'saat', 'ingin', 'mencari', 'informasi', 'kerja']","['membantu', 'mencari', 'informasi', 'kerja']",7,4,3,bantu cari informasi kerja,4,4
"Gila terfokus bahasa inggris, nggak ada filter bahasa begara sendiri...",negatif,2022-05-23,2022,gila terfokus bahasa inggris nggak ada filter bahasa begara sendiri,10,10,gila terfokus bahasa inggris tidak ada filter bahasa begara sendiri,10,10,"['gila', 'terfokus', 'bahasa', 'inggris', 'tidak', 'ada', 'filter', 'bahasa', 'begara', 'sendiri']","['gila', 'terfokus', 'bahasa', 'inggris', 'tidak', 'filter', 'bahasa', 'begara']",10,8,2,gila fokus bahasa inggris tidak filter bahasa begara,8,8
Sangat bermanfaat dan mudah dipelajari,positif,2021-09-02,2021,sangat bermanfaat dan mudah dipelajari,5,5,sangat bermanfaat dan mudah dipelajari,5,5,"['sangat', 'bermanfaat', 'dan', 'mudah', 'dipelajari']","['bermanfaat', 'mudah', 'dipelajari']",5,3,2,manfaat mudah ajar,3,3
Aplikasi yang sangat bagus buat pencari kerja,positif,2021-10-02,2021,aplikasi yang sangat bagus buat pencari kerja,7,7,aplikasi yang sangat bagus buat pencari kerja,7,7,"['aplikasi', 'yang', 'sangat', 'bagus', 'buat', 'pencari', 'kerja']","['aplikasi', 'bagus', 'pencari', 'kerja']",7,4,3,aplikasi bagus cari kerja,4,4
Hubungan kerja simpel dan praktis,positif,2021-09-27,2021,hubungan kerja simpel dan praktis,5,5,hubungan kerja simpel dan praktis,5,5,"['hubungan', 'kerja', 'simpel', 'dan', 'praktis']","['hubungan', 'kerja', 'simpel', 'praktis']",5,4,1,hubung kerja simpel praktis,4,4
Apk@ Sangat Membantu Para Generasi Muda Yang Belum Ada Pekerjaan...,positif,2023-09-07,2023,apk sangat membantu para generasi muda yang belum ada pekerjaan,10,10,aplikasi sangat membantu para generasi muda yang belum ada pekerjaan,10,10,"['aplikasi', 'sangat', 'membantu', 'para', 'generasi', 'muda', 'yang', 'belum', 'ada', 'pekerjaan']","['aplikasi', 'membantu', 'generasi', 'muda', 'pekerjaan']",10,5,5,aplikasi bantu generasi muda kerja,5,5
Aplikasi sekarang susah login makin kacau jelek very bad,negatif,2024-02-20,2024,aplikasi sekarang susah login makin kacau jelek very bad,9,9,aplikasi sekarang susah login makin kacau jelek sangat bad,9,9,"['aplikasi', 'sekarang', 'susah', 'login', 'makin', 'kacau', 'jelek', 'sangat', 'bad']","['aplikasi', 'susah', 'login', 'kacau', 'jelek', 'bad']",9,6,3,aplikasi susah login kacau jelek bad,6,6
"Aplikasi jelek, pas dibuka cuma layar putih aja",negatif,2022-01-02,2022,aplikasi jelek pas dibuka cuma layar putih aja,8,8,aplikasi jelek pas dibuka cuma layar putih saja,8,8,"['aplikasi', 'jelek', 'pas', 'dibuka', 'cuma', 'layar', 'putih', 'saja']","['aplikasi', 'jelek', 'pas', 'dibuka', 'layar', 'putih']",8,6,2,aplikasi jelek pas buka layar putih,6,6
"Ga jelas aplikasinya, padahal saya ga ngapa² in tiba² direstricted :(",negatif,2023-07-26,2023,ga jelas aplikasinya padahal saya ga ngapa² in tiba² direstricted,11,10,tidak jelas aplikasi nya padahal saya tidak ngapa² in tiba² direstricted,10,11,"['tidak', 'jelas', 'aplikasi', 'nya', 'padahal', 'saya', 'tidak', 'ngapa²', 'in', 'tiba²', 'direstricted']","['tidak', 'aplikasi', 'nya', 'tidak', 'ngapa²', 'in', 'tiba²', 'direstricted']",11,8,3,tidak aplikasi nya tidak ngapa in tiba direstricted,8,8
"Orang mau nyari kerja, bukan malah nambah kerjaan, lama kali proses pencariannya",negatif,2024-02-28,2024,orang mau nyari kerja bukan malah nambah kerjaan lama kali proses pencariannya,12,12,orang mau mencari kerja bukan bahkan nambah kerjaan lama kali proses pencariannya,12,12,"['orang', 'mau', 'mencari', 'kerja', 'bukan', 'bahkan', 'nambah', 'kerjaan', 'lama', 'kali', 'proses', 'pencariannya']","['orang', 'mencari', 'kerja', 'nambah', 'kerjaan', 'kali', 'proses', 'pencariannya']",12,8,4,orang cari kerja nambah kerja kali proses cari,8,8
"Ga verifikasi gambar, ga suara sama-sama gabisa, ini gw yg salah atau gmn ya?",negatif,2023-07-28,2023,ga verifikasi gambar ga suara sama sama gabisa ini gw yg salah atau gmn ya,14,15,tidak verifikasi gambar tidak suara sama sama tidak bisa ini saya yang salah atau bagaimana ya,15,16,"['tidak', 'verifikasi', 'gambar', 'tidak', 'suara', 'sama', 'sama', 'tidak', 'bisa', 'ini', 'saya', 'yang', 'salah', 'atau', 'bagaimana', 'ya']","['tidak', 'verifikasi', 'gambar', 'tidak', 'suara', 'tidak', 'salah', 'ya']",16,8,8,tidak verifikasi gambar tidak suara tidak salah ya,8,8
Sangat membantu saya dalam menjalin relasi dan pekerjaan,positif,2024-02-06,2024,sangat membantu saya dalam menjalin relasi dan pekerjaan,8,8,sangat membantu saya dalam menjalin relasi dan pekerjaan,8,8,"['sangat', 'membantu', 'saya', 'dalam', 'menjalin', 'relasi', 'dan', 'pekerjaan']","['membantu', 'menjalin', 'relasi', 'pekerjaan']",8,4,4,bantu jalin relasi kerja,4,4
"Sangat tidak aman, akun saya tiba2 tidak bisa diakses, dihack orang",negatif,2023-10-07,2023,sangat tidak aman akun saya tiba tidak bisa diakses dihack orang,11,11,sangat tidak aman akun saya tiba tidak bisa diakses dihack orang,11,11,"['sangat', 'tidak', 'aman', 'akun', 'saya', 'tiba', 'tidak', 'bisa', 'diakses', 'dihack', 'orang']","['tidak', 'aman', 'akun', 'tidak', 'diakses', 'dihack', 'orang']",11,7,4,tidak aman akun tidak akses dihack orang,7,7
Memberikan informasi lowongan kerja terupdate dan dipercaya.,positif,2022-05-09,2022,memberikan informasi lowongan kerja terupdate dan dipercaya,7,7,memberikan informasi lowongan kerja terupdate dan dipercaya,7,7,"['memberikan', 'informasi', 'lowongan', 'kerja', 'terupdate', 'dan', 'dipercaya']","['informasi', 'lowongan', 'kerja', 'terupdate', 'dipercaya']",7,5,2,informasi lowong kerja terupdate percaya,5,5
"Suka sekali, karena bisa liat lowongan pekerjaan",positif,2021-03-17,2021,suka sekali karena bisa liat lowongan pekerjaan,7,7,suka sekali karena bisa lihat lowongan pekerjaan,7,7,"['suka', 'sekali', 'karena', 'bisa', 'lihat', 'lowongan', 'pekerjaan']","['suka', 'lihat', 'lowongan', 'pekerjaan']",7,4,3,suka lihat lowong kerja,4,4
Mau daftar tapi tidak bisa masuk eror terus gimana,negatif,2023-09-11,2023,mau daftar tapi tidak bisa masuk eror terus gimana,9,9,mau daftar tapi tidak bisa masuk error terus bagaimana,9,9,"['mau', 'daftar', 'tapi', 'tidak', 'bisa', 'masuk', 'error', 'terus', 'bagaimana']","['daftar', 'tidak', 'masuk', 'error']",9,4,5,daftar tidak masuk error,4,4
"Saya sudah login pake fb ,email ,trus 3 kali tapi selalu pakai teka teki gak masuk² capek",negatif,2024-02-19,2024,saya sudah login pake fb email trus kali tapi selalu pakai teka teki gak masuk² capek,17,16,saya sudah login pakai fb email terus kali tapi selalu pakai teka teki tidak masuk² capek,16,16,"['saya', 'sudah', 'login', 'pakai', 'fb', 'email', 'terus', 'kali', 'tapi', 'selalu', 'pakai', 'teka', 'teki', 'tidak', 'masuk²', 'capek']","['login', 'pakai', 'fb', 'email', 'kali', 'pakai', 'teka', 'teki', 'tidak', 'masuk²', 'capek']",16,11,5,login pakai fb email kali pakai teka teki tidak masuk capek,11,11
Sangat berguna untuk mencari lowongan,positif,2021-02-23,2021,sangat berguna untuk mencari lowongan,5,5,sangat berguna untuk mencari lowongan,5,5,"['sangat', 'berguna', 'untuk', 'mencari', 'lowongan']","['berguna', 'mencari', 'lowongan']",5,3,2,guna cari lowong,3,3
"Bagus sekali app linkedIn, lebih bagus lagi referensi lowker ya diperbanyak",positif,2022-03-30,2022,bagus sekali app linkedin lebih bagus lagi referensi lowker ya diperbanyak,11,11,bagus sekali aplikasi linkedin lebih bagus lagi referensi lowker ya diperbanyak,11,11,"['bagus', 'sekali', 'aplikasi', 'linkedin', 'lebih', 'bagus', 'lagi', 'referensi', 'lowker', 'ya', 'diperbanyak']","['bagus', 'aplikasi', 'linkedin', 'bagus', 'referensi', 'lowker', 'ya', 'diperbanyak']",11,8,3,bagus aplikasi linkedin bagus referensi lowker ya banyak,8,8
Aplikasi bagus untuk dunia kerja menambah koneksi,positif,2022-06-13,2022,aplikasi bagus untuk dunia kerja menambah koneksi,7,7,aplikasi bagus untuk dunia kerja menambah koneksi,7,7,"['aplikasi', 'bagus', 'untuk', 'dunia', 'kerja', 'menambah', 'koneksi']","['aplikasi', 'bagus', 'dunia', 'kerja', 'menambah', 'koneksi']",7,6,1,aplikasi bagus dunia kerja tambah koneksi,6,6
Aplikasi yang bermanfaat untuk mencari pekerjaan.,positif,2023-05-10,2023,aplikasi yang bermanfaat untuk mencari pekerjaan,6,6,aplikasi yang bermanfaat untuk mencari pekerjaan,6,6,"['aplikasi', 'yang', 'bermanfaat', 'untuk', 'mencari', 'pekerjaan']","['aplikasi', 'bermanfaat', 'mencari', 'pekerjaan']",6,4,2,aplikasi manfaat cari kerja,4,4
"sangat bagus,cukup menbantu juga saya mudah memahami🙂",positif,2023-07-05,2023,sangat bagus cukup menbantu juga saya mudah memahami,7,8,sangat bagus cukup menbantu juga saya mudah memahami,8,8,"['sangat', 'bagus', 'cukup', 'menbantu', 'juga', 'saya', 'mudah', 'memahami']","['bagus', 'menbantu', 'mudah', 'memahami']",8,4,4,bagus menbantu mudah paham,4,4
Sangat membantu unt mendapatkan informasi Ter update...,positif,2023-08-10,2023,sangat membantu unt mendapatkan informasi ter update,7,7,sangat membantu unt mendapatkan informasi ter diperbarui,7,7,"['sangat', 'membantu', 'unt', 'mendapatkan', 'informasi', 'ter', 'diperbarui']","['membantu', 'unt', 'informasi', 'ter', 'diperbarui']",7,5,2,bantu unt informasi ter baru,5,5
Cukup bagus sangat membantu dalam mencari info job,positif,2020-11-12,2020,cukup bagus sangat membantu dalam mencari info job,8,8,cukup bagus sangat membantu dalam mencari informasi kerja,8,8,"['cukup', 'bagus', 'sangat', 'membantu', 'dalam', 'mencari', 'informasi', 'kerja']","['bagus', 'membantu', 'mencari', 'informasi', 'kerja']",8,5,3,bagus bantu cari informasi kerja,5,5
Suka dengan LinkedIn untuk komunikasi dengan teman dan sharing pekerjaan sesuai kualifikasi,positif,2022-06-03,2022,suka dengan linkedin untuk komunikasi dengan teman dan sharing pekerjaan sesuai kualifikasi,12,12,suka dengan linkedin untuk komunikasi dengan teman dan sharing pekerjaan sesuai kualifikasi,12,12,"['suka', 'dengan', 'linkedin', 'untuk', 'komunikasi', 'dengan', 'teman', 'dan', 'sharing', 'pekerjaan', 'sesuai', 'kualifikasi']","['suka', 'linkedin', 'komunikasi', 'teman', 'sharing', 'pekerjaan', 'sesuai', 'kualifikasi']",12,8,4,suka linkedin komunikasi teman sharing kerja sesuai kualifikasi,8,8
"Semakin detail, mencakup bidang-bidang pekerjaan dan aktivitas ekonomi, terkoneksi dengan platform lain",positif,2023-08-06,2023,semakin detail mencakup bidang bidang pekerjaan dan aktivitas ekonomi terkoneksi dengan platform lain,12,13,semakin detail mencakup bidang bidang pekerjaan dan aktivitas ekonomi terkoneksi dengan platform lain,13,13,"['semakin', 'detail', 'mencakup', 'bidang', 'bidang', 'pekerjaan', 'dan', 'aktivitas', 'ekonomi', 'terkoneksi', 'dengan', 'platform', 'lain']","['detail', 'mencakup', 'bidang', 'bidang', 'pekerjaan', 'aktivitas', 'ekonomi', 'terkoneksi', 'platform']",13,9,4,detail cakup bidang bidang kerja aktivitas ekonomi koneksi platform,9,9
"buruk, berkali2 minta verifikasi gambar, sudh benar tp tetap dinilai salah",negatif,2023-08-02,2023,buruk berkali minta verifikasi gambar sudh benar tp tetap dinilai salah,11,11,buruk berkali minta verifikasi gambar sudh benar tapi tetap dinilai salah,11,11,"['buruk', 'berkali', 'minta', 'verifikasi', 'gambar', 'sudh', 'benar', 'tapi', 'tetap', 'dinilai', 'salah']","['buruk', 'berkali', 'verifikasi', 'gambar', 'sudh', 'dinilai', 'salah']",11,7,4,buruk kali verifikasi gambar sudh nilai salah,7,7
Bug ada pada notifikasi,negatif,2024-02-19,2024,bug ada pada notifikasi,4,4,bug ada pada notifikasi,4,4,"['bug', 'ada', 'pada', 'notifikasi']","['bug', 'notifikasi']",4,2,2,bug notifikasi,2,2
"Tidak bisa login di hp android, verifikasi looping",negatif,2023-11-26,2023,tidak bisa login di hp android verifikasi looping,8,8,tidak bisa login di handphone android verifikasi looping,8,8,"['tidak', 'bisa', 'login', 'di', 'handphone', 'android', 'verifikasi', 'looping']","['tidak', 'login', 'handphone', 'android', 'verifikasi', 'looping']",8,6,2,tidak login handphone android verifikasi looping,6,6
"Terima kasih,sangat membantu sekali dan semoga langgeng dan memberi informasi lebih bagus",positif,2023-11-17,2023,terima kasih sangat membantu sekali dan semoga langgeng dan memberi informasi lebih bagus,12,13,terima kasih sangat membantu sekali dan semoga langgeng dan memberi informasi lebih bagus,13,13,"['terima', 'kasih', 'sangat', 'membantu', 'sekali', 'dan', 'semoga', 'langgeng', 'dan', 'memberi', 'informasi', 'lebih', 'bagus']","['terima', 'kasih', 'membantu', 'semoga', 'langgeng', 'informasi', 'bagus']",13,7,6,terima kasih bantu moga langgeng informasi bagus,7,7
Dasbor sering lag... Atau ngeblank...,negatif,2023-11-30,2023,dasbor sering lag atau ngeblank,5,5,dasbor sering lagi atau ngeblank,5,5,"['dasbor', 'sering', 'lagi', 'atau', 'ngeblank']","['dasbor', 'ngeblank']",5,2,3,dasbor ngeblank,2,2
Sangat berguna untk pencari kerja,positif,2020-07-26,2020,sangat berguna untk pencari kerja,5,5,sangat berguna untuk pencari kerja,5,5,"['sangat', 'berguna', 'untuk', 'pencari', 'kerja']","['berguna', 'pencari', 'kerja']",5,3,2,guna cari kerja,3,3
"Bagus, dan bermanfaat buat profesional",positif,2021-02-21,2021,bagus dan bermanfaat buat profesional,5,5,bagus dan bermanfaat buat profesional,5,5,"['bagus', 'dan', 'bermanfaat', 'buat', 'profesional']","['bagus', 'bermanfaat', 'profesional']",5,3,2,bagus manfaat profesional,3,3
ga jelas suruh verifikasi mulu padahal dah bener veeifikasinya tapi tulisan nya eror mulu,negatif,2023-09-14,2023,ga jelas suruh verifikasi mulu padahal dah bener veeifikasinya tapi tulisan nya eror mulu,14,14,tidak jelas suruh verifikasi mulu padahal sudah benar veeifikasinya tapi tulisan nya error mulu,14,14,"['tidak', 'jelas', 'suruh', 'verifikasi', 'mulu', 'padahal', 'sudah', 'benar', 'veeifikasinya', 'tapi', 'tulisan', 'nya', 'error', 'mulu']","['tidak', 'suruh', 'verifikasi', 'mulu', 'veeifikasinya', 'tulisan', 'nya', 'error', 'mulu']",14,9,5,tidak suruh verifikasi mulu veeifikasinya tulis nya error mulu,9,9
Sangat terbantu untuk terhubung dengan cepat,positif,2020-07-15,2020,sangat terbantu untuk terhubung dengan cepat,6,6,sangat membantu untuk terhubung dengan cepat,6,6,"['sangat', 'membantu', 'untuk', 'terhubung', 'dengan', 'cepat']","['membantu', 'terhubung', 'cepat']",6,3,3,bantu hubung cepat,3,3
Tidak bisa login setelah update.,negatif,2021-01-09,2021,tidak bisa login setelah update,5,5,tidak bisa login setelah diperbarui,5,5,"['tidak', 'bisa', 'login', 'setelah', 'diperbarui']","['tidak', 'login', 'diperbarui']",5,3,2,tidak login baru,3,3
Kenapa notifikasi sering tidak muncul?,negatif,2023-01-28,2023,kenapa notifikasi sering tidak muncul,5,5,kenapa notifikasi sering tidak muncul,5,5,"['kenapa', 'notifikasi', 'sering', 'tidak', 'muncul']","['notifikasi', 'tidak', 'muncul']",5,3,2,notifikasi tidak muncul,3,3
Sangat bermanfaat. Fitur lengkap.,positif,2020-07-09,2020,sangat bermanfaat fitur lengkap,4,4,sangat bermanfaat fitur lengkap,4,4,"['sangat', 'bermanfaat', 'fitur', 'lengkap']","['bermanfaat', 'fitur', 'lengkap']",4,3,1,manfaat fitur lengkap,3,3
Sulit untuk masuk login keluar lagi keluar lagi,negatif,2022-10-07,2022,sulit untuk masuk login keluar lagi keluar lagi,8,8,sulit untuk masuk login keluar lagi keluar lagi,8,8,"['sulit', 'untuk', 'masuk', 'login', 'keluar', 'lagi', 'keluar', 'lagi']","['sulit', 'masuk', 'login']",8,3,5,sulit masuk login,3,3
Mantap untuk mencari koneksi dan relasi,positif,2020-06-29,2020,mantap untuk mencari koneksi dan relasi,6,6,mantap untuk mencari koneksi dan relasi,6,6,"['mantap', 'untuk', 'mencari', 'koneksi', 'dan', 'relasi']","['mantap', 'mencari', 'koneksi', 'relasi']",6,4,2,mantap cari koneksi relasi,4,4
Job portal yang sangat membantu bagi penggunanya,positif,2021-10-27,2021,job portal yang sangat membantu bagi penggunanya,7,7,kerja portal yang sangat membantu bagi penggunanya,7,7,"['kerja', 'portal', 'yang', 'sangat', 'membantu', 'bagi', 'penggunanya']","['kerja', 'portal', 'membantu', 'penggunanya']",7,4,3,kerja portal bantu guna,4,4
Bagus untuk promosikan product,positif,2020-09-18,2020,bagus untuk promosikan product,4,4,bagus untuk promosikan produk,4,4,"['bagus', 'untuk', 'promosikan', 'produk']","['bagus', 'promosikan', 'produk']",4,3,1,bagus promosi produk,3,3
Simple mudah di mengerti,positif,2021-02-24,2021,simple mudah di mengerti,4,4,simpel mudah di mengerti,4,4,"['simpel', 'mudah', 'di', 'mengerti']","['simpel', 'mudah', 'mengerti']",4,3,1,simpel mudah erti,3,3
Sangat membantu untuk yg mencari pekerjaan,positif,2022-04-11,2022,sangat membantu untuk yg mencari pekerjaan,6,6,sangat membantu untuk yang mencari pekerjaan,6,6,"['sangat', 'membantu', 'untuk', 'yang', 'mencari', 'pekerjaan']","['membantu', 'mencari', 'pekerjaan']",6,3,3,bantu cari kerja,3,3
Semakin menambah jaringan dan koneksi usaha,positif,2021-01-18,2021,semakin menambah jaringan dan koneksi usaha,6,6,semakin menambah jaringan dan koneksi usaha,6,6,"['semakin', 'menambah', 'jaringan', 'dan', 'koneksi', 'usaha']","['menambah', 'jaringan', 'koneksi', 'usaha']",6,4,2,tambah jaring koneksi usaha,4,4
linkedln aplikasi yang menginspirasi dan banyak membantu,positif,2021-07-22,2021,linkedln aplikasi yang menginspirasi dan banyak membantu,7,7,linkedln aplikasi yang menginspirasi dan banyak membantu,7,7,"['linkedln', 'aplikasi', 'yang', 'menginspirasi', 'dan', 'banyak', 'membantu']","['linkedln', 'aplikasi', 'menginspirasi', 'membantu']",7,4,3,linkedln aplikasi inspirasi bantu,4,4
Cukup memuaskan utk posting di linkedin,positif,2020-05-02,2020,cukup memuaskan utk posting di linkedin,6,6,cukup memuaskan untuk posting di linkedin,6,6,"['cukup', 'memuaskan', 'untuk', 'posting', 'di', 'linkedin']","['memuaskan', 'posting', 'linkedin']",6,3,3,muas posting linkedin,3,3
Sangat membantu untuk mencari info pekerjaan,positif,2021-01-26,2021,sangat membantu untuk mencari info pekerjaan,6,6,sangat membantu untuk mencari informasi pekerjaan,6,6,"['sangat', 'membantu', 'untuk', 'mencari', 'informasi', 'pekerjaan']","['membantu', 'mencari', 'informasi', 'pekerjaan']",6,4,2,bantu cari informasi kerja,4,4
Banyak manfaatnya dan lebih mudah mencari pekerjaan.,positif,2022-01-18,2022,banyak manfaatnya dan lebih mudah mencari pekerjaan,7,7,banyak manfaatnya dan lebih mudah mencari pekerjaan,7,7,"['banyak', 'manfaatnya', 'dan', 'lebih', 'mudah', 'mencari', 'pekerjaan']","['manfaatnya', 'mudah', 'mencari', 'pekerjaan']",7,4,3,manfaat mudah cari kerja,4,4
"Sangat membantu sekali terhubung dengan orang-orang d luar sana yang satu profesi,,,,,,mantul",positif,2020-09-25,2020,sangat membantu sekali terhubung dengan orang orang d luar sana yang satu profesi mantul,12,14,sangat membantu sekali terhubung dengan orang orang di luar sana yang satu profesi mantap betul,14,15,"['sangat', 'membantu', 'sekali', 'terhubung', 'dengan', 'orang', 'orang', 'di', 'luar', 'sana', 'yang', 'satu', 'profesi', 'mantap', 'betul']","['membantu', 'terhubung', 'orang', 'orang', 'profesi', 'mantap']",15,6,9,bantu hubung orang orang profesi mantap,6,6
Pas masuk mau isi pengalaman kerja terakhir selalu bermasalah terus di apl nya.. solusinya bagaimana?,negatif,2022-04-25,2022,pas masuk mau isi pengalaman kerja terakhir selalu bermasalah terus di apl nya solusinya bagaimana,15,15,pas masuk mau isi pengalaman kerja terakhir selalu bermasalah terus di aplikasi nya solusinya bagaimana,15,15,"['pas', 'masuk', 'mau', 'isi', 'pengalaman', 'kerja', 'terakhir', 'selalu', 'bermasalah', 'terus', 'di', 'aplikasi', 'nya', 'solusinya', 'bagaimana']","['pas', 'masuk', 'isi', 'pengalaman', 'kerja', 'bermasalah', 'aplikasi', 'nya', 'solusinya']",15,9,6,pas masuk isi alam kerja masalah aplikasi nya solusi,9,9
Sangat sanagat membantu sekali dalam pekerjaan,positif,2020-02-17,2020,sangat sanagat membantu sekali dalam pekerjaan,6,6,sangat sanagat membantu sekali dalam pekerjaan,6,6,"['sangat', 'sanagat', 'membantu', 'sekali', 'dalam', 'pekerjaan']","['sanagat', 'membantu', 'pekerjaan']",6,3,3,sanagat bantu kerja,3,3
Semoga bisa menjadi platform terpercaya yang selalu mampu memeberikan info lapangan pekerjaan serta mempertemukan orang dengan lebih baik lagi,positif,2020-07-05,2020,semoga bisa menjadi platform terpercaya yang selalu mampu memeberikan info lapangan pekerjaan serta mempertemukan orang dengan lebih baik lagi,19,19,semoga bisa menjadi platform terpercaya yang selalu mampu memeberikan informasi lapangan pekerjaan serta mempertemukan orang dengan lebih baik lagi,19,19,"['semoga', 'bisa', 'menjadi', 'platform', 'terpercaya', 'yang', 'selalu', 'mampu', 'memeberikan', 'informasi', 'lapangan', 'pekerjaan', 'serta', 'mempertemukan', 'orang', 'dengan', 'lebih', 'baik', 'lagi']","['semoga', 'platform', 'terpercaya', 'memeberikan', 'informasi', 'lapangan', 'pekerjaan', 'mempertemukan', 'orang']",19,9,10,moga platform percaya memeberikan informasi lapang kerja temu orang,9,9
"Membantu dalam mencari relasi usaha dan pekerjaan, Nice!!!",positif,2020-08-08,2020,membantu dalam mencari relasi usaha dan pekerjaan nice,8,8,membantu dalam mencari relasi usaha dan pekerjaan baik,8,8,"['membantu', 'dalam', 'mencari', 'relasi', 'usaha', 'dan', 'pekerjaan', 'baik']","['membantu', 'mencari', 'relasi', 'usaha', 'pekerjaan']",8,5,3,bantu cari relasi usaha kerja,5,5
"Sangat membantu, mudah dan puas",positif,2021-07-03,2021,sangat membantu mudah dan puas,5,5,sangat membantu mudah dan puas,5,5,"['sangat', 'membantu', 'mudah', 'dan', 'puas']","['membantu', 'mudah', 'puas']",5,3,2,bantu mudah puas,3,3
Sangat bermanfaat untuk komunitas Jobseeker.,positif,2020-07-22,2020,sangat bermanfaat untuk komunitas jobseeker,5,5,sangat bermanfaat untuk komunitas jobseeker,5,5,"['sangat', 'bermanfaat', 'untuk', 'komunitas', 'jobseeker']","['bermanfaat', 'komunitas', 'jobseeker']",5,3,2,manfaat komunitas jobseeker,3,3
Aplikasi ini sagat berguna baget buat kita yg lagi susah nyari kerja.,positif,2023-01-14,2023,aplikasi ini sagat berguna baget buat kita yg lagi susah nyari kerja,12,12,aplikasi ini sagat berguna banget buat kita yang lagi susah mencari kerja,12,12,"['aplikasi', 'ini', 'sagat', 'berguna', 'banget', 'buat', 'kita', 'yang', 'lagi', 'susah', 'mencari', 'kerja']","['aplikasi', 'sagat', 'berguna', 'banget', 'susah', 'mencari', 'kerja']",12,7,5,aplikasi sagat guna banget susah cari kerja,7,7
Aplikasi ini sangat mudah untuk mencari pekerjaan,positif,2020-02-25,2020,aplikasi ini sangat mudah untuk mencari pekerjaan,7,7,aplikasi ini sangat mudah untuk mencari pekerjaan,7,7,"['aplikasi', 'ini', 'sangat', 'mudah', 'untuk', 'mencari', 'pekerjaan']","['aplikasi', 'mudah', 'mencari', 'pekerjaan']",7,4,3,aplikasi mudah cari kerja,4,4
Sangat membantu karir saya & babyak relasi dan teman,positif,2020-04-30,2020,sangat membantu karir saya babyak relasi dan teman,9,8,sangat membantu karir saya babyak relasi dan teman,8,8,"['sangat', 'membantu', 'karir', 'saya', 'babyak', 'relasi', 'dan', 'teman']","['membantu', 'karir', 'babyak', 'relasi', 'teman']",8,5,3,bantu karir babyak relasi teman,5,5
Sangat bagus untuk media informasi nya,positif,2022-02-09,2022,sangat bagus untuk media informasi nya,6,6,sangat bagus untuk media informasi nya,6,6,"['sangat', 'bagus', 'untuk', 'media', 'informasi', 'nya']","['bagus', 'media', 'informasi', 'nya']",6,4,2,bagus media informasi nya,4,4
sangat mengganggu iklan nya,negatif,2024-02-27,2024,sangat mengganggu iklan nya,4,4,sangat mengganggu iklan nya,4,4,"['sangat', 'mengganggu', 'iklan', 'nya']","['mengganggu', 'iklan', 'nya']",4,3,1,ganggu iklan nya,3,3
"Masih aja susah log in, suruh milih gambar yg ga jelas",negatif,2024-01-24,2024,masih aja susah log in suruh milih gambar yg ga jelas,11,11,masih saja susah log in suruh memilih gambar yang tidak jelas,11,11,"['masih', 'saja', 'susah', 'log', 'in', 'suruh', 'memilih', 'gambar', 'yang', 'tidak', 'jelas']","['susah', 'log', 'in', 'suruh', 'memilih', 'gambar', 'tidak']",11,7,4,susah log in suruh pilih gambar tidak,7,7
Teka teki nya menyulitkan. Tidak bisa masuk,negatif,2022-06-15,2022,teka teki nya menyulitkan tidak bisa masuk,7,7,teka teki nya menyulitkan tidak bisa masuk,7,7,"['teka', 'teki', 'nya', 'menyulitkan', 'tidak', 'bisa', 'masuk']","['teka', 'teki', 'nya', 'menyulitkan', 'tidak', 'masuk']",7,6,1,teka teki nya sulit tidak masuk,6,6
"Saya tidak bisa login melalui akun google, notifnya selalu ada kesalahan",negatif,2023-05-27,2023,saya tidak bisa login melalui akun google notifnya selalu ada kesalahan,11,11,saya tidak bisa login melalui akun google notifnya selalu ada kesalahan,11,11,"['saya', 'tidak', 'bisa', 'login', 'melalui', 'akun', 'google', 'notifnya', 'selalu', 'ada', 'kesalahan']","['tidak', 'login', 'akun', 'google', 'notifnya', 'kesalahan']",11,6,5,tidak login akun google notifnya salah,6,6
"Sangat Membantu, dalam pekerjaan",positif,2020-12-07,2020,sangat membantu dalam pekerjaan,4,4,sangat membantu dalam pekerjaan,4,4,"['sangat', 'membantu', 'dalam', 'pekerjaan']","['membantu', 'pekerjaan']",4,2,2,bantu kerja,2,2
"Saya senang ketika bergabung bersama linked, banyak motivasi yang saya dapat. Tksh.",positif,2020-03-19,2020,saya senang ketika bergabung bersama linked banyak motivasi yang saya dapat tksh,12,12,saya senang ketika bergabung bersama linked banyak motivasi yang saya dapat tksh,12,12,"['saya', 'senang', 'ketika', 'bergabung', 'bersama', 'linked', 'banyak', 'motivasi', 'yang', 'saya', 'dapat', 'tksh']","['senang', 'bergabung', 'linked', 'motivasi', 'tksh']",12,5,7,senang gabung linked motivasi tksh,5,5
"Terlalu mengganggu, karena sering banyak notifikasi yang tidak penting.",negatif,2020-05-20,2020,terlalu mengganggu karena sering banyak notifikasi yang tidak penting,9,9,terlalu mengganggu karena sering banyak notifikasi yang tidak penting,9,9,"['terlalu', 'mengganggu', 'karena', 'sering', 'banyak', 'notifikasi', 'yang', 'tidak', 'penting']","['mengganggu', 'notifikasi', 'tidak']",9,3,6,ganggu notifikasi tidak,3,3
Sangat berguna dan dan sangat membatu. Di kalangan usaha,positif,2022-02-10,2022,sangat berguna dan dan sangat membatu di kalangan usaha,9,9,sangat berguna dan dan sangat membantu di kalangan usaha,9,9,"['sangat', 'berguna', 'dan', 'dan', 'sangat', 'membantu', 'di', 'kalangan', 'usaha']","['berguna', 'membantu', 'kalangan', 'usaha']",9,4,5,guna bantu kalang usaha,4,4
Proses verifikasi login yang selalu gagal,negatif,2023-08-01,2023,proses verifikasi login yang selalu gagal,6,6,proses verifikasi login yang selalu gagal,6,6,"['proses', 'verifikasi', 'login', 'yang', 'selalu', 'gagal']","['proses', 'verifikasi', 'login', 'gagal']",6,4,2,proses verifikasi login gagal,4,4
Susah banget sih verifikasi nya. Bikin emosi aja. Auto uninstall,negatif,2022-09-30,2022,susah banget sih verifikasi nya bikin emosi aja auto uninstall,10,10,susah banget sih verifikasi nya bikin emosi saja otomatis uninstall,10,10,"['susah', 'banget', 'sih', 'verifikasi', 'nya', 'bikin', 'emosi', 'saja', 'otomatis', 'uninstall']","['susah', 'banget', 'sih', 'verifikasi', 'nya', 'bikin', 'emosi', 'otomatis', 'uninstall']",10,9,1,susah banget sih verifikasi nya bikin emosi otomatis uninstall,9,9
Sangat baik untuk berbagi informasi,positif,2022-07-25,2022,sangat baik untuk berbagi informasi,5,5,sangat baik untuk berbagi informasi,5,5,"['sangat', 'baik', 'untuk', 'berbagi', 'informasi']","['berbagi', 'informasi']",5,2,3,bagi informasi,2,2
Aplikasinya sangat membantu dan berguna sangat bagus sekali,positif,2021-03-18,2021,aplikasinya sangat membantu dan berguna sangat bagus sekali,8,8,aplikasi nya sangat membantu dan berguna sangat bagus sekali,8,9,"['aplikasi', 'nya', 'sangat', 'membantu', 'dan', 'berguna', 'sangat', 'bagus', 'sekali']","['aplikasi', 'nya', 'membantu', 'berguna', 'bagus']",9,5,4,aplikasi nya bantu guna bagus,5,5
Aplikasi yg baik untuk para pencari kerja seperti saya.,positif,2020-09-05,2020,aplikasi yg baik untuk para pencari kerja seperti saya,9,9,aplikasi yang baik untuk para pencari kerja seperti saya,9,9,"['aplikasi', 'yang', 'baik', 'untuk', 'para', 'pencari', 'kerja', 'seperti', 'saya']","['aplikasi', 'pencari', 'kerja']",9,3,6,aplikasi cari kerja,3,3
Belum ada pengalaman baru mau coba moga baik dan lancar,positif,2021-06-04,2021,belum ada pengalaman baru mau coba moga baik dan lancar,10,10,belum ada pengalaman baru mau coba semoga baik dan lancar,10,10,"['belum', 'ada', 'pengalaman', 'baru', 'mau', 'coba', 'semoga', 'baik', 'dan', 'lancar']","['pengalaman', 'coba', 'semoga', 'lancar']",10,4,6,alam coba moga lancar,4,4
Sangat susah untuk login,negatif,2021-08-01,2021,sangat susah untuk login,4,4,sangat susah untuk login,4,4,"['sangat', 'susah', 'untuk', 'login']","['susah', 'login']",4,2,2,susah login,2,2
Sangat bagus dan bisa bergabung dengan orang orang hebat.,positif,2022-02-14,2022,sangat bagus dan bisa bergabung dengan orang orang hebat,9,9,sangat bagus dan bisa bergabung dengan orang orang hebat,9,9,"['sangat', 'bagus', 'dan', 'bisa', 'bergabung', 'dengan', 'orang', 'orang', 'hebat']","['bagus', 'bergabung', 'orang', 'orang', 'hebat']",9,5,4,bagus gabung orang orang hebat,5,5
Berbagai informasi yang didapat setelah begabung Linkedia. Terimakasih.,positif,2021-09-16,2021,berbagai informasi yang didapat setelah begabung linkedia terimakasih,8,8,berbagai informasi yang didapat setelah begabung linkedia terima kasih,8,9,"['berbagai', 'informasi', 'yang', 'didapat', 'setelah', 'begabung', 'linkedia', 'terima', 'kasih']","['informasi', 'begabung', 'linkedia', 'terima', 'kasih']",9,5,4,informasi begabung linkedia terima kasih,5,5
"Kenapa akun saya tidak bisa login, dengan alasan di batasi? Bagaimana cara saya mengembalikannya? Tidak ada petunjuk di linked in untuk mengembalikan akun dengan case seperti saya",negatif,2020-04-17,2020,kenapa akun saya tidak bisa login dengan alasan di batasi bagaimana cara saya mengembalikannya tidak ada petunjuk di linked in untuk mengembalikan akun dengan case seperti saya,27,27,kenapa akun saya tidak bisa login dengan alasan di batasi bagaimana cara saya mengembalikannya tidak ada petunjuk di linked in untuk mengembalikan akun dengan case seperti saya,27,27,"['kenapa', 'akun', 'saya', 'tidak', 'bisa', 'login', 'dengan', 'alasan', 'di', 'batasi', 'bagaimana', 'cara', 'saya', 'mengembalikannya', 'tidak', 'ada', 'petunjuk', 'di', 'linked', 'in', 'untuk', 'mengembalikan', 'akun', 'dengan', 'case', 'seperti', 'saya']","['akun', 'tidak', 'login', 'alasan', 'batasi', 'mengembalikannya', 'tidak', 'petunjuk', 'linked', 'in', 'mengembalikan', 'akun', 'case']",27,13,14,akun tidak login alas batas kembali tidak tunjuk linked in kembali akun case,13,13
Bagus aplikasinya untuk info mengenai lowongan kerja,positif,2022-08-06,2022,bagus aplikasinya untuk info mengenai lowongan kerja,7,7,bagus aplikasi nya untuk informasi mengenai lowongan kerja,7,8,"['bagus', 'aplikasi', 'nya', 'untuk', 'informasi', 'mengenai', 'lowongan', 'kerja']","['bagus', 'aplikasi', 'nya', 'informasi', 'lowongan', 'kerja']",8,6,2,bagus aplikasi nya informasi lowong kerja,6,6
Menjadi lebih mudah & praktis,positif,2020-04-08,2020,menjadi lebih mudah praktis,5,4,menjadi lebih mudah praktis,4,4,"['menjadi', 'lebih', 'mudah', 'praktis']","['mudah', 'praktis']",4,2,2,mudah praktis,2,2
G bisa uploap foto. Selalu error saat mau pilih.,negatif,2021-05-04,2021,g bisa uploap foto selalu error saat mau pilih,9,9,tidak bisa uploap foto selalu error saat mau pilih,9,9,"['tidak', 'bisa', 'uploap', 'foto', 'selalu', 'error', 'saat', 'mau', 'pilih']","['tidak', 'uploap', 'foto', 'error', 'pilih']",9,5,4,tidak uploap foto error pilih,5,5
Susah login nya/ bikin pasword nya,negatif,2021-08-04,2021,susah login nya bikin pasword nya,6,6,susah login nya bikin pasword nya,6,6,"['susah', 'login', 'nya', 'bikin', 'pasword', 'nya']","['susah', 'login', 'nya', 'bikin', 'pasword', 'nya']",6,6,0,susah login nya bikin pasword nya,6,6
sangat membantu terhubung dengan dunia kerja juga relasi,positif,2020-04-15,2020,sangat membantu terhubung dengan dunia kerja juga relasi,8,8,sangat membantu terhubung dengan dunia kerja juga relasi,8,8,"['sangat', 'membantu', 'terhubung', 'dengan', 'dunia', 'kerja', 'juga', 'relasi']","['membantu', 'terhubung', 'dunia', 'kerja', 'relasi']",8,5,3,bantu hubung dunia kerja relasi,5,5
meskipun belum dapat kerjaan dr aplikasi ini tapi top lah,positif,2020-11-17,2020,meskipun belum dapat kerjaan dr aplikasi ini tapi top lah,10,10,meskipun belum dapat kerjaan dari aplikasi ini tapi top lah,10,10,"['meskipun', 'belum', 'dapat', 'kerjaan', 'dari', 'aplikasi', 'ini', 'tapi', 'top', 'lah']","['kerjaan', 'aplikasi', 'top']",10,3,7,kerja aplikasi top,3,3
"Terdepan dalam wawasan,sharing dan kemajuan para jobstreet berubah",positif,2020-10-04,2020,terdepan dalam wawasan sharing dan kemajuan para jobstreet berubah,8,9,terdepan dalam wawasan sharing dan kemajuan para jobstreet berubah,9,9,"['terdepan', 'dalam', 'wawasan', 'sharing', 'dan', 'kemajuan', 'para', 'jobstreet', 'berubah']","['terdepan', 'wawasan', 'sharing', 'kemajuan', 'jobstreet', 'berubah']",9,6,3,depan wawas sharing maju jobstreet ubah,6,6
Aplikasi yang sangat membantu bagi para jobseeker,positif,2022-02-13,2022,aplikasi yang sangat membantu bagi para jobseeker,7,7,aplikasi yang sangat membantu bagi para jobseeker,7,7,"['aplikasi', 'yang', 'sangat', 'membantu', 'bagi', 'para', 'jobseeker']","['aplikasi', 'membantu', 'jobseeker']",7,3,4,aplikasi bantu jobseeker,3,3
Mendapat informasih tentang Job dengan cepat.,positif,2020-04-23,2020,mendapat informasih tentang job dengan cepat,6,6,mendapat informasih tentang kerja dengan cepat,6,6,"['mendapat', 'informasih', 'tentang', 'kerja', 'dengan', 'cepat']","['informasih', 'kerja', 'cepat']",6,3,3,informasih kerja cepat,3,3
Sangat amat membantu untuk orang-orang yang mencari kerja,positif,2022-11-10,2022,sangat amat membantu untuk orang orang yang mencari kerja,8,9,sangat amat membantu untuk orang orang yang mencari kerja,9,9,"['sangat', 'amat', 'membantu', 'untuk', 'orang', 'orang', 'yang', 'mencari', 'kerja']","['membantu', 'orang', 'orang', 'mencari', 'kerja']",9,5,4,bantu orang orang cari kerja,5,5
"Cukup bagus utk menambah relasi, selamat n maju terus.",positif,2022-03-30,2022,cukup bagus utk menambah relasi selamat n maju terus,9,9,cukup bagus untuk menambah relasi selamat dan maju terus,9,9,"['cukup', 'bagus', 'untuk', 'menambah', 'relasi', 'selamat', 'dan', 'maju', 'terus']","['bagus', 'menambah', 'relasi', 'selamat', 'maju']",9,5,4,bagus tambah relasi selamat maju,5,5
semakin..mempermudah pencari kerjaa ...sip..ok..,positif,2021-03-05,2021,semakin mempermudah pencari kerjaa sip ok,4,6,semakin mempermudah pencari kerjaa sip oke,6,6,"['semakin', 'mempermudah', 'pencari', 'kerjaa', 'sip', 'oke']","['mempermudah', 'pencari', 'kerjaa', 'sip', 'oke']",6,5,1,mudah cari kerjaa sip oke,5,5
Good sih cuma setiap update poto gagal mulu dah,positif,2020-03-05,2020,good sih cuma setiap update poto gagal mulu dah,9,9,bagus sih cuma setiap diperbarui poto gagal mulu sudah,9,9,"['bagus', 'sih', 'cuma', 'setiap', 'diperbarui', 'poto', 'gagal', 'mulu', 'sudah']","['bagus', 'sih', 'diperbarui', 'poto', 'gagal', 'mulu']",9,6,3,bagus sih baru poto gagal mulu,6,6
Sangat informative mudah dipakai,positif,2021-03-09,2021,sangat informative mudah dipakai,4,4,sangat informative mudah dipakai,4,4,"['sangat', 'informative', 'mudah', 'dipakai']","['informative', 'mudah', 'dipakai']",4,3,1,informative mudah pakai,3,3
Susah verifikasi..auto balik and uninstall..,negatif,2022-04-30,2022,susah verifikasi auto balik and uninstall,5,6,susah verifikasi otomatis balik and uninstall,6,6,"['susah', 'verifikasi', 'otomatis', 'balik', 'and', 'uninstall']","['susah', 'verifikasi', 'otomatis', 'and', 'uninstall']",6,5,1,susah verifikasi otomatis and uninstall,5,5
Sangat bermanfaat dan bisa bertemu dengan rekan rekan yang seprofesi,positif,2022-11-02,2022,sangat bermanfaat dan bisa bertemu dengan rekan rekan yang seprofesi,10,10,sangat bermanfaat dan bisa bertemu dengan rekan rekan yang seprofesi,10,10,"['sangat', 'bermanfaat', 'dan', 'bisa', 'bertemu', 'dengan', 'rekan', 'rekan', 'yang', 'seprofesi']","['bermanfaat', 'bertemu', 'rekan', 'rekan', 'seprofesi']",10,5,5,manfaat temu rekan rekan profesi,5,5
Terima kasih atas waktunya cepat dan mudah untuk digunakan,positif,2021-01-01,2021,terima kasih atas waktunya cepat dan mudah untuk digunakan,9,9,terima kasih atas waktunya cepat dan mudah untuk digunakan,9,9,"['terima', 'kasih', 'atas', 'waktunya', 'cepat', 'dan', 'mudah', 'untuk', 'digunakan']","['terima', 'kasih', 'cepat', 'mudah']",9,4,5,terima kasih cepat mudah,4,4
Ini kenapa kok ga bisa konfirmasi alamat email. Padahal penting banget.,negatif,2021-02-07,2021,ini kenapa kok ga bisa konfirmasi alamat email padahal penting banget,11,11,ini kenapa kok tidak bisa konfirmasi alamat email padahal penting banget,11,11,"['ini', 'kenapa', 'kok', 'tidak', 'bisa', 'konfirmasi', 'alamat', 'email', 'padahal', 'penting', 'banget']","['tidak', 'konfirmasi', 'alamat', 'email', 'banget']",11,5,6,tidak konfirmasi alamat email banget,5,5
Terhubung dengan banyak resources,positif,2022-12-22,2022,terhubung dengan banyak resources,4,4,terhubung dengan banyak resources,4,4,"['terhubung', 'dengan', 'banyak', 'resources']","['terhubung', 'resources']",4,2,2,hubung resources,2,2
"Trima ksh infonya,Linkedln,smoga lbh brmanfaat lgi buat org byk,sukses slalu,dan tingkatkan mutu dan kwalitas info.",positif,2021-03-13,2021,trima ksh infonya linkedln smoga lbh brmanfaat lgi buat org byk sukses slalu dan tingkatkan mutu dan kwalitas info,15,19,terima kasih informasinya linkedln semoga lebih brmanfaat lagi buat orang banyak sukses selalu dan tingkatkan mutu dan kualitas informasi,19,19,"['terima', 'kasih', 'informasinya', 'linkedln', 'semoga', 'lebih', 'brmanfaat', 'lagi', 'buat', 'orang', 'banyak', 'sukses', 'selalu', 'dan', 'tingkatkan', 'mutu', 'dan', 'kualitas', 'informasi']","['terima', 'kasih', 'informasinya', 'linkedln', 'semoga', 'brmanfaat', 'orang', 'sukses', 'tingkatkan', 'mutu', 'kualitas', 'informasi']",19,12,7,terima kasih informasi linkedln moga brmanfaat orang sukses tingkat mutu kualitas informasi,12,12
Linkedin memang bagus untuk berinteraksi saya pengguna sdh cukup lama,positif,2022-02-20,2022,linkedin memang bagus untuk berinteraksi saya pengguna sdh cukup lama,10,10,linkedin memang bagus untuk berinteraksi saya pengguna sudah cukup lama,10,10,"['linkedin', 'memang', 'bagus', 'untuk', 'berinteraksi', 'saya', 'pengguna', 'sudah', 'cukup', 'lama']","['linkedin', 'bagus', 'berinteraksi', 'pengguna']",10,4,6,linkedin bagus interaksi guna,4,4
Cukup bagus untuk mendapatkan info loker,positif,2023-05-24,2023,cukup bagus untuk mendapatkan info loker,6,6,cukup bagus untuk mendapatkan informasi loker,6,6,"['cukup', 'bagus', 'untuk', 'mendapatkan', 'informasi', 'loker']","['bagus', 'informasi', 'loker']",6,3,3,bagus informasi loker,3,3
Sangat membantu untuk para pencari kerja,positif,2022-07-14,2022,sangat membantu untuk para pencari kerja,6,6,sangat membantu untuk para pencari kerja,6,6,"['sangat', 'membantu', 'untuk', 'para', 'pencari', 'kerja']","['membantu', 'pencari', 'kerja']",6,3,3,bantu cari kerja,3,3
Simpel dan bijaksana efisien dan efektif.,positif,2021-09-05,2021,simpel dan bijaksana efisien dan efektif,6,6,simpel dan bijaksana efisien dan efektif,6,6,"['simpel', 'dan', 'bijaksana', 'efisien', 'dan', 'efektif']","['simpel', 'bijaksana', 'efisien', 'efektif']",6,4,2,simpel bijaksana efisien efektif,4,4
Aplikasi yang berguna untuk menjalin networking sesama profesional,positif,2020-09-12,2020,aplikasi yang berguna untuk menjalin networking sesama profesional,8,8,aplikasi yang berguna untuk menjalin networking sesama profesional,8,8,"['aplikasi', 'yang', 'berguna', 'untuk', 'menjalin', 'networking', 'sesama', 'profesional']","['aplikasi', 'berguna', 'menjalin', 'networking', 'profesional']",8,5,3,aplikasi guna jalin networking profesional,5,5
Sangat membantu dalam mencari pekerjaan,positif,2020-04-28,2020,sangat membantu dalam mencari pekerjaan,5,5,sangat membantu dalam mencari pekerjaan,5,5,"['sangat', 'membantu', 'dalam', 'mencari', 'pekerjaan']","['membantu', 'mencari', 'pekerjaan']",5,3,2,bantu cari kerja,3,3
"Verification tolol yang buat apk, gak bisa masuk",negatif,2022-06-06,2022,verification tolol yang buat apk gak bisa masuk,8,8,verification tolol yang buat aplikasi tidak bisa masuk,8,8,"['verification', 'tolol', 'yang', 'buat', 'aplikasi', 'tidak', 'bisa', 'masuk']","['verification', 'tolol', 'aplikasi', 'tidak', 'masuk']",8,5,3,verification tolol aplikasi tidak masuk,5,5
Komunikatif dan bermanfaat,positif,2023-03-30,2023,komunikatif dan bermanfaat,3,3,komunikatif dan bermanfaat,3,3,"['komunikatif', 'dan', 'bermanfaat']","['komunikatif', 'bermanfaat']",3,2,1,komunikatif manfaat,2,2
"Kenapa kalau ngelamar kerja harus masuk aplikasi lain, kalau kayak gitu mending nggak usah download ini tapi aplikasi yang lain aja",negatif,2022-08-16,2022,kenapa kalau ngelamar kerja harus masuk aplikasi lain kalau kayak gitu mending nggak usah download ini tapi aplikasi yang lain aja,21,21,kenapa kalau ngelamar kerja harus masuk aplikasi lain kalau kayak begitu mending tidak usah unduh ini tapi aplikasi yang lain saja,21,21,"['kenapa', 'kalau', 'ngelamar', 'kerja', 'harus', 'masuk', 'aplikasi', 'lain', 'kalau', 'kayak', 'begitu', 'mending', 'tidak', 'usah', 'unduh', 'ini', 'tapi', 'aplikasi', 'yang', 'lain', 'saja']","['ngelamar', 'kerja', 'masuk', 'aplikasi', 'kayak', 'mending', 'tidak', 'unduh', 'aplikasi']",21,9,12,ngelamar kerja masuk aplikasi kayak mending tidak unduh aplikasi,9,9
banyak info maupun lebih banyak mengenal job yg lebih baik,positif,2021-09-20,2021,banyak info maupun lebih banyak mengenal job yg lebih baik,10,10,banyak informasi maupun lebih banyak mengenal kerja yang lebih baik,10,10,"['banyak', 'informasi', 'maupun', 'lebih', 'banyak', 'mengenal', 'kerja', 'yang', 'lebih', 'baik']","['informasi', 'mengenal', 'kerja']",10,3,7,informasi kenal kerja,3,3
Aplikasi ini bagus bg calon penguasaha atau pembisnis. Krn aplikasi ini memberi inspirasi yg tak ternilai.,positif,2020-07-27,2020,aplikasi ini bagus bg calon penguasaha atau pembisnis krn aplikasi ini memberi inspirasi yg tak ternilai,16,16,aplikasi ini bagus bg calon penguasaha atau pembisnis karena aplikasi ini memberi inspirasi yang tidak ternilai,16,16,"['aplikasi', 'ini', 'bagus', 'bg', 'calon', 'penguasaha', 'atau', 'pembisnis', 'karena', 'aplikasi', 'ini', 'memberi', 'inspirasi', 'yang', 'tidak', 'ternilai']","['aplikasi', 'bagus', 'bg', 'calon', 'penguasaha', 'pembisnis', 'aplikasi', 'inspirasi', 'tidak', 'ternilai']",16,10,6,aplikasi bagus bg calon penguasaha bisnis aplikasi inspirasi tidak nilai,10,10
Verifikasi login terlalu rumit,negatif,2022-02-19,2022,verifikasi login terlalu rumit,4,4,verifikasi login terlalu rumit,4,4,"['verifikasi', 'login', 'terlalu', 'rumit']","['verifikasi', 'login', 'rumit']",4,3,1,verifikasi login rumit,3,3
"Bagus, sangat friendly, dan menolong banyak hal",positif,2020-03-03,2020,bagus sangat friendly dan menolong banyak hal,7,7,bagus sangat friendly dan menolong banyak hal,7,7,"['bagus', 'sangat', 'friendly', 'dan', 'menolong', 'banyak', 'hal']","['bagus', 'friendly', 'menolong']",7,3,4,bagus friendly tolong,3,3
Tempat terbaik untuk banyak belajar dan mendapatkan ilmu,positif,2020-10-26,2020,tempat terbaik untuk banyak belajar dan mendapatkan ilmu,8,8,tempat terbaik untuk banyak belajar dan mendapatkan ilmu,8,8,"['tempat', 'terbaik', 'untuk', 'banyak', 'belajar', 'dan', 'mendapatkan', 'ilmu']","['terbaik', 'belajar', 'ilmu']",8,3,5,baik ajar ilmu,3,3
Sangat bermanfaat dalam mencari kerja,positif,2021-07-27,2021,sangat bermanfaat dalam mencari kerja,5,5,sangat bermanfaat dalam mencari kerja,5,5,"['sangat', 'bermanfaat', 'dalam', 'mencari', 'kerja']","['bermanfaat', 'mencari', 'kerja']",5,3,2,manfaat cari kerja,3,3
Sangat membantu dalam mencari Pekerjaan 👍,positif,2023-02-11,2023,sangat membantu dalam mencari pekerjaan,6,5,sangat membantu dalam mencari pekerjaan,5,5,"['sangat', 'membantu', 'dalam', 'mencari', 'pekerjaan']","['membantu', 'mencari', 'pekerjaan']",5,3,2,bantu cari kerja,3,3
Sangat bermanfaat buat menambah pengetahuan dan wawasan,positif,2022-05-29,2022,sangat bermanfaat buat menambah pengetahuan dan wawasan,7,7,sangat bermanfaat buat menambah pengetahuan dan wawasan,7,7,"['sangat', 'bermanfaat', 'buat', 'menambah', 'pengetahuan', 'dan', 'wawasan']","['bermanfaat', 'menambah', 'pengetahuan', 'wawasan']",7,4,3,manfaat tambah tahu wawas,4,4
Bagus untuk pencarian pekerjaan,positif,2020-10-21,2020,bagus untuk pencarian pekerjaan,4,4,bagus untuk pencarian pekerjaan,4,4,"['bagus', 'untuk', 'pencarian', 'pekerjaan']","['bagus', 'pencarian', 'pekerjaan']",4,3,1,bagus cari kerja,3,3
"Mantap dari aplikasi ini,kita bisa cari pekerjaan yang kita ingin kan",positif,2022-04-16,2022,mantap dari aplikasi ini kita bisa cari pekerjaan yang kita ingin kan,11,12,mantap dari aplikasi ini kita bisa cari pekerjaan yang kita ingin akan,12,12,"['mantap', 'dari', 'aplikasi', 'ini', 'kita', 'bisa', 'cari', 'pekerjaan', 'yang', 'kita', 'ingin', 'akan']","['mantap', 'aplikasi', 'cari', 'pekerjaan']",12,4,8,mantap aplikasi cari kerja,4,4
Hapus aja bos aplikasinya verifikasi ribet bgt gagal terus kek kita mau maling aja !!!!! Sampah,negatif,2021-06-03,2021,hapus aja bos aplikasinya verifikasi ribet bgt gagal terus kek kita mau maling aja sampah,16,15,hapus saja box aplikasi nya verifikasi rumit banget gagal terus seperti kita mau maling saja sampah,15,16,"['hapus', 'saja', 'box', 'aplikasi', 'nya', 'verifikasi', 'rumit', 'banget', 'gagal', 'terus', 'seperti', 'kita', 'mau', 'maling', 'saja', 'sampah']","['hapus', 'box', 'aplikasi', 'nya', 'verifikasi', 'rumit', 'banget', 'gagal', 'maling', 'sampah']",16,10,6,hapus box aplikasi nya verifikasi rumit banget gagal maling sampah,10,10
Sangat membantu dalam jaringan profesional,positif,2024-01-31,2024,sangat membantu dalam jaringan profesional,5,5,sangat membantu dalam jaringan profesional,5,5,"['sangat', 'membantu', 'dalam', 'jaringan', 'profesional']","['membantu', 'jaringan', 'profesional']",5,3,2,bantu jaring profesional,3,3
"keren banget sih aplikasi ini memudahkan semua urusan, thank you for good a chooice",positif,2023-12-23,2023,keren banget sih aplikasi ini memudahkan semua urusan thank you for good a chooice,14,14,keren banget sih aplikasi ini memudahkan semua urusan terima kasih you for bagus a chooice,14,15,"['keren', 'banget', 'sih', 'aplikasi', 'ini', 'memudahkan', 'semua', 'urusan', 'terima', 'kasih', 'you', 'for', 'bagus', 'a', 'chooice']","['keren', 'banget', 'sih', 'aplikasi', 'memudahkan', 'urusan', 'terima', 'kasih', 'you', 'for', 'bagus', 'a', 'chooice']",15,13,2,keren banget sih aplikasi mudah urus terima kasih you for bagus a chooice,13,13
Dengan mudah mendapatkan info pekerjaan,positif,2021-01-04,2021,dengan mudah mendapatkan info pekerjaan,5,5,dengan mudah mendapatkan informasi pekerjaan,5,5,"['dengan', 'mudah', 'mendapatkan', 'informasi', 'pekerjaan']","['mudah', 'informasi', 'pekerjaan']",5,3,2,mudah informasi kerja,3,3
Apk ga jelas. Foto profil punya saya sendiri. Saya yang edit logo sendiri. Eh taunya di hapus dengan alasan melanggar hak cipta 🤦.,negatif,2022-01-06,2022,apk ga jelas foto profil punya saya sendiri saya yang edit logo sendiri eh taunya di hapus dengan alasan melanggar hak cipta,23,22,aplikasi tidak jelas foto profil punya saya sendiri saya yang edit logo sendiri eh taunya di hapus dengan alasan melanggar hak cipta,22,22,"['aplikasi', 'tidak', 'jelas', 'foto', 'profil', 'punya', 'saya', 'sendiri', 'saya', 'yang', 'edit', 'logo', 'sendiri', 'eh', 'taunya', 'di', 'hapus', 'dengan', 'alasan', 'melanggar', 'hak', 'cipta']","['aplikasi', 'tidak', 'foto', 'profil', 'edit', 'logo', 'eh', 'taunya', 'hapus', 'alasan', 'melanggar', 'hak', 'cipta']",22,13,9,aplikasi tidak foto profil edit logo eh tau hapus alas langgar hak cipta,13,13
Sangat berguna dan mudah penggunaannya,positif,2020-07-14,2020,sangat berguna dan mudah penggunaannya,5,5,sangat berguna dan mudah penggunaannya,5,5,"['sangat', 'berguna', 'dan', 'mudah', 'penggunaannya']","['berguna', 'mudah', 'penggunaannya']",5,3,2,guna mudah guna,3,3
Saya tidak ketinggalan informasi terkait perkembangan dunia kerja. Terimakasih,positif,2020-04-09,2020,saya tidak ketinggalan informasi terkait perkembangan dunia kerja terimakasih,9,9,saya tidak ketinggalan informasi terkait perkembangan dunia kerja terima kasih,9,10,"['saya', 'tidak', 'ketinggalan', 'informasi', 'terkait', 'perkembangan', 'dunia', 'kerja', 'terima', 'kasih']","['tidak', 'ketinggalan', 'informasi', 'terkait', 'perkembangan', 'dunia', 'kerja', 'terima', 'kasih']",10,9,1,tidak tinggal informasi kait kembang dunia kerja terima kasih,9,9
Tidak bisa verifikasi salah terus terlalu sulit,negatif,2022-06-13,2022,tidak bisa verifikasi salah terus terlalu sulit,7,7,tidak bisa verifikasi salah terus terlalu sulit,7,7,"['tidak', 'bisa', 'verifikasi', 'salah', 'terus', 'terlalu', 'sulit']","['tidak', 'verifikasi', 'salah', 'sulit']",7,4,3,tidak verifikasi salah sulit,4,4
"Parah, verifikasi captcha gagal terus. Mending pake website",negatif,2023-04-15,2023,parah verifikasi captcha gagal terus mending pake website,8,8,parah verifikasi captcha gagal terus mending pakai website,8,8,"['parah', 'verifikasi', 'captcha', 'gagal', 'terus', 'mending', 'pakai', 'website']","['parah', 'verifikasi', 'captcha', 'gagal', 'mending', 'pakai', 'website']",8,7,1,parah verifikasi captcha gagal mending pakai website,7,7
Kenapa sulit sekali untuk menambah foto profil,negatif,2020-05-31,2020,kenapa sulit sekali untuk menambah foto profil,7,7,kenapa sulit sekali untuk menambah foto profil,7,7,"['kenapa', 'sulit', 'sekali', 'untuk', 'menambah', 'foto', 'profil']","['sulit', 'menambah', 'foto', 'profil']",7,4,3,sulit tambah foto profil,4,4
Aplikasi bawaan yg tidak bisa dihapus.,negatif,2023-03-12,2023,aplikasi bawaan yg tidak bisa dihapus,6,6,aplikasi bawaan yang tidak bisa dihapus,6,6,"['aplikasi', 'bawaan', 'yang', 'tidak', 'bisa', 'dihapus']","['aplikasi', 'bawaan', 'tidak', 'dihapus']",6,4,2,aplikasi bawa tidak hapus,4,4
Sangat membantu untuk mendapatkan informasi tentang lapangan pekerjaan,positif,2022-01-17,2022,sangat membantu untuk mendapatkan informasi tentang lapangan pekerjaan,8,8,sangat membantu untuk mendapatkan informasi tentang lapangan pekerjaan,8,8,"['sangat', 'membantu', 'untuk', 'mendapatkan', 'informasi', 'tentang', 'lapangan', 'pekerjaan']","['membantu', 'informasi', 'lapangan', 'pekerjaan']",8,4,4,bantu informasi lapang kerja,4,4
"Tolong di follow up email saya sejak 3 tahun lalu, 2 tahun lalu 1 tahun yang lalu dan saat ini !!!!!!! Mohon tim ahli di perhatikan !!",negatif,2021-06-21,2021,tolong di follow up email saya sejak tahun lalu tahun lalu tahun yang lalu dan saat ini mohon tim ahli di perhatikan,27,22,tolong di follow up email saya sejak tahun lalu tahun lalu tahun yang lalu dan saat ini mohon tim ahli di perhatikan,22,22,"['tolong', 'di', 'follow', 'up', 'email', 'saya', 'sejak', 'tahun', 'lalu', 'tahun', 'lalu', 'tahun', 'yang', 'lalu', 'dan', 'saat', 'ini', 'mohon', 'tim', 'ahli', 'di', 'perhatikan']","['tolong', 'follow', 'up', 'email', 'mohon', 'tim', 'ahli', 'perhatikan']",22,8,14,tolong follow up email mohon tim ahli perhati,8,8
"Mudah2an dengan ini semua jobseeker terbantu, dpet rezeki drj LinkedIn. Amin",positif,2020-03-17,2020,mudah an dengan ini semua jobseeker terbantu dpet rezeki drj linkedin amin,11,12,mudah an dengan ini semua jobseeker membantu dapat rezeki drj linkedin aamiin,12,12,"['mudah', 'an', 'dengan', 'ini', 'semua', 'jobseeker', 'membantu', 'dapat', 'rezeki', 'drj', 'linkedin', 'aamiin']","['mudah', 'an', 'jobseeker', 'membantu', 'rezeki', 'drj', 'linkedin', 'aamiin']",12,8,4,mudah an jobseeker bantu rezeki drj linkedin aamiin,8,8
Maaf untuk verifikasi nya sudah amat agak konyol di suruh cari kudanil lihat ke atas sampe tanggan gempor gak berhasil berhasil.,negatif,2021-10-05,2021,maaf untuk verifikasi nya sudah amat agak konyol di suruh cari kudanil lihat ke atas sampe tanggan gempor gak berhasil berhasil,21,21,maaf untuk verifikasi nya sudah amat agak konyol di suruh cari kudanil lihat ke atas sampai tanggan gempor tidak berhasil berhasil,21,21,"['maaf', 'untuk', 'verifikasi', 'nya', 'sudah', 'amat', 'agak', 'konyol', 'di', 'suruh', 'cari', 'kudanil', 'lihat', 'ke', 'atas', 'sampai', 'tanggan', 'gempor', 'tidak', 'berhasil', 'berhasil']","['maaf', 'verifikasi', 'nya', 'konyol', 'suruh', 'cari', 'kudanil', 'lihat', 'tanggan', 'gempor', 'tidak', 'berhasil', 'berhasil']",21,13,8,maaf verifikasi nya konyol suruh cari kudanil lihat tanggan gempor tidak hasil hasil,13,13
Informasi tentang lowongan pekerjaan dan informasi tentang pekerjaan sangat membantu sekali,positif,2021-05-17,2021,informasi tentang lowongan pekerjaan dan informasi tentang pekerjaan sangat membantu sekali,11,11,informasi tentang lowongan pekerjaan dan informasi tentang pekerjaan sangat membantu sekali,11,11,"['informasi', 'tentang', 'lowongan', 'pekerjaan', 'dan', 'informasi', 'tentang', 'pekerjaan', 'sangat', 'membantu', 'sekali']","['informasi', 'lowongan', 'pekerjaan', 'informasi', 'pekerjaan', 'membantu']",11,6,5,informasi lowong kerja informasi kerja bantu,6,6
sangat bagus. bagi para pelamar kerja wajib inst linkedin,positif,2020-10-02,2020,sangat bagus bagi para pelamar kerja wajib inst linkedin,9,9,sangat bagus bagi para pelamar kerja wajib inst linkedin,9,9,"['sangat', 'bagus', 'bagi', 'para', 'pelamar', 'kerja', 'wajib', 'inst', 'linkedin']","['bagus', 'pelamar', 'kerja', 'wajib', 'inst', 'linkedin']",9,6,3,bagus lamar kerja wajib inst linkedin,6,6
Mantap... Sangat membantu di dunia periklanan,positif,2022-03-16,2022,mantap sangat membantu di dunia periklanan,6,6,mantap sangat membantu di dunia periklanan,6,6,"['mantap', 'sangat', 'membantu', 'di', 'dunia', 'periklanan']","['mantap', 'membantu', 'dunia', 'periklanan']",6,4,2,mantap bantu dunia iklan,4,4
Mudah mudahan dapat pekerjaan sesuai keinginan,positif,2020-06-20,2020,mudah mudahan dapat pekerjaan sesuai keinginan,6,6,mudah mudahan dapat pekerjaan sesuai keinginan,6,6,"['mudah', 'mudahan', 'dapat', 'pekerjaan', 'sesuai', 'keinginan']","['mudah', 'mudahan', 'pekerjaan', 'sesuai']",6,4,2,mudah mudah kerja sesuai,4,4
"Halo kak, kenapa email saya tidak bisa masuk ke apk ini, mohon penjelasannya?",negatif,2020-11-05,2020,halo kak kenapa email saya tidak bisa masuk ke apk ini mohon penjelasannya,13,13,halo kak kenapa email saya tidak bisa masuk ke aplikasi ini mohon penjelasannya,13,13,"['halo', 'kak', 'kenapa', 'email', 'saya', 'tidak', 'bisa', 'masuk', 'ke', 'aplikasi', 'ini', 'mohon', 'penjelasannya']","['halo', 'kak', 'email', 'tidak', 'masuk', 'aplikasi', 'mohon', 'penjelasannya']",13,8,5,halo kak email tidak masuk aplikasi mohon jelas,8,8
Sangat membantu buat temen 2 postingan supaya tidak stres apa 2 mahal apa yang kita lakukan .? Untuk jenjang anak cucu ki te,positif,2022-06-09,2022,sangat membantu buat temen postingan supaya tidak stres apa mahal apa yang kita lakukan untuk jenjang anak cucu ki te,23,20,sangat membantu buat teman postingan supaya tidak stres apa mahal apa yang kita lakukan untuk jenjang anak cucu ki te,20,20,"['sangat', 'membantu', 'buat', 'teman', 'postingan', 'supaya', 'tidak', 'stres', 'apa', 'mahal', 'apa', 'yang', 'kita', 'lakukan', 'untuk', 'jenjang', 'anak', 'cucu', 'ki', 'te']","['membantu', 'teman', 'postingan', 'tidak', 'stres', 'mahal', 'lakukan', 'jenjang', 'anak', 'cucu', 'ki', 'te']",20,12,8,bantu teman postingan tidak stres mahal laku jenjang anak cucu ki te,12,12
Sangat bagus dan baik untk persahabatan antar benua.,positif,2021-09-26,2021,sangat bagus dan baik untk persahabatan antar benua,8,8,sangat bagus dan baik untuk persahabatan antar benua,8,8,"['sangat', 'bagus', 'dan', 'baik', 'untuk', 'persahabatan', 'antar', 'benua']","['bagus', 'persahabatan', 'benua']",8,3,5,bagus sahabat benua,3,3
Bermanfaat..pada situasi seperti ini.. pada hal sudah lama pun akun in.. baru tau maaf nya.. dulu hanya di pake pas zaman kulia aj,positif,2020-07-16,2020,bermanfaat pada situasi seperti ini pada hal sudah lama pun akun in baru tau maaf nya dulu hanya di pake pas zaman kulia aj,23,24,bermanfaat pada situasi seperti ini pada hal sudah lama pun akun in baru tahu maaf nya dahulu hanya di pakai pas zaman kulia saja,24,24,"['bermanfaat', 'pada', 'situasi', 'seperti', 'ini', 'pada', 'hal', 'sudah', 'lama', 'pun', 'akun', 'in', 'baru', 'tahu', 'maaf', 'nya', 'dahulu', 'hanya', 'di', 'pakai', 'pas', 'zaman', 'kulia', 'saja']","['bermanfaat', 'situasi', 'akun', 'in', 'maaf', 'nya', 'pakai', 'pas', 'zaman', 'kulia']",24,10,14,manfaat situasi akun in maaf nya pakai pas zaman kulia,10,10
Akun saya di tutup tanpa ada penjelasan kesalahan saya dan tidak ada kejelasan kapan saya bisa menggunakan akun saya lagi,negatif,2020-03-01,2020,akun saya di tutup tanpa ada penjelasan kesalahan saya dan tidak ada kejelasan kapan saya bisa menggunakan akun saya lagi,20,20,akun saya di tutup tanpa ada penjelasan kesalahan saya dan tidak ada kejelasan kapan saya bisa menggunakan akun saya lagi,20,20,"['akun', 'saya', 'di', 'tutup', 'tanpa', 'ada', 'penjelasan', 'kesalahan', 'saya', 'dan', 'tidak', 'ada', 'kejelasan', 'kapan', 'saya', 'bisa', 'menggunakan', 'akun', 'saya', 'lagi']","['akun', 'tutup', 'penjelasan', 'kesalahan', 'tidak', 'kejelasan', 'akun']",20,7,13,akun tutup jelas salah tidak jelas akun,7,7
saya suka dengan Linkedln makin banyak conectivitas.,positif,2021-01-17,2021,saya suka dengan linkedln makin banyak conectivitas,7,7,saya suka dengan linkedln makin banyak conectivitas,7,7,"['saya', 'suka', 'dengan', 'linkedln', 'makin', 'banyak', 'conectivitas']","['suka', 'linkedln', 'conectivitas']",7,3,4,suka linkedln conectivitas,3,3
"Saya malas linkedIn kalo saya masih anak mudah, baru Dewasa dengan sudah besar",negatif,2023-04-10,2023,saya malas linkedin kalo saya masih anak mudah baru dewasa dengan sudah besar,13,13,saya malas linkedin kalau saya masih anak mudah baru dewasa dengan sudah besar,13,13,"['saya', 'malas', 'linkedin', 'kalau', 'saya', 'masih', 'anak', 'mudah', 'baru', 'dewasa', 'dengan', 'sudah', 'besar']","['malas', 'linkedin', 'anak', 'mudah', 'dewasa']",13,5,8,malas linkedin anak mudah dewasa,5,5
Sangat bagus untu k refrensi profile,positif,2022-03-20,2022,sangat bagus untu k refrensi profile,6,6,sangat bagus untu ke refrensi profile,6,6,"['sangat', 'bagus', 'untu', 'ke', 'refrensi', 'profile']","['bagus', 'untu', 'refrensi', 'profile']",6,4,2,bagus untu refrensi profile,4,4
"Aplikasi bagus, cepet gak lemot kyk aplikasi bank CI*B",positif,2021-08-25,2021,aplikasi bagus cepet gak lemot kyk aplikasi bank ci b,9,10,aplikasi bagus cepat tidak lambat seperti aplikasi bank ci biasa,10,10,"['aplikasi', 'bagus', 'cepat', 'tidak', 'lambat', 'seperti', 'aplikasi', 'bank', 'ci', 'biasa']","['aplikasi', 'bagus', 'cepat', 'tidak', 'lambat', 'aplikasi', 'bank', 'ci']",10,8,2,aplikasi bagus cepat tidak lambat aplikasi bank ci,8,8
Sangat membantu untuk membantu pencari kerja.,positif,2022-12-13,2022,sangat membantu untuk membantu pencari kerja,6,6,sangat membantu untuk membantu pencari kerja,6,6,"['sangat', 'membantu', 'untuk', 'membantu', 'pencari', 'kerja']","['membantu', 'membantu', 'pencari', 'kerja']",6,4,2,bantu bantu cari kerja,4,4
"Koq nggak bisa uninstall, bagaimana cara uninstal aplikasi Linkedin?",negatif,2021-02-01,2021,koq nggak bisa uninstall bagaimana cara uninstal aplikasi linkedin,9,9,kok tidak bisa uninstall bagaimana cara hapus instalan aplikasi linkedin,9,10,"['kok', 'tidak', 'bisa', 'uninstall', 'bagaimana', 'cara', 'hapus', 'instalan', 'aplikasi', 'linkedin']","['tidak', 'uninstall', 'hapus', 'instalan', 'aplikasi', 'linkedin']",10,6,4,tidak uninstall hapus instalan aplikasi linkedin,6,6
Dengan adanya linked sangat berguna sekali,positif,2021-04-30,2021,dengan adanya linked sangat berguna sekali,6,6,dengan adanya linked sangat berguna sekali,6,6,"['dengan', 'adanya', 'linked', 'sangat', 'berguna', 'sekali']","['linked', 'berguna']",6,2,4,linked guna,2,2
"Linkedln aplikasi terbaik , pertahankan kwalitas ,,,",positif,2021-08-04,2021,linkedln aplikasi terbaik pertahankan kwalitas,7,5,linkedln aplikasi terbaik pertahankan kualitas,5,5,"['linkedln', 'aplikasi', 'terbaik', 'pertahankan', 'kualitas']","['linkedln', 'aplikasi', 'terbaik', 'pertahankan', 'kualitas']",5,5,0,linkedln aplikasi baik tahan kualitas,5,5
Sangat membantu untuk memperluas jaringan bisnis,positif,2020-06-09,2020,sangat membantu untuk memperluas jaringan bisnis,6,6,sangat membantu untuk memperluas jaringan bisnis,6,6,"['sangat', 'membantu', 'untuk', 'memperluas', 'jaringan', 'bisnis']","['membantu', 'memperluas', 'jaringan', 'bisnis']",6,4,2,bantu luas jaring bisnis,4,4
Sangat bagus untuk para job seeker,positif,2022-06-06,2022,sangat bagus untuk para job seeker,6,6,sangat bagus untuk para kerja seeker,6,6,"['sangat', 'bagus', 'untuk', 'para', 'kerja', 'seeker']","['bagus', 'kerja', 'seeker']",6,3,3,bagus kerja seeker,3,3
Parah si.. verifikasinya gagal terus padahal udh pencet yg bener bgtu aja terus sampe gw emosian..knp si nyashin..,negatif,2022-03-13,2022,parah si verifikasinya gagal terus padahal udh pencet yg bener bgtu aja terus sampe gw emosian knp si nyashin,18,19,parah sih verifikasinya gagal terus padahal sudah tekan yang benar begitu saja terus sampai saya emosian kenapa sih nyashin,19,19,"['parah', 'sih', 'verifikasinya', 'gagal', 'terus', 'padahal', 'sudah', 'tekan', 'yang', 'benar', 'begitu', 'saja', 'terus', 'sampai', 'saya', 'emosian', 'kenapa', 'sih', 'nyashin']","['parah', 'sih', 'verifikasinya', 'gagal', 'tekan', 'emosian', 'sih', 'nyashin']",19,8,11,parah sih verifikasi gagal tekan emosi sih nyashin,8,8
Sangat bagus utk menambah pengalaman dan berkenalan dengan para pemilik perusahaan maupun para manager,positif,2021-02-13,2021,sangat bagus utk menambah pengalaman dan berkenalan dengan para pemilik perusahaan maupun para manager,14,14,sangat bagus untuk menambah pengalaman dan berkenalan dengan para pemilik perusahaan maupun para manager,14,14,"['sangat', 'bagus', 'untuk', 'menambah', 'pengalaman', 'dan', 'berkenalan', 'dengan', 'para', 'pemilik', 'perusahaan', 'maupun', 'para', 'manager']","['bagus', 'menambah', 'pengalaman', 'berkenalan', 'pemilik', 'perusahaan', 'manager']",14,7,7,bagus tambah alam nal milik usaha manager,7,7
Aplikasi yg sangat mendukung informasi peluang pekerjaan saya 👍,positif,2020-05-23,2020,aplikasi yg sangat mendukung informasi peluang pekerjaan saya,9,8,aplikasi yang sangat mendukung informasi peluang pekerjaan saya,8,8,"['aplikasi', 'yang', 'sangat', 'mendukung', 'informasi', 'peluang', 'pekerjaan', 'saya']","['aplikasi', 'mendukung', 'informasi', 'peluang', 'pekerjaan']",8,5,3,aplikasi dukung informasi peluang kerja,5,5
Aplikasi ga jelas ... Mau login aja mesti verifikasi gambar yg ga jelas,negatif,2022-02-18,2022,aplikasi ga jelas mau login aja mesti verifikasi gambar yg ga jelas,13,12,aplikasi tidak jelas mau login saja mesti verifikasi gambar yang tidak jelas,12,12,"['aplikasi', 'tidak', 'jelas', 'mau', 'login', 'saja', 'mesti', 'verifikasi', 'gambar', 'yang', 'tidak', 'jelas']","['aplikasi', 'tidak', 'login', 'mesti', 'verifikasi', 'gambar', 'tidak']",12,7,5,aplikasi tidak login mesti verifikasi gambar tidak,7,7
Kenapa sih pas lengkapi profil gagal terus,negatif,2021-02-01,2021,kenapa sih pas lengkapi profil gagal terus,7,7,kenapa sih pas lengkapi profil gagal terus,7,7,"['kenapa', 'sih', 'pas', 'lengkapi', 'profil', 'gagal', 'terus']","['sih', 'pas', 'lengkapi', 'profil', 'gagal']",7,5,2,sih pas lengkap profil gagal,5,5
Bagus sangat membantu informasi pencari kerja,positif,2023-04-21,2023,bagus sangat membantu informasi pencari kerja,6,6,bagus sangat membantu informasi pencari kerja,6,6,"['bagus', 'sangat', 'membantu', 'informasi', 'pencari', 'kerja']","['bagus', 'membantu', 'informasi', 'pencari', 'kerja']",6,5,1,bagus bantu informasi cari kerja,5,5
Okelah kalo begitu mantap keren banget bos,positif,2023-04-22,2023,okelah kalo begitu mantap keren banget bos,7,7,okelah kalau begitu mantap keren banget box,7,7,"['okelah', 'kalau', 'begitu', 'mantap', 'keren', 'banget', 'box']","['okelah', 'mantap', 'keren', 'banget', 'box']",7,5,2,oke mantap keren banget box,5,5
"Saya tidak bisa masuk, selalu verivikasi gambar terus",negatif,2022-05-08,2022,saya tidak bisa masuk selalu verivikasi gambar terus,8,8,saya tidak bisa masuk selalu verivikasi gambar terus,8,8,"['saya', 'tidak', 'bisa', 'masuk', 'selalu', 'verivikasi', 'gambar', 'terus']","['tidak', 'masuk', 'verivikasi', 'gambar']",8,4,4,tidak masuk verivikasi gambar,4,4
"Tempat saling bertukar pengalaman, informasi pekerjaan, dan relasi",positif,2020-06-10,2020,tempat saling bertukar pengalaman informasi pekerjaan dan relasi,8,8,tempat saling bertukar pengalaman informasi pekerjaan dan relasi,8,8,"['tempat', 'saling', 'bertukar', 'pengalaman', 'informasi', 'pekerjaan', 'dan', 'relasi']","['bertukar', 'pengalaman', 'informasi', 'pekerjaan', 'relasi']",8,5,3,tukar alam informasi kerja relasi,5,5
"luar biasa untuk pengembangan ,tapi sayang saya sudah kerja",positif,2022-04-14,2022,luar biasa untuk pengembangan tapi sayang saya sudah kerja,9,9,luar biasa untuk pengembangan tapi sayang saya sudah kerja,9,9,"['luar', 'biasa', 'untuk', 'pengembangan', 'tapi', 'sayang', 'saya', 'sudah', 'kerja']","['pengembangan', 'sayang', 'kerja']",9,3,6,kembang sayang kerja,3,3
Sangat membantu bagi para pejuang amplop coklat.,positif,2021-06-01,2021,sangat membantu bagi para pejuang amplop coklat,7,7,sangat membantu bagi para pejuang amplop coklat,7,7,"['sangat', 'membantu', 'bagi', 'para', 'pejuang', 'amplop', 'coklat']","['membantu', 'pejuang', 'amplop', 'coklat']",7,4,3,bantu juang amplop coklat,4,4
Baru mau daftar udh hampir setengahnya cuma verifikasi keamanan aja. Hadeuh,negatif,2021-01-01,2021,baru mau daftar udh hampir setengahnya cuma verifikasi keamanan aja hadeuh,11,11,baru mau daftar sudah hampir setengahnya cuma verifikasi keamanan saja hadeuh,11,11,"['baru', 'mau', 'daftar', 'sudah', 'hampir', 'setengahnya', 'cuma', 'verifikasi', 'keamanan', 'saja', 'hadeuh']","['daftar', 'setengahnya', 'verifikasi', 'keamanan', 'hadeuh']",11,5,6,daftar tengah verifikasi aman hadeuh,5,5
Sangat membantu sekali melihat peluang peluang bisnis d dunia digital.,positif,2020-01-28,2020,sangat membantu sekali melihat peluang peluang bisnis d dunia digital,10,10,sangat membantu sekali melihat peluang peluang bisnis di dunia digital,10,10,"['sangat', 'membantu', 'sekali', 'melihat', 'peluang', 'peluang', 'bisnis', 'di', 'dunia', 'digital']","['membantu', 'peluang', 'peluang', 'bisnis', 'dunia', 'digital']",10,6,4,bantu peluang peluang bisnis dunia digital,6,6
Aplikasi buang2 waktu verifikasi nya!!!,negatif,2022-06-13,2022,aplikasi buang waktu verifikasi nya,5,5,aplikasi buang waktu verifikasi nya,5,5,"['aplikasi', 'buang', 'waktu', 'verifikasi', 'nya']","['aplikasi', 'buang', 'verifikasi', 'nya']",5,4,1,aplikasi buang verifikasi nya,4,4
Terlalu ribet skip udah kaya aplikasi jadul,negatif,2022-12-11,2022,terlalu ribet skip udah kaya aplikasi jadul,7,7,terlalu rumit skip sudah kayak aplikasi jadul,7,7,"['terlalu', 'rumit', 'skip', 'sudah', 'kayak', 'aplikasi', 'jadul']","['rumit', 'skip', 'kayak', 'aplikasi', 'jadul']",7,5,2,rumit skip kayak aplikasi jadul,5,5
Bagus utk mereka yg semngt utk mncri pekerjaan,positif,2022-10-18,2022,bagus utk mereka yg semngt utk mncri pekerjaan,8,8,bagus untuk mereka yang semngt untuk mncri pekerjaan,8,8,"['bagus', 'untuk', 'mereka', 'yang', 'semngt', 'untuk', 'mncri', 'pekerjaan']","['bagus', 'semngt', 'mncri', 'pekerjaan']",8,4,4,bagus semngt mncri kerja,4,4
Sangat membantu dan lengkap informasinya,positif,2020-12-09,2020,sangat membantu dan lengkap informasinya,5,5,sangat membantu dan lengkap informasinya,5,5,"['sangat', 'membantu', 'dan', 'lengkap', 'informasinya']","['membantu', 'lengkap', 'informasinya']",5,3,2,bantu lengkap informasi,3,3
Berkualitas dan profesional,positif,2020-03-23,2020,berkualitas dan profesional,3,3,berkualitas dan profesional,3,3,"['berkualitas', 'dan', 'profesional']","['berkualitas', 'profesional']",3,2,1,kualitas profesional,2,2
Sangat membantu buat para jobseker 👍,positif,2020-09-19,2020,sangat membantu buat para jobseker,6,5,sangat membantu buat para jobseker,5,5,"['sangat', 'membantu', 'buat', 'para', 'jobseker']","['membantu', 'jobseker']",5,2,3,bantu jobseker,2,2
Bagus jaringan luas jadi menambah relasi lagi,positif,2023-12-06,2023,bagus jaringan luas jadi menambah relasi lagi,7,7,bagus jaringan luas jadi menambah relasi lagi,7,7,"['bagus', 'jaringan', 'luas', 'jadi', 'menambah', 'relasi', 'lagi']","['bagus', 'jaringan', 'luas', 'menambah', 'relasi']",7,5,2,bagus jaring luas tambah relasi,5,5
Mau registrasi sulit...proses verifikasi tidak berjalan.,negatif,2023-12-12,2023,mau registrasi sulit proses verifikasi tidak berjalan,6,7,mau registrasi sulit proses verifikasi tidak berjalan,7,7,"['mau', 'registrasi', 'sulit', 'proses', 'verifikasi', 'tidak', 'berjalan']","['registrasi', 'sulit', 'proses', 'verifikasi', 'tidak', 'berjalan']",7,6,1,registrasi sulit proses verifikasi tidak jalan,6,6
Gakbisa buat daftar sekian maksih langsung gua uninstall,negatif,2022-07-25,2022,gakbisa buat daftar sekian maksih langsung gua uninstall,8,8,gakbisa buat daftar sekian terima kasih langsung saya uninstall,8,9,"['gakbisa', 'buat', 'daftar', 'sekian', 'terima', 'kasih', 'langsung', 'saya', 'uninstall']","['gakbisa', 'daftar', 'sekian', 'terima', 'kasih', 'langsung', 'uninstall']",9,7,2,gakbisa daftar sekian terima kasih langsung uninstall,7,7
Saya beri reting satu yah soalnya saya gak bisa login tolong dong defeloper gimana ini solusinya,negatif,2020-09-12,2020,saya beri reting satu yah soalnya saya gak bisa login tolong dong defeloper gimana ini solusinya,16,16,saya beri reting satu ya soalnya saya tidak bisa login tolong dong defeloper bagaimana ini solusinya,16,16,"['saya', 'beri', 'reting', 'satu', 'ya', 'soalnya', 'saya', 'tidak', 'bisa', 'login', 'tolong', 'dong', 'defeloper', 'bagaimana', 'ini', 'solusinya']","['reting', 'ya', 'tidak', 'login', 'tolong', 'defeloper', 'solusinya']",16,7,9,reting ya tidak login tolong defeloper solusi,7,7
"Ribet daftar nya,,,baru juga nyari lowongan kerja aja udah di persulit,. RIBET NYA DI INDONESIA",negatif,2022-02-03,2022,ribet daftar nya baru juga nyari lowongan kerja aja udah di persulit ribet nya di indonesia,15,16,rumit daftar nya baru juga mencari lowongan kerja saja sudah di persulit rumit nya di indonesia,16,16,"['rumit', 'daftar', 'nya', 'baru', 'juga', 'mencari', 'lowongan', 'kerja', 'saja', 'sudah', 'di', 'persulit', 'rumit', 'nya', 'di', 'indonesia']","['rumit', 'daftar', 'nya', 'mencari', 'lowongan', 'kerja', 'persulit', 'rumit', 'nya', 'indonesia']",16,10,6,rumit daftar nya cari lowong kerja sulit rumit nya indonesia,10,10
Sangat membantu dalam mencari lapangan pekerjaan dan bisnis,positif,2022-05-23,2022,sangat membantu dalam mencari lapangan pekerjaan dan bisnis,8,8,sangat membantu dalam mencari lapangan pekerjaan dan bisnis,8,8,"['sangat', 'membantu', 'dalam', 'mencari', 'lapangan', 'pekerjaan', 'dan', 'bisnis']","['membantu', 'mencari', 'lapangan', 'pekerjaan', 'bisnis']",8,5,3,bantu cari lapang kerja bisnis,5,5
"Saya disuruh verifikasi keamanan dan sudah dilakukan dengan foto KTP berulang kali padahal seluruh tulisan sudah jelas, Tolong perbaiki kembali sistem verifikasi yang sangat buruk ini",negatif,2024-01-09,2024,saya disuruh verifikasi keamanan dan sudah dilakukan dengan foto ktp berulang kali padahal seluruh tulisan sudah jelas tolong perbaiki kembali sistem verifikasi yang sangat buruk ini,26,26,saya disuruh verifikasi keamanan dan sudah dilakukan dengan foto ktp berulang kali padahal seluruh tulisan sudah jelas tolong perbaikan kembali sistem verifikasi yang sangat buruk ini,26,26,"['saya', 'disuruh', 'verifikasi', 'keamanan', 'dan', 'sudah', 'dilakukan', 'dengan', 'foto', 'ktp', 'berulang', 'kali', 'padahal', 'seluruh', 'tulisan', 'sudah', 'jelas', 'tolong', 'perbaikan', 'kembali', 'sistem', 'verifikasi', 'yang', 'sangat', 'buruk', 'ini']","['disuruh', 'verifikasi', 'keamanan', 'foto', 'ktp', 'berulang', 'kali', 'tulisan', 'tolong', 'perbaikan', 'sistem', 'verifikasi', 'buruk']",26,13,13,suruh verifikasi aman foto ktp ulang kali tulis tolong baik sistem verifikasi buruk,13,13
Keren i like it. Tapi saat diterima atau ditolak gimana? Masih kurang paham sama Linkedin,positif,2020-05-22,2020,keren i like it tapi saat diterima atau ditolak gimana masih kurang paham sama linkedin,15,15,keren i like it tapi saat diterima atau ditolak bagaimana masih kurang paham sama linkedin,15,15,"['keren', 'i', 'like', 'it', 'tapi', 'saat', 'diterima', 'atau', 'ditolak', 'bagaimana', 'masih', 'kurang', 'paham', 'sama', 'linkedin']","['keren', 'i', 'like', 'it', 'diterima', 'ditolak', 'paham', 'linkedin']",15,8,7,keren i like it terima tolak paham linkedin,8,8
Mantap jaringan bisnis dan pekerjaan nya,positif,2020-11-05,2020,mantap jaringan bisnis dan pekerjaan nya,6,6,mantap jaringan bisnis dan pekerjaan nya,6,6,"['mantap', 'jaringan', 'bisnis', 'dan', 'pekerjaan', 'nya']","['mantap', 'jaringan', 'bisnis', 'pekerjaan', 'nya']",6,5,1,mantap jaring bisnis kerja nya,5,5
Sangat kecewa. Mau login tetapi akun saya di nonaktifkan,negatif,2020-01-02,2020,sangat kecewa mau login tetapi akun saya di nonaktifkan,9,9,sangat kecewa mau login tetapi akun saya di nonaktifkan,9,9,"['sangat', 'kecewa', 'mau', 'login', 'tetapi', 'akun', 'saya', 'di', 'nonaktifkan']","['kecewa', 'login', 'akun', 'nonaktifkan']",9,4,5,kecewa login akun nonaktif,4,4
Tidak bisa membuka pesan,negatif,2021-02-19,2021,tidak bisa membuka pesan,4,4,tidak bisa membuka pesan,4,4,"['tidak', 'bisa', 'membuka', 'pesan']","['tidak', 'membuka', 'pesan']",4,3,1,tidak buka pesan,3,3
untuk koneksi bisnis sangat bagus,positif,2022-02-08,2022,untuk koneksi bisnis sangat bagus,5,5,untuk koneksi bisnis sangat bagus,5,5,"['untuk', 'koneksi', 'bisnis', 'sangat', 'bagus']","['koneksi', 'bisnis', 'bagus']",5,3,2,koneksi bisnis bagus,3,3
"Kenapa mw update, ga bisa2... disuruh coba lagi terus2an, 😪",negatif,2022-08-28,2022,kenapa mw update ga bisa disuruh coba lagi terus an,10,10,kenapa mau diperbarui tidak bisa disuruh coba lagi terus an,10,10,"['kenapa', 'mau', 'diperbarui', 'tidak', 'bisa', 'disuruh', 'coba', 'lagi', 'terus', 'an']","['diperbarui', 'tidak', 'disuruh', 'coba', 'an']",10,5,5,baru tidak suruh coba an,5,5
"Sangat bermanfaat ,mohon lebih ditingkatkan",positif,2021-03-02,2021,sangat bermanfaat mohon lebih ditingkatkan,5,5,sangat bermanfaat mohon lebih ditingkatkan,5,5,"['sangat', 'bermanfaat', 'mohon', 'lebih', 'ditingkatkan']","['bermanfaat', 'mohon', 'ditingkatkan']",5,3,2,manfaat mohon tingkat,3,3
"Sangat bermanfaat untuk dapat info yang tepat untuk saya, Terimakasih",positif,2020-07-20,2020,sangat bermanfaat untuk dapat info yang tepat untuk saya terimakasih,10,10,sangat bermanfaat untuk dapat informasi yang tepat untuk saya terima kasih,10,11,"['sangat', 'bermanfaat', 'untuk', 'dapat', 'informasi', 'yang', 'tepat', 'untuk', 'saya', 'terima', 'kasih']","['bermanfaat', 'informasi', 'terima', 'kasih']",11,4,7,manfaat informasi terima kasih,4,4
Dengan ini saya bisa melihat informasi lebih lengkap dan jelas,positif,2021-04-19,2021,dengan ini saya bisa melihat informasi lebih lengkap dan jelas,10,10,dengan ini saya bisa melihat informasi lebih lengkap dan jelas,10,10,"['dengan', 'ini', 'saya', 'bisa', 'melihat', 'informasi', 'lebih', 'lengkap', 'dan', 'jelas']","['informasi', 'lengkap']",10,2,8,informasi lengkap,2,2
Mantap gan.. Aplikasi info loker gan...,positif,2020-12-04,2020,mantap gan aplikasi info loker gan,6,6,mantap juragan aplikasi informasi loker juragan,6,6,"['mantap', 'juragan', 'aplikasi', 'informasi', 'loker', 'juragan']","['mantap', 'juragan', 'aplikasi', 'informasi', 'loker', 'juragan']",6,6,0,mantap juragan aplikasi informasi loker juragan,6,6
Aplikasi ini sangat membantu banyak orang dalam mencari kerja.,positif,2023-11-16,2023,aplikasi ini sangat membantu banyak orang dalam mencari kerja,9,9,aplikasi ini sangat membantu banyak orang dalam mencari kerja,9,9,"['aplikasi', 'ini', 'sangat', 'membantu', 'banyak', 'orang', 'dalam', 'mencari', 'kerja']","['aplikasi', 'membantu', 'orang', 'mencari', 'kerja']",9,5,4,aplikasi bantu orang cari kerja,5,5
"Aplikasi ini sangat membantu, terimakasih linkedln",positif,2021-09-17,2021,aplikasi ini sangat membantu terimakasih linkedln,6,6,aplikasi ini sangat membantu terima kasih linkedln,6,7,"['aplikasi', 'ini', 'sangat', 'membantu', 'terima', 'kasih', 'linkedln']","['aplikasi', 'membantu', 'terima', 'kasih', 'linkedln']",7,5,2,aplikasi bantu terima kasih linkedln,5,5
Tidak bisa verifikasi mohon segera di perbaiki terimakasih,negatif,2023-05-10,2023,tidak bisa verifikasi mohon segera di perbaiki terimakasih,8,8,tidak bisa verifikasi mohon segera di perbaikan terima kasih,8,9,"['tidak', 'bisa', 'verifikasi', 'mohon', 'segera', 'di', 'perbaikan', 'terima', 'kasih']","['tidak', 'verifikasi', 'mohon', 'perbaikan', 'terima', 'kasih']",9,6,3,tidak verifikasi mohon baik terima kasih,6,6
Cukup baik untuk working link,positif,2020-01-16,2020,cukup baik untuk working link,5,5,cukup baik untuk working link,5,5,"['cukup', 'baik', 'untuk', 'working', 'link']","['working', 'link']",5,2,3,working link,2,2
"Aplikasi kntl, daftar saja ngak bisa"" ...juh",negatif,2022-07-06,2022,aplikasi kntl daftar saja ngak bisa juh,7,7,aplikasi bodoh daftar saja tidak bisa juh,7,7,"['aplikasi', 'bodoh', 'daftar', 'saja', 'tidak', 'bisa', 'juh']","['aplikasi', 'bodoh', 'daftar', 'tidak', 'juh']",7,5,2,aplikasi bodoh daftar tidak juh,5,5
"Ngerjain org ! verifikasi smpe sejam dh slesai ,tapi d ulang "" terusss ,jelek banget aplksi nyaaaaaaaaaa ❗❗❗",negatif,2023-05-17,2023,ngerjain org verifikasi smpe sejam dh slesai tapi d ulang terusss jelek banget aplksi nyaaaaaaaaaa,18,15,ngerjain orang verifikasi sampai sejam sudah selesai tapi di ulang terusss jelek banget aplksi nyaaaaaaaaaa,15,15,"['ngerjain', 'orang', 'verifikasi', 'sampai', 'sejam', 'sudah', 'selesai', 'tapi', 'di', 'ulang', 'terusss', 'jelek', 'banget', 'aplksi', 'nyaaaaaaaaaa']","['ngerjain', 'orang', 'verifikasi', 'sejam', 'selesai', 'ulang', 'terusss', 'jelek', 'banget', 'aplksi', 'nyaaaaaaaaaa']",15,11,4,ngerjain orang verifikasi jam selesai ulang terusss jelek banget aplksi nyaaaaaaaaaa,11,11
Aplikasi ga jelas penggunaan ribet. Developer webnya anak magang pasti,negatif,2020-06-02,2020,aplikasi ga jelas penggunaan ribet developer webnya anak magang pasti,10,10,aplikasi tidak jelas penggunaan rumit developer webnya anak magang pasti,10,10,"['aplikasi', 'tidak', 'jelas', 'penggunaan', 'rumit', 'developer', 'webnya', 'anak', 'magang', 'pasti']","['aplikasi', 'tidak', 'penggunaan', 'rumit', 'developer', 'webnya', 'anak', 'magang']",10,8,2,aplikasi tidak guna rumit developer webnya anak magang,8,8
"mau login aja susah,padahal pasword sudah benar tapi mengapa harus memasukan kode lagi?",negatif,2023-02-03,2023,mau login aja susah padahal pasword sudah benar tapi mengapa harus memasukan kode lagi,13,14,mau login saja susah padahal pasword sudah benar tapi mengapa harus memasukkan kode lagi,14,14,"['mau', 'login', 'saja', 'susah', 'padahal', 'pasword', 'sudah', 'benar', 'tapi', 'mengapa', 'harus', 'memasukkan', 'kode', 'lagi']","['login', 'susah', 'pasword', 'memasukkan', 'kode']",14,5,9,login susah pasword masuk kode,5,5
"Aplikasi ini mempermudah saya dlm pencarian loker, trimakasih.",positif,2023-05-27,2023,aplikasi ini mempermudah saya dlm pencarian loker trimakasih,8,8,aplikasi ini mempermudah saya dalam pencarian loker terima kasih,8,9,"['aplikasi', 'ini', 'mempermudah', 'saya', 'dalam', 'pencarian', 'loker', 'terima', 'kasih']","['aplikasi', 'mempermudah', 'pencarian', 'loker', 'terima', 'kasih']",9,6,3,aplikasi mudah cari loker terima kasih,6,6
Aplikasi yang mendidik. Patut di apresiasi..,positif,2021-09-18,2021,aplikasi yang mendidik patut di apresiasi,6,6,aplikasi yang mendidik patut di apresiasi,6,6,"['aplikasi', 'yang', 'mendidik', 'patut', 'di', 'apresiasi']","['aplikasi', 'mendidik', 'patut', 'apresiasi']",6,4,2,aplikasi didik patut apresiasi,4,4
gajelas daftar gabisa ngapain dibikin ini aplikasi,negatif,2021-11-13,2021,gajelas daftar gabisa ngapain dibikin ini aplikasi,7,7,tidak jelas daftar tidak bisa buat apa dibikin ini aplikasi,7,10,"['tidak', 'jelas', 'daftar', 'tidak', 'bisa', 'buat', 'apa', 'dibikin', 'ini', 'aplikasi']","['tidak', 'daftar', 'tidak', 'dibikin', 'aplikasi']",10,5,5,tidak daftar tidak bikin aplikasi,5,5
Kurang axes dengan pembaca layar.,negatif,2020-10-29,2020,kurang axes dengan pembaca layar,5,5,kurang axes dengan pembaca layar,5,5,"['kurang', 'axes', 'dengan', 'pembaca', 'layar']","['axes', 'pembaca', 'layar']",5,3,2,axes baca layar,3,3
Admin akun saya nonaktif kenapa ya? Pdahal gk ngapa2in cman apply kerja aja tolong bantuannya...,negatif,2021-08-28,2021,admin akun saya nonaktif kenapa ya pdahal gk ngapa in cman apply kerja aja tolong bantuannya,15,16,admin akun saya nonaktif kenapa ya pdahal tidak ngapa in cman apply kerja saja tolong bantuannya,16,16,"['admin', 'akun', 'saya', 'nonaktif', 'kenapa', 'ya', 'pdahal', 'tidak', 'ngapa', 'in', 'cman', 'apply', 'kerja', 'saja', 'tolong', 'bantuannya']","['admin', 'akun', 'nonaktif', 'ya', 'pdahal', 'tidak', 'ngapa', 'in', 'cman', 'apply', 'kerja', 'tolong', 'bantuannya']",16,13,3,admin akun nonaktif ya pdahal tidak ngapa in cman apply kerja tolong bantu,13,13
Sangat bersih dan cerah,positif,2020-03-02,2020,sangat bersih dan cerah,4,4,sangat bersih dan cerah,4,4,"['sangat', 'bersih', 'dan', 'cerah']","['bersih', 'cerah']",4,2,2,bersih cerah,2,2
Sangat membantu dalam mencari informasi lowongan pekerjaan,positif,2022-02-24,2022,sangat membantu dalam mencari informasi lowongan pekerjaan,7,7,sangat membantu dalam mencari informasi lowongan pekerjaan,7,7,"['sangat', 'membantu', 'dalam', 'mencari', 'informasi', 'lowongan', 'pekerjaan']","['membantu', 'mencari', 'informasi', 'lowongan', 'pekerjaan']",7,5,2,bantu cari informasi lowong kerja,5,5
Aplikasi gajelas.. registrasi ajaa ribet SMS ga muncul mucul,negatif,2022-10-05,2022,aplikasi gajelas registrasi ajaa ribet sms ga muncul mucul,9,9,aplikasi tidak jelas registrasi ajaa rumit sms tidak muncul mucul,9,10,"['aplikasi', 'tidak', 'jelas', 'registrasi', 'ajaa', 'rumit', 'sms', 'tidak', 'muncul', 'mucul']","['aplikasi', 'tidak', 'registrasi', 'ajaa', 'rumit', 'sms', 'tidak', 'muncul', 'mucul']",10,9,1,aplikasi tidak registrasi ajaa rumit sms tidak muncul mucul,9,9
Memperluas jangkauan untuk mendapatkan penawaran pekerjaan,positif,2021-03-09,2021,memperluas jangkauan untuk mendapatkan penawaran pekerjaan,6,6,memperluas jangkauan untuk mendapatkan penawaran pekerjaan,6,6,"['memperluas', 'jangkauan', 'untuk', 'mendapatkan', 'penawaran', 'pekerjaan']","['memperluas', 'jangkauan', 'penawaran', 'pekerjaan']",6,4,2,luas jangkau tawar kerja,4,4
Sangat membantu untuk saya yang sedang mencari perkerjaan.,positif,2020-09-14,2020,sangat membantu untuk saya yang sedang mencari perkerjaan,8,8,sangat membantu untuk saya yang sedang mencari perkerjaan,8,8,"['sangat', 'membantu', 'untuk', 'saya', 'yang', 'sedang', 'mencari', 'perkerjaan']","['membantu', 'mencari', 'perkerjaan']",8,3,5,bantu cari kerja,3,3
Ga diupgrade ga bisa dibuka aplikasinya,negatif,2021-10-08,2021,ga diupgrade ga bisa dibuka aplikasinya,6,6,tidak diupgrade tidak bisa dibuka aplikasi nya,6,7,"['tidak', 'diupgrade', 'tidak', 'bisa', 'dibuka', 'aplikasi', 'nya']","['tidak', 'diupgrade', 'tidak', 'dibuka', 'aplikasi', 'nya']",7,6,1,tidak diupgrade tidak buka aplikasi nya,6,6
Sippp... Untuk mendapat update info pekerjaan baru,positif,2021-05-06,2021,sippp untuk mendapat update info pekerjaan baru,7,7,sippp untuk mendapat diperbarui informasi pekerjaan baru,7,7,"['sippp', 'untuk', 'mendapat', 'diperbarui', 'informasi', 'pekerjaan', 'baru']","['sippp', 'diperbarui', 'informasi', 'pekerjaan']",7,4,3,sippp baru informasi kerja,4,4
Saya sangat suka banget applikasih ini. Semoga semakin hari dan semoga semakin tahun maju terus yah,positif,2022-01-29,2022,saya sangat suka banget applikasih ini semoga semakin hari dan semoga semakin tahun maju terus yah,16,16,saya sangat suka banget applikasih ini semoga semakin hari dan semoga semakin tahun maju terus ya,16,16,"['saya', 'sangat', 'suka', 'banget', 'applikasih', 'ini', 'semoga', 'semakin', 'hari', 'dan', 'semoga', 'semakin', 'tahun', 'maju', 'terus', 'ya']","['suka', 'banget', 'applikasih', 'semoga', 'semoga', 'maju', 'ya']",16,7,9,suka banget applikasih moga moga maju ya,7,7
Baru download gabisa masuk/daftar Aplikasi gila,negatif,2023-06-02,2023,baru download gabisa masuk daftar aplikasi gila,6,7,baru unduh tidak bisa masuk daftar aplikasi gila,7,8,"['baru', 'unduh', 'tidak', 'bisa', 'masuk', 'daftar', 'aplikasi', 'gila']","['unduh', 'tidak', 'masuk', 'daftar', 'aplikasi', 'gila']",8,6,2,unduh tidak masuk daftar aplikasi gila,6,6
Sangat membantu proses mencari kerja,positif,2022-02-14,2022,sangat membantu proses mencari kerja,5,5,sangat membantu proses mencari kerja,5,5,"['sangat', 'membantu', 'proses', 'mencari', 'kerja']","['membantu', 'proses', 'mencari', 'kerja']",5,4,1,bantu proses cari kerja,4,4
"Aplikasi yang bagus, untuk berhubungan dengan orang orang dsri berbagai perusahaan",positif,2023-01-05,2023,aplikasi yang bagus untuk berhubungan dengan orang orang dsri berbagai perusahaan,11,11,aplikasi yang bagus untuk berhubungan dengan orang orang dsri berbagai perusahaan,11,11,"['aplikasi', 'yang', 'bagus', 'untuk', 'berhubungan', 'dengan', 'orang', 'orang', 'dsri', 'berbagai', 'perusahaan']","['aplikasi', 'bagus', 'berhubungan', 'orang', 'orang', 'dsri', 'perusahaan']",11,7,4,aplikasi bagus hubung orang orang dsri usaha,7,7
"Saya baru saja down load aplikasi ini, mudah2 saya banyak dapat kemudahan",positif,2022-02-04,2022,saya baru saja down load aplikasi ini mudah saya banyak dapat kemudahan,12,12,saya baru saja down load aplikasi ini mudah saya banyak dapat kemudahan,12,12,"['saya', 'baru', 'saja', 'down', 'load', 'aplikasi', 'ini', 'mudah', 'saya', 'banyak', 'dapat', 'kemudahan']","['down', 'load', 'aplikasi', 'mudah', 'kemudahan']",12,5,7,down load aplikasi mudah mudah,5,5
Kenapa dalam memberikan kode verifikasi lupa sandi membutuhkan waktu yang cukup lama? Sangat membuang banyak waktu,negatif,2023-03-23,2023,kenapa dalam memberikan kode verifikasi lupa sandi membutuhkan waktu yang cukup lama sangat membuang banyak waktu,16,16,kenapa dalam memberikan kode verifikasi lupa sandi membutuhkan waktu yang cukup lama sangat membuang banyak waktu,16,16,"['kenapa', 'dalam', 'memberikan', 'kode', 'verifikasi', 'lupa', 'sandi', 'membutuhkan', 'waktu', 'yang', 'cukup', 'lama', 'sangat', 'membuang', 'banyak', 'waktu']","['kode', 'verifikasi', 'lupa', 'sandi', 'membutuhkan', 'membuang']",16,6,10,kode verifikasi lupa sandi butuh buang,6,6
Aplikasi oke banget. Sukses selalu LinkedIn,positif,2021-12-06,2021,aplikasi oke banget sukses selalu linkedin,6,6,aplikasi oke banget sukses selalu linkedin,6,6,"['aplikasi', 'oke', 'banget', 'sukses', 'selalu', 'linkedin']","['aplikasi', 'oke', 'banget', 'sukses', 'linkedin']",6,5,1,aplikasi oke banget sukses linkedin,5,5
"Aplikasinya bagus sekali, sanganf membantu untuk info² loker",positif,2021-11-27,2021,aplikasinya bagus sekali sanganf membantu untuk info² loker,8,8,aplikasi nya bagus sekali sanganf membantu untuk info² loker,8,9,"['aplikasi', 'nya', 'bagus', 'sekali', 'sanganf', 'membantu', 'untuk', 'info²', 'loker']","['aplikasi', 'nya', 'bagus', 'sanganf', 'membantu', 'info²', 'loker']",9,7,2,aplikasi nya bagus sanganf bantu info loker,7,7
Tolong dong keamanan verifikasi nya eror jadi susah masuk,negatif,2022-09-12,2022,tolong dong keamanan verifikasi nya eror jadi susah masuk,9,9,tolong dong keamanan verifikasi nya error jadi susah masuk,9,9,"['tolong', 'dong', 'keamanan', 'verifikasi', 'nya', 'error', 'jadi', 'susah', 'masuk']","['tolong', 'keamanan', 'verifikasi', 'nya', 'error', 'susah', 'masuk']",9,7,2,tolong aman verifikasi nya error susah masuk,7,7
Mau cari informasi tentang kerja dan lowongan..ini jawaban nya.,positif,2020-07-29,2020,mau cari informasi tentang kerja dan lowongan ini jawaban nya,9,10,mau cari informasi tentang kerja dan lowongan ini jawaban nya,10,10,"['mau', 'cari', 'informasi', 'tentang', 'kerja', 'dan', 'lowongan', 'ini', 'jawaban', 'nya']","['cari', 'informasi', 'kerja', 'lowongan', 'nya']",10,5,5,cari informasi kerja lowong nya,5,5
"Sangat bermanfaat untuk banyak orang, terimakasih LinkedIn",positif,2020-09-10,2020,sangat bermanfaat untuk banyak orang terimakasih linkedin,7,7,sangat bermanfaat untuk banyak orang terima kasih linkedin,7,8,"['sangat', 'bermanfaat', 'untuk', 'banyak', 'orang', 'terima', 'kasih', 'linkedin']","['bermanfaat', 'orang', 'terima', 'kasih', 'linkedin']",8,5,3,manfaat orang terima kasih linkedin,5,5
saya nggak ada akses lagi ke email dan akhirnya saya nggak bisa login..,negatif,2023-10-27,2023,saya nggak ada akses lagi ke email dan akhirnya saya nggak bisa login,13,13,saya tidak ada akses lagi ke email dan akhirnya saya tidak bisa login,13,13,"['saya', 'tidak', 'ada', 'akses', 'lagi', 'ke', 'email', 'dan', 'akhirnya', 'saya', 'tidak', 'bisa', 'login']","['tidak', 'akses', 'email', 'tidak', 'login']",13,5,8,tidak akses email tidak login,5,5
"Mau daftar susah,tolong di ganti verifikasinya via no hp(send code OTP)",negatif,2022-02-12,2022,mau daftar susah tolong di ganti verifikasinya via no hp send code otp,11,13,mau daftar susah tolong di ganti verifikasinya melalui nomor handphone send code one time password,13,15,"['mau', 'daftar', 'susah', 'tolong', 'di', 'ganti', 'verifikasinya', 'melalui', 'nomor', 'handphone', 'send', 'code', 'one', 'time', 'password']","['daftar', 'susah', 'tolong', 'ganti', 'verifikasinya', 'nomor', 'handphone', 'send', 'code', 'one', 'time', 'password']",15,12,3,daftar susah tolong ganti verifikasi nomor handphone send code one time password,12,12
Saya mudah mencari kerja dengan bnyak nya koneksi linkedin,positif,2021-10-02,2021,saya mudah mencari kerja dengan bnyak nya koneksi linkedin,9,9,saya mudah mencari kerja dengan banyak nya koneksi linkedin,9,9,"['saya', 'mudah', 'mencari', 'kerja', 'dengan', 'banyak', 'nya', 'koneksi', 'linkedin']","['mudah', 'mencari', 'kerja', 'nya', 'koneksi', 'linkedin']",9,6,3,mudah cari kerja nya koneksi linkedin,6,6
Bagus untuk mendapat berita lowongan pekerjaan,positif,2020-09-06,2020,bagus untuk mendapat berita lowongan pekerjaan,6,6,bagus untuk mendapat berita lowongan pekerjaan,6,6,"['bagus', 'untuk', 'mendapat', 'berita', 'lowongan', 'pekerjaan']","['bagus', 'berita', 'lowongan', 'pekerjaan']",6,4,2,bagus berita lowong kerja,4,4
"Baik,, mempermudah untuk lowker terbaru",positif,2022-02-08,2022,baik mempermudah untuk lowker terbaru,5,5,baik mempermudah untuk lowker terbaru,5,5,"['baik', 'mempermudah', 'untuk', 'lowker', 'terbaru']","['mempermudah', 'lowker', 'terbaru']",5,3,2,mudah lowker baru,3,3
Trimhkasi udh mengaktifkan semua yg di butuhkn,positif,2022-09-21,2022,trimhkasi udh mengaktifkan semua yg di butuhkn,7,7,trimhkasi sudah mengaktifkan semua yang di butuhkn,7,7,"['trimhkasi', 'sudah', 'mengaktifkan', 'semua', 'yang', 'di', 'butuhkn']","['trimhkasi', 'mengaktifkan', 'butuhkn']",7,3,4,trimhkasi aktif butuhkn,3,3
Selalu gagal ketika mau pilih foto untuk di posting,negatif,2023-06-04,2023,selalu gagal ketika mau pilih foto untuk di posting,9,9,selalu gagal ketika mau pilih foto untuk di posting,9,9,"['selalu', 'gagal', 'ketika', 'mau', 'pilih', 'foto', 'untuk', 'di', 'posting']","['gagal', 'pilih', 'foto', 'posting']",9,4,5,gagal pilih foto posting,4,4
Aplikasi ini sangat berguna bagi pencari pekerjaan,positif,2022-07-13,2022,aplikasi ini sangat berguna bagi pencari pekerjaan,7,7,aplikasi ini sangat berguna bagi pencari pekerjaan,7,7,"['aplikasi', 'ini', 'sangat', 'berguna', 'bagi', 'pencari', 'pekerjaan']","['aplikasi', 'berguna', 'pencari', 'pekerjaan']",7,4,3,aplikasi guna cari kerja,4,4
Sdh instal tapi kok ngk ada uplikasinya di hp saya.. klu masuk harus melalui ply store,negatif,2022-03-14,2022,sdh instal tapi kok ngk ada uplikasinya di hp saya klu masuk harus melalui ply store,16,16,sudah memasang tapi kok tidak ada uplikasinya di handphone saya kalau masuk harus melalui ply store,16,16,"['sudah', 'memasang', 'tapi', 'kok', 'tidak', 'ada', 'uplikasinya', 'di', 'handphone', 'saya', 'kalau', 'masuk', 'harus', 'melalui', 'ply', 'store']","['memasang', 'tidak', 'uplikasinya', 'handphone', 'masuk', 'ply', 'store']",16,7,9,pasang tidak uplikasinya handphone masuk ply store,7,7
Mudah di mengerti sangat bagus untuk pemula,positif,2020-09-05,2020,mudah di mengerti sangat bagus untuk pemula,7,7,mudah di mengerti sangat bagus untuk pemula,7,7,"['mudah', 'di', 'mengerti', 'sangat', 'bagus', 'untuk', 'pemula']","['mudah', 'mengerti', 'bagus', 'pemula']",7,4,3,mudah erti bagus mula,4,4
Sangat membantu bagi para pencari kerja,positif,2020-08-22,2020,sangat membantu bagi para pencari kerja,6,6,sangat membantu bagi para pencari kerja,6,6,"['sangat', 'membantu', 'bagi', 'para', 'pencari', 'kerja']","['membantu', 'pencari', 'kerja']",6,3,3,bantu cari kerja,3,3
Membantu mencari pekerjaan yang sesuai,positif,2020-10-27,2020,membantu mencari pekerjaan yang sesuai,5,5,membantu mencari pekerjaan yang sesuai,5,5,"['membantu', 'mencari', 'pekerjaan', 'yang', 'sesuai']","['membantu', 'mencari', 'pekerjaan', 'sesuai']",5,4,1,bantu cari kerja sesuai,4,4
Media sosial yang banyak positif dan bagus untuk informasi karir,positif,2022-07-28,2022,media sosial yang banyak positif dan bagus untuk informasi karir,10,10,media sosial yang banyak positif dan bagus untuk informasi karir,10,10,"['media', 'sosial', 'yang', 'banyak', 'positif', 'dan', 'bagus', 'untuk', 'informasi', 'karir']","['media', 'sosial', 'positif', 'bagus', 'informasi', 'karir']",10,6,4,media sosial positif bagus informasi karir,6,6
Gak bisa² login saya tidak tahu kenapa kayanya eror mulu dah lah copot saja,negatif,2023-08-14,2023,gak bisa² login saya tidak tahu kenapa kayanya eror mulu dah lah copot saja,14,14,tidak bisa² login saya tidak tahu kenapa kayaknya error mulu sudah lah copot saja,14,14,"['tidak', 'bisa²', 'login', 'saya', 'tidak', 'tahu', 'kenapa', 'kayaknya', 'error', 'mulu', 'sudah', 'lah', 'copot', 'saja']","['tidak', 'bisa²', 'login', 'tidak', 'kayaknya', 'error', 'mulu', 'copot']",14,8,6,tidak bisa login tidak kayak error mulu copot,8,8
"ini kenapa gak bisa daftar, login",negatif,2022-08-31,2022,ini kenapa gak bisa daftar login,6,6,ini kenapa tidak bisa daftar login,6,6,"['ini', 'kenapa', 'tidak', 'bisa', 'daftar', 'login']","['tidak', 'daftar', 'login']",6,3,3,tidak daftar login,3,3
"Saya nggak ngerti cara pakai aplikasinya gimana. Soalnya saya belum tamat kuliah, terima kasih",negatif,2021-05-25,2021,saya nggak ngerti cara pakai aplikasinya gimana soalnya saya belum tamat kuliah terima kasih,14,14,saya tidak mengerti cara pakai aplikasi nya bagaimana soalnya saya belum tamat kuliah terima kasih,14,15,"['saya', 'tidak', 'mengerti', 'cara', 'pakai', 'aplikasi', 'nya', 'bagaimana', 'soalnya', 'saya', 'belum', 'tamat', 'kuliah', 'terima', 'kasih']","['tidak', 'mengerti', 'pakai', 'aplikasi', 'nya', 'tamat', 'kuliah', 'terima', 'kasih']",15,9,6,tidak erti pakai aplikasi nya tamat kuliah terima kasih,9,9
Aplikasi ga guna mau daptar bergabung aja dipersulit Mendi dihapus saja dari play store 🔥🔥,negatif,2022-12-01,2022,aplikasi ga guna mau daptar bergabung aja dipersulit mendi dihapus saja dari play store,15,14,aplikasi tidak guna mau daptar bergabung saja dipersulit mendi dihapus saja dari play store,14,14,"['aplikasi', 'tidak', 'guna', 'mau', 'daptar', 'bergabung', 'saja', 'dipersulit', 'mendi', 'dihapus', 'saja', 'dari', 'play', 'store']","['aplikasi', 'tidak', 'daptar', 'bergabung', 'dipersulit', 'mendi', 'dihapus', 'play', 'store']",14,9,5,aplikasi tidak daptar gabung sulit mendi hapus play store,9,9
sangat membantu dlm berkomunikasi,positif,2020-07-22,2020,sangat membantu dlm berkomunikasi,4,4,sangat membantu dalam berkomunikasi,4,4,"['sangat', 'membantu', 'dalam', 'berkomunikasi']","['membantu', 'berkomunikasi']",4,2,2,bantu komunikasi,2,2
ui nya ga menarik. untuk ux nya pun ga enak bnget,negatif,2023-01-19,2023,ui nya ga menarik untuk ux nya pun ga enak bnget,11,11,ui nya tidak menarik untuk ux nya pun tidak enak banget,11,11,"['ui', 'nya', 'tidak', 'menarik', 'untuk', 'ux', 'nya', 'pun', 'tidak', 'enak', 'banget']","['ui', 'nya', 'tidak', 'menarik', 'ux', 'nya', 'tidak', 'enak', 'banget']",11,9,2,ui nya tidak tarik ux nya tidak enak banget,9,9
Sistem keamanan perlu diperbaiki,negatif,2022-06-10,2022,sistem keamanan perlu diperbaiki,4,4,sistem keamanan perlu di perbaiki,4,5,"['sistem', 'keamanan', 'perlu', 'di', 'perbaiki']","['sistem', 'keamanan', 'perbaiki']",5,3,2,sistem aman baik,3,3
"Ribet bgt mau verifikasi, selalu salah di akhir. Ngulang berkali², ujung²nya gagal juga hadeh",negatif,2022-06-11,2022,ribet bgt mau verifikasi selalu salah di akhir ngulang berkali² ujung²nya gagal juga hadeh,14,14,rumit banget mau verifikasi selalu salah di akhir mengulang berkali² ujung²nya gagal juga hadeh,14,14,"['rumit', 'banget', 'mau', 'verifikasi', 'selalu', 'salah', 'di', 'akhir', 'mengulang', 'berkali²', 'ujung²nya', 'gagal', 'juga', 'hadeh']","['rumit', 'banget', 'verifikasi', 'salah', 'mengulang', 'berkali²', 'ujung²nya', 'gagal', 'hadeh']",14,9,5,rumit banget verifikasi salah ulang kali ujung nya gagal hadeh,9,10
Jelek...tidak ada notifikasi dan kejelasan lebih lanjut,negatif,2021-03-26,2021,jelek tidak ada notifikasi dan kejelasan lebih lanjut,7,8,jelek tidak ada notifikasi dan kejelasan lebih lanjut,8,8,"['jelek', 'tidak', 'ada', 'notifikasi', 'dan', 'kejelasan', 'lebih', 'lanjut']","['jelek', 'tidak', 'notifikasi', 'kejelasan']",8,4,4,jelek tidak notifikasi jelas,4,4
Aplikasi yang bermanfaat. Semoga ke depan LinkedIn semakin sukses,positif,2020-08-26,2020,aplikasi yang bermanfaat semoga ke depan linkedin semakin sukses,9,9,aplikasi yang bermanfaat semoga ke depan linkedin semakin sukses,9,9,"['aplikasi', 'yang', 'bermanfaat', 'semoga', 'ke', 'depan', 'linkedin', 'semakin', 'sukses']","['aplikasi', 'bermanfaat', 'semoga', 'linkedin', 'sukses']",9,5,4,aplikasi manfaat moga linkedin sukses,5,5
Aplikasi linkedln sangat membantu kami para jobsekers,positif,2022-03-31,2022,aplikasi linkedln sangat membantu kami para jobsekers,7,7,aplikasi linkedln sangat membantu kami para jobsekers,7,7,"['aplikasi', 'linkedln', 'sangat', 'membantu', 'kami', 'para', 'jobsekers']","['aplikasi', 'linkedln', 'membantu', 'jobsekers']",7,4,3,aplikasi linkedln bantu jobsekers,4,4
Semoga aplikasi ini bisa membantu dlm mencari pkerjaan.trima ksih,positif,2020-07-03,2020,semoga aplikasi ini bisa membantu dlm mencari pkerjaan trima ksih,9,10,semoga aplikasi ini bisa membantu dalam mencari pkerjaan terima ksih,10,10,"['semoga', 'aplikasi', 'ini', 'bisa', 'membantu', 'dalam', 'mencari', 'pkerjaan', 'terima', 'ksih']","['semoga', 'aplikasi', 'membantu', 'mencari', 'pkerjaan', 'terima', 'ksih']",10,7,3,moga aplikasi bantu cari pkerjaan terima ksih,7,7
Sangat membantu dalan ulasan dan berita yang akurat. Terima kasih Team Linkedin,positif,2021-05-22,2021,sangat membantu dalan ulasan dan berita yang akurat terima kasih team linkedin,12,12,sangat membantu dalan ulasan dan berita yang akurat terima kasih team linkedin,12,12,"['sangat', 'membantu', 'dalan', 'ulasan', 'dan', 'berita', 'yang', 'akurat', 'terima', 'kasih', 'team', 'linkedin']","['membantu', 'dalan', 'ulasan', 'berita', 'akurat', 'terima', 'kasih', 'team', 'linkedin']",12,9,3,bantu dal ulas berita akurat terima kasih team linkedin,9,9
Banyak informasi bermanfaat untuk dunia pekerja dan usaha,positif,2022-06-21,2022,banyak informasi bermanfaat untuk dunia pekerja dan usaha,8,8,banyak informasi bermanfaat untuk dunia yang kerja dan usaha,8,9,"['banyak', 'informasi', 'bermanfaat', 'untuk', 'dunia', 'yang', 'kerja', 'dan', 'usaha']","['informasi', 'bermanfaat', 'dunia', 'kerja', 'usaha']",9,5,4,informasi manfaat dunia kerja usaha,5,5
Gabisa masuk apk! Verifikasi berulang!,negatif,2022-12-18,2022,gabisa masuk apk verifikasi berulang,5,5,tidak bisa masuk aplikasi verifikasi berulang,5,6,"['tidak', 'bisa', 'masuk', 'aplikasi', 'verifikasi', 'berulang']","['tidak', 'masuk', 'aplikasi', 'verifikasi', 'berulang']",6,5,1,tidak masuk aplikasi verifikasi ulang,5,5
Media ter- update dan efektif dalam bursa karir,positif,2022-12-14,2022,media ter update dan efektif dalam bursa karir,8,8,media ter diperbarui dan efektif dalam bursa karir,8,8,"['media', 'ter', 'diperbarui', 'dan', 'efektif', 'dalam', 'bursa', 'karir']","['media', 'ter', 'diperbarui', 'efektif', 'bursa', 'karir']",8,6,2,media ter baru efektif bursa karir,6,6
Aplikasi cukup membantu untuk mencari pekerjaan,positif,2023-10-01,2023,aplikasi cukup membantu untuk mencari pekerjaan,6,6,aplikasi cukup membantu untuk mencari pekerjaan,6,6,"['aplikasi', 'cukup', 'membantu', 'untuk', 'mencari', 'pekerjaan']","['aplikasi', 'membantu', 'mencari', 'pekerjaan']",6,4,2,aplikasi bantu cari kerja,4,4
Sangat bagus untuk branding personal,positif,2021-11-23,2021,sangat bagus untuk branding personal,5,5,sangat bagus untuk branding personal,5,5,"['sangat', 'bagus', 'untuk', 'branding', 'personal']","['bagus', 'branding', 'personal']",5,3,2,bagus branding personal,3,3
"Mau login susah bgt. Verifikasi pk suara dh dilakuin, udh bener pdhl tp malah diminta verif lg. Yg dulu gk ky gni bgt!!!!!!!!",negatif,2023-05-06,2023,mau login susah bgt verifikasi pk suara dh dilakuin udh bener pdhl tp malah diminta verif lg yg dulu gk ky gni bgt,23,23,mau login susah banget verifikasi pakai suara sudah dilakuin sudah benar padahal tapi bahkan diminta verif lagi yang dahulu tidak seperti begini banget,23,23,"['mau', 'login', 'susah', 'banget', 'verifikasi', 'pakai', 'suara', 'sudah', 'dilakuin', 'sudah', 'benar', 'padahal', 'tapi', 'bahkan', 'diminta', 'verif', 'lagi', 'yang', 'dahulu', 'tidak', 'seperti', 'begini', 'banget']","['login', 'susah', 'banget', 'verifikasi', 'pakai', 'suara', 'dilakuin', 'verif', 'tidak', 'banget']",23,10,13,login susah banget verifikasi pakai suara dilakuin verif tidak banget,10,10
"Memberi motivasi, kreatip, berteman bnyak,, sangat membantu kami, Terima kasih LinkeDIn",positif,2021-03-18,2021,memberi motivasi kreatip berteman bnyak sangat membantu kami terima kasih linkedin,11,11,memberi motivasi kreatip berteman banyak sangat membantu kami terima kasih linkedin,11,11,"['memberi', 'motivasi', 'kreatip', 'berteman', 'banyak', 'sangat', 'membantu', 'kami', 'terima', 'kasih', 'linkedin']","['motivasi', 'kreatip', 'berteman', 'membantu', 'terima', 'kasih', 'linkedin']",11,7,4,motivasi kreatip teman bantu terima kasih linkedin,7,7
Sangat bermanfaat menjalin hubungan dan mendapat pengetahuan dari para Ahli,positif,2023-09-26,2023,sangat bermanfaat menjalin hubungan dan mendapat pengetahuan dari para ahli,10,10,sangat bermanfaat menjalin hubungan dan mendapat pengetahuan dari para ahli,10,10,"['sangat', 'bermanfaat', 'menjalin', 'hubungan', 'dan', 'mendapat', 'pengetahuan', 'dari', 'para', 'ahli']","['bermanfaat', 'menjalin', 'hubungan', 'pengetahuan', 'ahli']",10,5,5,manfaat jalin hubung tahu ahli,5,5
Aplikasi sangat bermanfaat. Terima kasih Linkedln,positif,2020-05-24,2020,aplikasi sangat bermanfaat terima kasih linkedln,6,6,aplikasi sangat bermanfaat terima kasih linkedln,6,6,"['aplikasi', 'sangat', 'bermanfaat', 'terima', 'kasih', 'linkedln']","['aplikasi', 'bermanfaat', 'terima', 'kasih', 'linkedln']",6,5,1,aplikasi manfaat terima kasih linkedln,5,5
"Sudah lama saya pakai,melamar nggak ada tembus dan tidak ada respon mengenai kendala lamaran saya. Tolong beri tanggapan untuk lamaran yang sudah di kirim ke perusahaan.",negatif,2022-08-05,2022,sudah lama saya pakai melamar nggak ada tembus dan tidak ada respon mengenai kendala lamaran saya tolong beri tanggapan untuk lamaran yang sudah di kirim ke perusahaan,26,27,sudah lama saya pakai melamar tidak ada tembus dan tidak ada respons mengenai kendala lamaran saya tolong beri tanggapan untuk lamaran yang sudah di kirim ke perusahaan,27,27,"['sudah', 'lama', 'saya', 'pakai', 'melamar', 'tidak', 'ada', 'tembus', 'dan', 'tidak', 'ada', 'respons', 'mengenai', 'kendala', 'lamaran', 'saya', 'tolong', 'beri', 'tanggapan', 'untuk', 'lamaran', 'yang', 'sudah', 'di', 'kirim', 'ke', 'perusahaan']","['pakai', 'melamar', 'tidak', 'tembus', 'tidak', 'respons', 'kendala', 'lamaran', 'tolong', 'tanggapan', 'lamaran', 'kirim', 'perusahaan']",27,13,14,pakai lamar tidak tembus tidak respons kendala lamar tolong tanggap lamar kirim usaha,13,13
Update informasi terkini dari semua peluang bisnis dan pekerjaan yg sangat dibutuhkan utk konsumsi publik dari semua kalangan,positif,2021-04-12,2021,update informasi terkini dari semua peluang bisnis dan pekerjaan yg sangat dibutuhkan utk konsumsi publik dari semua kalangan,18,18,diperbarui informasi terkini dari semua peluang bisnis dan pekerjaan yang sangat dibutuhkan untuk konsumsi publik dari semua kalangan,18,18,"['diperbarui', 'informasi', 'terkini', 'dari', 'semua', 'peluang', 'bisnis', 'dan', 'pekerjaan', 'yang', 'sangat', 'dibutuhkan', 'untuk', 'konsumsi', 'publik', 'dari', 'semua', 'kalangan']","['diperbarui', 'informasi', 'terkini', 'peluang', 'bisnis', 'pekerjaan', 'dibutuhkan', 'konsumsi', 'publik', 'kalangan']",18,10,8,baru informasi kini peluang bisnis kerja butuh konsumsi publik kalang,10,10
Sangat mudah dan cepat dipahami,positif,2020-03-07,2020,sangat mudah dan cepat dipahami,5,5,sangat mudah dan cepat dipahami,5,5,"['sangat', 'mudah', 'dan', 'cepat', 'dipahami']","['mudah', 'cepat', 'dipahami']",5,3,2,mudah cepat paham,3,3
Lumayan bagus utk progres informasi pekerjaan dll,positif,2023-07-04,2023,lumayan bagus utk progres informasi pekerjaan dll,7,7,lumayan bagus untuk progres informasi pekerjaan dan lain lain,7,9,"['lumayan', 'bagus', 'untuk', 'progres', 'informasi', 'pekerjaan', 'dan', 'lain', 'lain']","['lumayan', 'bagus', 'progres', 'informasi', 'pekerjaan']",9,5,4,lumayan bagus progres informasi kerja,5,5
Kok ngelag ya sekarang sering error,negatif,2022-04-20,2022,kok ngelag ya sekarang sering error,6,6,kok lambat ya sekarang sering error,6,6,"['kok', 'lambat', 'ya', 'sekarang', 'sering', 'error']","['lambat', 'ya', 'error']",6,3,3,lambat ya error,3,3
"knapa bisa gni saya buka akun lindkedln lari ke aplikasi lain, hadeuuh kecewa ga jelas🙄",negatif,2020-10-26,2020,knapa bisa gni saya buka akun lindkedln lari ke aplikasi lain hadeuuh kecewa ga jelas,15,15,kenapa bisa begini saya buka akun lindkedln lari ke aplikasi lain aduh kecewa tidak jelas,15,15,"['kenapa', 'bisa', 'begini', 'saya', 'buka', 'akun', 'lindkedln', 'lari', 'ke', 'aplikasi', 'lain', 'aduh', 'kecewa', 'tidak', 'jelas']","['buka', 'akun', 'lindkedln', 'lari', 'aplikasi', 'aduh', 'kecewa', 'tidak']",15,8,7,buka akun lindkedln lari aplikasi aduh kecewa tidak,8,8
Gambar verifikasinya terlalu susah,negatif,2023-09-27,2023,gambar verifikasinya terlalu susah,4,4,gambar verifikasinya terlalu susah,4,4,"['gambar', 'verifikasinya', 'terlalu', 'susah']","['gambar', 'verifikasinya', 'susah']",4,3,1,gambar verifikasi susah,3,3
Informatif untuk bidang profesionalisme,positif,2021-07-19,2021,informatif untuk bidang profesionalisme,4,4,informatif untuk bidang profesionalisme,4,4,"['informatif', 'untuk', 'bidang', 'profesionalisme']","['informatif', 'bidang', 'profesionalisme']",4,3,1,informatif bidang profesionalisme,3,3
Sangat membantu untuk mencari pekerjaan.,positif,2021-07-28,2021,sangat membantu untuk mencari pekerjaan,5,5,sangat membantu untuk mencari pekerjaan,5,5,"['sangat', 'membantu', 'untuk', 'mencari', 'pekerjaan']","['membantu', 'mencari', 'pekerjaan']",5,3,2,bantu cari kerja,3,3
Tidak bisa daftar gagal terus !!!!,negatif,2020-03-14,2020,tidak bisa daftar gagal terus,6,5,tidak bisa daftar gagal terus,5,5,"['tidak', 'bisa', 'daftar', 'gagal', 'terus']","['tidak', 'daftar', 'gagal']",5,3,2,tidak daftar gagal,3,3
Bismilah sudah jadi exporter baja berat,positif,2023-11-08,2023,bismilah sudah jadi exporter baja berat,6,6,bismilah sudah jadi exporter baja berat,6,6,"['bismilah', 'sudah', 'jadi', 'exporter', 'baja', 'berat']","['bismilah', 'exporter', 'baja', 'berat']",6,4,2,bismilah exporter baja berat,4,4
Semoga mudah dan cepat diperngerti,positif,2022-06-25,2022,semoga mudah dan cepat diperngerti,5,5,semoga mudah dan cepat diperngerti,5,5,"['semoga', 'mudah', 'dan', 'cepat', 'diperngerti']","['semoga', 'mudah', 'cepat', 'diperngerti']",5,4,1,moga mudah cepat diperngerti,4,4
Bagus untuk mencari pekerjaan yg diinginkan,positif,2023-03-24,2023,bagus untuk mencari pekerjaan yg diinginkan,6,6,bagus untuk mencari pekerjaan yang diinginkan,6,6,"['bagus', 'untuk', 'mencari', 'pekerjaan', 'yang', 'diinginkan']","['bagus', 'mencari', 'pekerjaan']",6,3,3,bagus cari kerja,3,3
perlu ditingkatkan kembali pelayanan nya,positif,2021-04-15,2021,perlu ditingkatkan kembali pelayanan nya,5,5,perlu ditingkatkan kembali pelayanan nya,5,5,"['perlu', 'ditingkatkan', 'kembali', 'pelayanan', 'nya']","['ditingkatkan', 'pelayanan', 'nya']",5,3,2,tingkat layan nya,3,3
Aplikasi gk jlas. Tebak gambar sdh benar tpi kluarnya salah trs,negatif,2022-04-13,2022,aplikasi gk jlas tebak gambar sdh benar tpi kluarnya salah trs,11,11,aplikasi tidak jlas tebak gambar sudah benar tetapi kluarnya salah terus,11,11,"['aplikasi', 'tidak', 'jlas', 'tebak', 'gambar', 'sudah', 'benar', 'tetapi', 'kluarnya', 'salah', 'terus']","['aplikasi', 'tidak', 'jlas', 'tebak', 'gambar', 'kluarnya', 'salah']",11,7,4,aplikasi tidak jlas tebak gambar kluarnya salah,7,7
"Sangat bagus, banyak di pertemukan dengan orang-orang baru.",positif,2022-07-08,2022,sangat bagus banyak di pertemukan dengan orang orang baru,8,9,sangat bagus banyak di pertemukan dengan orang orang baru,9,9,"['sangat', 'bagus', 'banyak', 'di', 'pertemukan', 'dengan', 'orang', 'orang', 'baru']","['bagus', 'pertemukan', 'orang', 'orang']",9,4,5,bagus temu orang orang,4,4
Kode Verifikasi error padahl udh jawab dengan benar tapi ada pemberitahuan nya kode chapta belum diisi atau tidak valid,negatif,2023-11-17,2023,kode verifikasi error padahl udh jawab dengan benar tapi ada pemberitahuan nya kode chapta belum diisi atau tidak valid,19,19,kode verifikasi error padahal sudah jawab dengan benar tapi ada pemberitahuan nya kode chapta belum diisi atau tidak valid,19,19,"['kode', 'verifikasi', 'error', 'padahal', 'sudah', 'jawab', 'dengan', 'benar', 'tapi', 'ada', 'pemberitahuan', 'nya', 'kode', 'chapta', 'belum', 'diisi', 'atau', 'tidak', 'valid']","['kode', 'verifikasi', 'error', 'pemberitahuan', 'nya', 'kode', 'chapta', 'diisi', 'tidak', 'valid']",19,10,9,kode verifikasi error pemberitahuan nya kode chapta isi tidak valid,10,10
mau login aja gabisa terus aneh,negatif,2023-07-12,2023,mau login aja gabisa terus aneh,6,6,mau login saja tidak bisa terus aneh,6,7,"['mau', 'login', 'saja', 'tidak', 'bisa', 'terus', 'aneh']","['login', 'tidak', 'aneh']",7,3,4,login tidak aneh,3,3
"Gimana akun saya lupa sandi, udah konfirmasi nomor handphone, masukkan nama depan belakang gak bisa. Maksudnya gimana? Mohon bantuannya",negatif,2023-02-23,2023,gimana akun saya lupa sandi udah konfirmasi nomor handphone masukkan nama depan belakang gak bisa maksudnya gimana mohon bantuannya,19,19,bagaimana akun saya lupa sandi sudah konfirmasi nomor handphone masukkan nama depan belakang tidak bisa maksudnya bagaimana mohon bantuannya,19,19,"['bagaimana', 'akun', 'saya', 'lupa', 'sandi', 'sudah', 'konfirmasi', 'nomor', 'handphone', 'masukkan', 'nama', 'depan', 'belakang', 'tidak', 'bisa', 'maksudnya', 'bagaimana', 'mohon', 'bantuannya']","['akun', 'lupa', 'sandi', 'konfirmasi', 'nomor', 'handphone', 'masukkan', 'nama', 'tidak', 'maksudnya', 'mohon', 'bantuannya']",19,12,7,akun lupa sandi konfirmasi nomor handphone masuk nama tidak maksud mohon bantu,12,12
"Bodoh, verifikasi mu tidak jelas...gambar nya ngawur dan gak bisa login",negatif,2021-11-08,2021,bodoh verifikasi mu tidak jelas gambar nya ngawur dan gak bisa login,11,12,bodoh verifikasi mau tidak jelas gambar nya asal asalan dan tidak bisa login,12,13,"['bodoh', 'verifikasi', 'mau', 'tidak', 'jelas', 'gambar', 'nya', 'asal', 'asalan', 'dan', 'tidak', 'bisa', 'login']","['bodoh', 'verifikasi', 'tidak', 'gambar', 'nya', 'asalan', 'tidak', 'login']",13,8,5,bodoh verifikasi tidak gambar nya asal tidak login,8,8
Selalu menyajikan lowongan sesuai pengalaman,positif,2023-05-20,2023,selalu menyajikan lowongan sesuai pengalaman,5,5,selalu menyajikan lowongan sesuai pengalaman,5,5,"['selalu', 'menyajikan', 'lowongan', 'sesuai', 'pengalaman']","['menyajikan', 'lowongan', 'sesuai', 'pengalaman']",5,4,1,saji lowong sesuai alam,4,4
Gambar nya yg akurat boss bikin bingung aja verifikasinya gambar atas bikin bingung,negatif,2022-03-01,2022,gambar nya yg akurat boss bikin bingung aja verifikasinya gambar atas bikin bingung,13,13,gambar nya yang akurat boss bikin bingung saja verifikasinya gambar atas bikin bingung,13,13,"['gambar', 'nya', 'yang', 'akurat', 'boss', 'bikin', 'bingung', 'saja', 'verifikasinya', 'gambar', 'atas', 'bikin', 'bingung']","['gambar', 'nya', 'akurat', 'boss', 'bikin', 'bingung', 'verifikasinya', 'gambar', 'bikin', 'bingung']",13,10,3,gambar nya akurat boss bikin bingung verifikasi gambar bikin bingung,10,10
Sangat membantu untuk pengembangan diri,positif,2020-09-16,2020,sangat membantu untuk pengembangan diri,5,5,sangat membantu untuk pengembangan diri,5,5,"['sangat', 'membantu', 'untuk', 'pengembangan', 'diri']","['membantu', 'pengembangan']",5,2,3,bantu kembang,2,2
Sangat bermanfaat untuk pertemanan dan loker,positif,2020-08-04,2020,sangat bermanfaat untuk pertemanan dan loker,6,6,sangat bermanfaat untuk pertemanan dan loker,6,6,"['sangat', 'bermanfaat', 'untuk', 'pertemanan', 'dan', 'loker']","['bermanfaat', 'pertemanan', 'loker']",6,3,3,manfaat teman loker,3,3
Lebih banyak baca motivasinya sih daripada lokernya,positif,2020-07-07,2020,lebih banyak baca motivasinya sih daripada lokernya,7,7,lebih banyak baca motivasinya sih daripada lokernya,7,7,"['lebih', 'banyak', 'baca', 'motivasinya', 'sih', 'daripada', 'lokernya']","['baca', 'motivasinya', 'sih', 'lokernya']",7,4,3,baca motivasi sih lokernya,4,4
Sangat membantu untuk lowongan kerja,positif,2021-09-12,2021,sangat membantu untuk lowongan kerja,5,5,sangat membantu untuk lowongan kerja,5,5,"['sangat', 'membantu', 'untuk', 'lowongan', 'kerja']","['membantu', 'lowongan', 'kerja']",5,3,2,bantu lowong kerja,3,3
Semoga semua yang download app ini bisa segera dapat kerja di app ini aamiin,positif,2021-12-09,2021,semoga semua yang download app ini bisa segera dapat kerja di app ini aamiin,14,14,semoga semua yang unduh aplikasi ini bisa segera dapat kerja di aplikasi ini aamiin,14,14,"['semoga', 'semua', 'yang', 'unduh', 'aplikasi', 'ini', 'bisa', 'segera', 'dapat', 'kerja', 'di', 'aplikasi', 'ini', 'aamiin']","['semoga', 'unduh', 'aplikasi', 'kerja', 'aplikasi', 'aamiin']",14,6,8,moga unduh aplikasi kerja aplikasi aamiin,6,6
Mudah mudahan bisa membantu untuk melamar kerja dan utk semua orang,positif,2020-10-09,2020,mudah mudahan bisa membantu untuk melamar kerja dan utk semua orang,11,11,mudah mudahan bisa membantu untuk melamar kerja dan untuk semua orang,11,11,"['mudah', 'mudahan', 'bisa', 'membantu', 'untuk', 'melamar', 'kerja', 'dan', 'untuk', 'semua', 'orang']","['mudah', 'mudahan', 'membantu', 'melamar', 'kerja', 'orang']",11,6,5,mudah mudah bantu lamar kerja orang,6,6
Bagus dan bermanfat untuk bngun komunikasi,positif,2021-02-23,2021,bagus dan bermanfat untuk bngun komunikasi,6,6,bagus dan bermanfat untuk bngun komunikasi,6,6,"['bagus', 'dan', 'bermanfat', 'untuk', 'bngun', 'komunikasi']","['bagus', 'bermanfat', 'bngun', 'komunikasi']",6,4,2,bagus bermanfat bngun komunikasi,4,4
Mau daftar aja susah amat verifikasi ga bisa2,negatif,2021-05-17,2021,mau daftar aja susah amat verifikasi ga bisa,8,8,mau daftar saja susah amat verifikasi tidak bisa,8,8,"['mau', 'daftar', 'saja', 'susah', 'amat', 'verifikasi', 'tidak', 'bisa']","['daftar', 'susah', 'verifikasi', 'tidak']",8,4,4,daftar susah verifikasi tidak,4,4
Sangat membantu dalam mengembangkan network..,positif,2020-09-26,2020,sangat membantu dalam mengembangkan network,5,5,sangat membantu dalam mengembangkan network,5,5,"['sangat', 'membantu', 'dalam', 'mengembangkan', 'network']","['membantu', 'mengembangkan', 'network']",5,3,2,bantu kembang network,3,3
Thanks you... Semoga tambah barokah n sukses menjalankan bisnis ini selesai ya....,positif,2021-03-08,2021,thanks you semoga tambah barokah n sukses menjalankan bisnis ini selesai ya,12,12,terima kasih you semoga tambah barokah dan sukses menjalankan bisnis ini selesai ya,12,13,"['terima', 'kasih', 'you', 'semoga', 'tambah', 'barokah', 'dan', 'sukses', 'menjalankan', 'bisnis', 'ini', 'selesai', 'ya']","['terima', 'kasih', 'you', 'semoga', 'barokah', 'sukses', 'menjalankan', 'bisnis', 'selesai', 'ya']",13,10,3,terima kasih you moga barokah sukses jalan bisnis selesai ya,10,10
Sangat membantu kita dalam mencari pekerjaan,positif,2020-11-17,2020,sangat membantu kita dalam mencari pekerjaan,6,6,sangat membantu kita dalam mencari pekerjaan,6,6,"['sangat', 'membantu', 'kita', 'dalam', 'mencari', 'pekerjaan']","['membantu', 'mencari', 'pekerjaan']",6,3,3,bantu cari kerja,3,3
Media sosial yg sangat membantu bagi siapa saja yg mencari kerja.,positif,2021-01-26,2021,media sosial yg sangat membantu bagi siapa saja yg mencari kerja,11,11,media sosial yang sangat membantu bagi siapa saja yang mencari kerja,11,11,"['media', 'sosial', 'yang', 'sangat', 'membantu', 'bagi', 'siapa', 'saja', 'yang', 'mencari', 'kerja']","['media', 'sosial', 'membantu', 'mencari', 'kerja']",11,5,6,media sosial bantu cari kerja,5,5
Link in knp ya kok gw ga bisa log in si parah,negatif,2023-06-07,2023,link in knp ya kok gw ga bisa log in si parah,12,12,link in kenapa ya kok saya tidak bisa log in sih parah,12,12,"['link', 'in', 'kenapa', 'ya', 'kok', 'saya', 'tidak', 'bisa', 'log', 'in', 'sih', 'parah']","['link', 'in', 'ya', 'tidak', 'log', 'in', 'sih', 'parah']",12,8,4,link in ya tidak log in sih parah,8,8
"Pelanggaran dalam menggunakan aplikasi tidak dijelaskan, trus pemulihan akun tidak bisa dilakukan",negatif,2023-09-10,2023,pelanggaran dalam menggunakan aplikasi tidak dijelaskan trus pemulihan akun tidak bisa dilakukan,12,12,pelanggaran dalam menggunakan aplikasi tidak dijelaskan terus pemulihan akun tidak bisa dilakukan,12,12,"['pelanggaran', 'dalam', 'menggunakan', 'aplikasi', 'tidak', 'dijelaskan', 'terus', 'pemulihan', 'akun', 'tidak', 'bisa', 'dilakukan']","['pelanggaran', 'aplikasi', 'tidak', 'pemulihan', 'akun', 'tidak']",12,6,6,langgar aplikasi tidak pulih akun tidak,6,6
sangat bermanfaat bagi para profesional,positif,2020-11-08,2020,sangat bermanfaat bagi para profesional,5,5,sangat bermanfaat bagi para profesional,5,5,"['sangat', 'bermanfaat', 'bagi', 'para', 'profesional']","['bermanfaat', 'profesional']",5,2,3,manfaat profesional,2,2
Ok lah...lbh diupgrade lg agar komunikasi lbh jelas,positif,2020-09-17,2020,ok lah lbh diupgrade lg agar komunikasi lbh jelas,8,9,oke lah lebih diupgrade lagi agar komunikasi lebih jelas,9,9,"['oke', 'lah', 'lebih', 'diupgrade', 'lagi', 'agar', 'komunikasi', 'lebih', 'jelas']","['oke', 'diupgrade', 'komunikasi']",9,3,6,oke diupgrade komunikasi,3,3
Bagus bisa dipakai sebagai lahan informasi bagi kawan²,positif,2023-01-28,2023,bagus bisa dipakai sebagai lahan informasi bagi kawan²,8,8,bagus bisa dipakai sebagai lahan informasi bagi kawan²,8,8,"['bagus', 'bisa', 'dipakai', 'sebagai', 'lahan', 'informasi', 'bagi', 'kawan²']","['bagus', 'dipakai', 'lahan', 'informasi', 'kawan²']",8,5,3,bagus pakai lahan informasi kawan,5,5
Aplikasinya kenapa sih? Kok mau masuk mesti tebak-tebak gambar dulu,negatif,2022-07-30,2022,aplikasinya kenapa sih kok mau masuk mesti tebak tebak gambar dulu,10,11,aplikasi nya kenapa sih kok mau masuk mesti tebak tebak gambar dahulu,11,12,"['aplikasi', 'nya', 'kenapa', 'sih', 'kok', 'mau', 'masuk', 'mesti', 'tebak', 'tebak', 'gambar', 'dahulu']","['aplikasi', 'nya', 'sih', 'masuk', 'mesti', 'tebak', 'tebak', 'gambar']",12,8,4,aplikasi nya sih masuk mesti tebak tebak gambar,8,8
Membantu saya membuka dan menemukan orang-orang hebat diseluruh dunia terkait perusahaan dan pekerjaan. Salam.🙏,positif,2020-08-05,2020,membantu saya membuka dan menemukan orang orang hebat diseluruh dunia terkait perusahaan dan pekerjaan salam,14,15,membantu saya membuka dan menemukan orang orang hebat diseluruh dunia terkait perusahaan dan pekerjaan salam,15,15,"['membantu', 'saya', 'membuka', 'dan', 'menemukan', 'orang', 'orang', 'hebat', 'diseluruh', 'dunia', 'terkait', 'perusahaan', 'dan', 'pekerjaan', 'salam']","['membantu', 'membuka', 'menemukan', 'orang', 'orang', 'hebat', 'diseluruh', 'dunia', 'terkait', 'perusahaan', 'pekerjaan', 'salam']",15,12,3,bantu buka temu orang orang hebat seluruh dunia kait usaha kerja salam,12,12
Aplikasi yang membantu saya terkoneksi dengan banyak orang dan menemukan info loker,positif,2022-11-12,2022,aplikasi yang membantu saya terkoneksi dengan banyak orang dan menemukan info loker,12,12,aplikasi yang membantu saya terkoneksi dengan banyak orang dan menemukan informasi loker,12,12,"['aplikasi', 'yang', 'membantu', 'saya', 'terkoneksi', 'dengan', 'banyak', 'orang', 'dan', 'menemukan', 'informasi', 'loker']","['aplikasi', 'membantu', 'terkoneksi', 'orang', 'menemukan', 'informasi', 'loker']",12,7,5,aplikasi bantu koneksi orang temu informasi loker,7,7
Link sangat membantu untuk mencari kerja,positif,2020-11-26,2020,link sangat membantu untuk mencari kerja,6,6,link sangat membantu untuk mencari kerja,6,6,"['link', 'sangat', 'membantu', 'untuk', 'mencari', 'kerja']","['link', 'membantu', 'mencari', 'kerja']",6,4,2,link bantu cari kerja,4,4
sangat membantu untuk mencari loker,positif,2020-09-23,2020,sangat membantu untuk mencari loker,5,5,sangat membantu untuk mencari loker,5,5,"['sangat', 'membantu', 'untuk', 'mencari', 'loker']","['membantu', 'mencari', 'loker']",5,3,2,bantu cari loker,3,3
"Sangat membantu promosi produk usaha, hebatnya gratis",positif,2023-04-23,2023,sangat membantu promosi produk usaha hebatnya gratis,7,7,sangat membantu promosi produk usaha hebatnya gratis,7,7,"['sangat', 'membantu', 'promosi', 'produk', 'usaha', 'hebatnya', 'gratis']","['membantu', 'promosi', 'produk', 'usaha', 'hebatnya', 'gratis']",7,6,1,bantu promosi produk usaha hebat gratis,6,6
Mantab..tp sayang nya pekerjaan nya ngga bisa nentuin sendiri,positif,2021-06-21,2021,mantab tp sayang nya pekerjaan nya ngga bisa nentuin sendiri,9,10,mantap tapi sayang nya pekerjaan nya tidak bisa nentuin sendiri,10,10,"['mantap', 'tapi', 'sayang', 'nya', 'pekerjaan', 'nya', 'tidak', 'bisa', 'nentuin', 'sendiri']","['mantap', 'sayang', 'nya', 'pekerjaan', 'nya', 'tidak', 'nentuin']",10,7,3,mantap sayang nya kerja nya tidak nentuin,7,7
"Aplikasi nya mantap lah, gak ngebosenin",positif,2021-11-12,2021,aplikasi nya mantap lah gak ngebosenin,6,6,aplikasi nya mantap lah tidak ngebosenin,6,6,"['aplikasi', 'nya', 'mantap', 'lah', 'tidak', 'ngebosenin']","['aplikasi', 'nya', 'mantap', 'tidak', 'ngebosenin']",6,5,1,aplikasi nya mantap tidak ngebosenin,5,5
Mudah2an terbantu dalam hal Info lowongan pekerjaan,positif,2020-05-04,2020,mudah an terbantu dalam hal info lowongan pekerjaan,7,8,mudah an membantu dalam hal informasi lowongan pekerjaan,8,8,"['mudah', 'an', 'membantu', 'dalam', 'hal', 'informasi', 'lowongan', 'pekerjaan']","['mudah', 'an', 'membantu', 'informasi', 'lowongan', 'pekerjaan']",8,6,2,mudah an bantu informasi lowong kerja,6,6
Sangat membantu memberikan ingormasi lowongan kerja,positif,2021-10-15,2021,sangat membantu memberikan ingormasi lowongan kerja,6,6,sangat membantu memberikan ingormasi lowongan kerja,6,6,"['sangat', 'membantu', 'memberikan', 'ingormasi', 'lowongan', 'kerja']","['membantu', 'ingormasi', 'lowongan', 'kerja']",6,4,2,bantu ingormasi lowong kerja,4,4
Captcha nya gimana sih udah bener disuruh ngulang ngulang terus,negatif,2023-12-10,2023,captcha nya gimana sih udah bener disuruh ngulang ngulang terus,10,10,captcha nya bagaimana sih sudah benar disuruh mengulang mengulang terus,10,10,"['captcha', 'nya', 'bagaimana', 'sih', 'sudah', 'benar', 'disuruh', 'mengulang', 'mengulang', 'terus']","['captcha', 'nya', 'sih', 'disuruh', 'mengulang', 'mengulang']",10,6,4,captcha nya sih suruh ulang ulang,6,6
"Kok saya gak bisa memposting sih, sudah berkali kali saya coba tapi tetap tidak bisa memposting",negatif,2021-07-10,2021,kok saya gak bisa memposting sih sudah berkali kali saya coba tapi tetap tidak bisa memposting,16,16,kok saya tidak bisa memposting sih sudah berkali kali saya coba tapi tetap tidak bisa memposting,16,16,"['kok', 'saya', 'tidak', 'bisa', 'memposting', 'sih', 'sudah', 'berkali', 'kali', 'saya', 'coba', 'tapi', 'tetap', 'tidak', 'bisa', 'memposting']","['tidak', 'memposting', 'sih', 'berkali', 'kali', 'coba', 'tidak', 'memposting']",16,8,8,tidak memposting sih kali kali coba tidak memposting,8,8
"Coba ada dark mode, lebih nyaman si",positif,2021-08-11,2021,coba ada dark mode lebih nyaman si,7,7,coba ada dark mode lebih nyaman sih,7,7,"['coba', 'ada', 'dark', 'mode', 'lebih', 'nyaman', 'sih']","['coba', 'dark', 'mode', 'nyaman', 'sih']",7,5,2,coba dark mode nyaman sih,5,5
eror kalo cek profil foto lama keluar.. lelet suka eror,negatif,2020-06-16,2020,eror kalo cek profil foto lama keluar lelet suka eror,10,10,error kalau cek profil foto lama keluar lelet suka error,10,10,"['error', 'kalau', 'cek', 'profil', 'foto', 'lama', 'keluar', 'lelet', 'suka', 'error']","['error', 'cek', 'profil', 'foto', 'lelet', 'suka', 'error']",10,7,3,error cek profil foto lelet suka error,7,7
LinkedIn memberi kesempatan untuk terhubung dengan profesional dan menambah relasi dan peluang.,positif,2022-04-29,2022,linkedin memberi kesempatan untuk terhubung dengan profesional dan menambah relasi dan peluang,12,12,linkedin memberi kesempatan untuk terhubung dengan profesional dan menambah relasi dan peluang,12,12,"['linkedin', 'memberi', 'kesempatan', 'untuk', 'terhubung', 'dengan', 'profesional', 'dan', 'menambah', 'relasi', 'dan', 'peluang']","['linkedin', 'kesempatan', 'terhubung', 'profesional', 'menambah', 'relasi', 'peluang']",12,7,5,linkedin sempat hubung profesional tambah relasi peluang,7,7
Link ini bagus untuk org2 yang sedang mencari pekerjaan dan membuka lowongan kerja,positif,2020-05-07,2020,link ini bagus untuk org yang sedang mencari pekerjaan dan membuka lowongan kerja,13,13,link ini bagus untuk orang yang sedang mencari pekerjaan dan membuka lowongan kerja,13,13,"['link', 'ini', 'bagus', 'untuk', 'orang', 'yang', 'sedang', 'mencari', 'pekerjaan', 'dan', 'membuka', 'lowongan', 'kerja']","['link', 'bagus', 'orang', 'mencari', 'pekerjaan', 'membuka', 'lowongan', 'kerja']",13,8,5,link bagus orang cari kerja buka lowong kerja,8,8
Suruh diperbarui ko tapi tetep ga bisa...yach.. payah,negatif,2020-12-08,2020,suruh diperbarui ko tapi tetep ga bisa yach payah,8,9,suruh diperbarui kok tapi tetap tidak bisa yach payah,9,9,"['suruh', 'diperbarui', 'kok', 'tapi', 'tetap', 'tidak', 'bisa', 'yach', 'payah']","['suruh', 'diperbarui', 'tidak', 'yach', 'payah']",9,5,4,suruh baru tidak yach payah,5,5
Gak nyangka daftar LinkedIn data bisa bocor wkwkwkwk banyak banget chat WhatsApp yg mau coba melakukan penipuan ke wa gw,negatif,2022-09-10,2022,gak nyangka daftar linkedin data bisa bocor wkwkwkwk banyak banget chat whatsapp yg mau coba melakukan penipuan ke wa gw,20,20,tidak nyangka daftar linkedin data bisa bocor wkwkwkwk banyak banget chat whatsapp yang mau coba melakukan penipuan ke whatsapp saya,20,20,"['tidak', 'nyangka', 'daftar', 'linkedin', 'data', 'bisa', 'bocor', 'wkwkwkwk', 'banyak', 'banget', 'chat', 'whatsapp', 'yang', 'mau', 'coba', 'melakukan', 'penipuan', 'ke', 'whatsapp', 'saya']","['tidak', 'nyangka', 'daftar', 'linkedin', 'data', 'bocor', 'wkwkwkwk', 'banget', 'chat', 'whatsapp', 'coba', 'penipuan', 'whatsapp']",20,13,7,tidak nyangka daftar linkedin data bocor wkwkwkwk banget chat whatsapp coba tipu whatsapp,13,13
"sampai kapan gangguan ya? kok keterangan ""kesalahan ada pada kami"" terus",negatif,2020-09-13,2020,sampai kapan gangguan ya kok keterangan kesalahan ada pada kami terus,11,11,sampai kapan gangguan ya kok keterangan kesalahan ada pada kami terus,11,11,"['sampai', 'kapan', 'gangguan', 'ya', 'kok', 'keterangan', 'kesalahan', 'ada', 'pada', 'kami', 'terus']","['gangguan', 'ya', 'keterangan', 'kesalahan']",11,4,7,ganggu ya terang salah,4,4
Mau langganan kok makin mahal cuk. Masa 1jt/ bulan,negatif,2022-10-21,2022,mau langganan kok makin mahal cuk masa jt bulan,9,9,mau langganan kok makin mahal cuk masa jt bulan,9,9,"['mau', 'langganan', 'kok', 'makin', 'mahal', 'cuk', 'masa', 'jt', 'bulan']","['langganan', 'mahal', 'cuk', 'jt']",9,4,5,langgan mahal cuk jt,4,4
aplikasi kurang oke selalu minta di instal,negatif,2020-07-25,2020,aplikasi kurang oke selalu minta di instal,7,7,aplikasi kurang oke selalu minta di memasang,7,7,"['aplikasi', 'kurang', 'oke', 'selalu', 'minta', 'di', 'memasang']","['aplikasi', 'oke', 'memasang']",7,3,4,aplikasi oke pasang,3,3
Banyak pengalaman di sini tapi tidak bisa di ungkapan semuanya,positif,2021-12-26,2021,banyak pengalaman di sini tapi tidak bisa di ungkapan semuanya,10,10,banyak pengalaman di sini tapi tidak bisa di ungkapan semuanya,10,10,"['banyak', 'pengalaman', 'di', 'sini', 'tapi', 'tidak', 'bisa', 'di', 'ungkapan', 'semuanya']","['pengalaman', 'tidak', 'ungkapan']",10,3,7,alam tidak ungkap,3,3
Eh Aplikasi anjnggggggg.... sudah 2 juta lebih kau tarik saldoku. aplkasi penipu. jangan download aplikasi biadab ini,negatif,2023-01-07,2023,eh aplikasi anjnggggggg sudah juta lebih kau tarik saldoku aplkasi penipu jangan download aplikasi biadab ini,17,16,eh aplikasi anjnggggggg sudah juta lebih kau tarik saldoku aplkasi penipu jangan unduh aplikasi biadab ini,16,16,"['eh', 'aplikasi', 'anjnggggggg', 'sudah', 'juta', 'lebih', 'kau', 'tarik', 'saldoku', 'aplkasi', 'penipu', 'jangan', 'unduh', 'aplikasi', 'biadab', 'ini']","['eh', 'aplikasi', 'anjnggggggg', 'juta', 'kau', 'tarik', 'saldoku', 'aplkasi', 'penipu', 'unduh', 'aplikasi', 'biadab']",16,12,4,eh aplikasi anjnggggggg juta kau tarik saldo aplkasi tipu unduh aplikasi biadab,12,12
Makin susah daftar dan edit profil nya,negatif,2022-05-16,2022,makin susah daftar dan edit profil nya,7,7,makin susah daftar dan edit profil nya,7,7,"['makin', 'susah', 'daftar', 'dan', 'edit', 'profil', 'nya']","['susah', 'daftar', 'edit', 'profil', 'nya']",7,5,2,susah daftar edit profil nya,5,5
"tidak dapat menyimpan keterangan jenis bidang perusahaan yang sesuai dengan tempat yg saat ini saya sedang bekerja ,",negatif,2022-09-05,2022,tidak dapat menyimpan keterangan jenis bidang perusahaan yang sesuai dengan tempat yg saat ini saya sedang bekerja,18,17,tidak dapat menyimpan keterangan jenis bidang perusahaan yang sesuai dengan tempat yang saat ini saya sedang bekerja,17,17,"['tidak', 'dapat', 'menyimpan', 'keterangan', 'jenis', 'bidang', 'perusahaan', 'yang', 'sesuai', 'dengan', 'tempat', 'yang', 'saat', 'ini', 'saya', 'sedang', 'bekerja']","['tidak', 'menyimpan', 'keterangan', 'jenis', 'bidang', 'perusahaan', 'sesuai']",17,7,10,tidak simpan terang jenis bidang usaha sesuai,7,7
Sangay membantu jobseekers untuk mencari kerja,positif,2021-08-26,2021,sangay membantu jobseekers untuk mencari kerja,6,6,sangay membantu jobseekers untuk mencari kerja,6,6,"['sangay', 'membantu', 'jobseekers', 'untuk', 'mencari', 'kerja']","['sangay', 'membantu', 'jobseekers', 'mencari', 'kerja']",6,5,1,sangay bantu jobseekers cari kerja,5,5
tolong pihak linkedin banned akun yg bernama Asi Dwi Setianingrum. kenapa beliau ambil no.saya sbg masuk di aplikasi ini.. atau saya bkl lapor ke pihak berwajib.,positif,2020-07-17,2020,tolong pihak linkedin banned akun yg bernama asi dwi setianingrum kenapa beliau ambil no saya sbg masuk di aplikasi ini atau saya bkl lapor ke pihak berwajib,26,27,tolong pihak linkedin banned akun yang bernama asi dwi setianingrum kenapa beliau ambil nomor saya sebagai masuk di aplikasi ini atau saya akan lapor ke pihak berwajib,27,27,"['tolong', 'pihak', 'linkedin', 'banned', 'akun', 'yang', 'bernama', 'asi', 'dwi', 'setianingrum', 'kenapa', 'beliau', 'ambil', 'nomor', 'saya', 'sebagai', 'masuk', 'di', 'aplikasi', 'ini', 'atau', 'saya', 'akan', 'lapor', 'ke', 'pihak', 'berwajib']","['tolong', 'linkedin', 'banned', 'akun', 'bernama', 'asi', 'dwi', 'setianingrum', 'beliau', 'ambil', 'nomor', 'masuk', 'aplikasi', 'lapor', 'berwajib']",27,15,12,tolong linkedin banned akun nama asi dwi setianingrum beliau ambil nomor masuk aplikasi lapor wajib,15,15
Sangat membantu mencari pekerjaan,negatif,2020-06-12,2020,sangat membantu mencari pekerjaan,4,4,sangat membantu mencari pekerjaan,4,4,"['sangat', 'membantu', 'mencari', 'pekerjaan']","['membantu', 'mencari', 'pekerjaan']",4,3,1,bantu cari kerja,3,3
"Setelah di download terus mau pembuatan akunnya susah banget ada verivikasinya terlebih dahulu yang terus muter-muter pertanyaannya ""apakah anda manusia?""",negatif,2021-07-20,2021,setelah di download terus mau pembuatan akunnya susah banget ada verivikasinya terlebih dahulu yang terus muter muter pertanyaannya apakah anda manusia,20,21,setelah di unduh terus mau pembuatan akunnya susah banget ada verivikasinya terlebih dahulu yang terus memutar memutar pertanyaannya apakah anda manusia,21,21,"['setelah', 'di', 'unduh', 'terus', 'mau', 'pembuatan', 'akunnya', 'susah', 'banget', 'ada', 'verivikasinya', 'terlebih', 'dahulu', 'yang', 'terus', 'memutar', 'memutar', 'pertanyaannya', 'apakah', 'anda', 'manusia']","['unduh', 'pembuatan', 'akunnya', 'susah', 'banget', 'verivikasinya', 'memutar', 'memutar', 'pertanyaannya', 'manusia']",21,10,11,unduh buat akun susah banget verivikasinya putar putar tanya manusia,10,10
Sangat membantu mencari pekerjaan,positif,2020-02-14,2020,sangat membantu mencari pekerjaan,4,4,sangat membantu mencari pekerjaan,4,4,"['sangat', 'membantu', 'mencari', 'pekerjaan']","['membantu', 'mencari', 'pekerjaan']",4,3,1,bantu cari kerja,3,3
Sangat mudah untuk mendapatkan info loker,positif,2021-12-16,2021,sangat mudah untuk mendapatkan info loker,6,6,sangat mudah untuk mendapatkan informasi loker,6,6,"['sangat', 'mudah', 'untuk', 'mendapatkan', 'informasi', 'loker']","['mudah', 'informasi', 'loker']",6,3,3,mudah informasi loker,3,3
"LinkedIn sering membatasi pertemanan, jika ada level director yang berteman dengan kita, langsung di batalkan oleh pihak LinkedIn.",negatif,2021-05-23,2021,linkedin sering membatasi pertemanan jika ada level director yang berteman dengan kita langsung di batalkan oleh pihak linkedin,18,18,linkedin sering membatasi pertemanan jika ada level director yang berteman dengan kita langsung di batalkan oleh pihak linkedin,18,18,"['linkedin', 'sering', 'membatasi', 'pertemanan', 'jika', 'ada', 'level', 'director', 'yang', 'berteman', 'dengan', 'kita', 'langsung', 'di', 'batalkan', 'oleh', 'pihak', 'linkedin']","['linkedin', 'membatasi', 'pertemanan', 'level', 'director', 'berteman', 'langsung', 'batalkan', 'linkedin']",18,9,9,linkedin batas teman level director teman langsung batal linkedin,9,9
susah banget verifikasi manusia nyaa 😭😭 udh coba berkali kali tetep salah muluu 😭😭😭,negatif,2021-05-31,2021,susah banget verifikasi manusia nyaa udh coba berkali kali tetep salah muluu,14,12,susah banget verifikasi manusia nyaa sudah coba berkali kali tetap salah muluu,12,12,"['susah', 'banget', 'verifikasi', 'manusia', 'nyaa', 'sudah', 'coba', 'berkali', 'kali', 'tetap', 'salah', 'muluu']","['susah', 'banget', 'verifikasi', 'manusia', 'nyaa', 'coba', 'berkali', 'kali', 'salah', 'muluu']",12,10,2,susah banget verifikasi manusia nyaa coba kali kali salah muluu,10,10
"Sangat berguna, bgi yg mencari pekerjaan..",positif,2020-07-19,2020,sangat berguna bgi yg mencari pekerjaan,6,6,sangat berguna bgi yang mencari pekerjaan,6,6,"['sangat', 'berguna', 'bgi', 'yang', 'mencari', 'pekerjaan']","['berguna', 'bgi', 'mencari', 'pekerjaan']",6,4,2,guna bgi cari kerja,4,4
"Dengan adanya platform ini membantu bagi staf ahli dalam mencari pekerjaan dan memberikan informasi keahlianya bagi pencari tenaga kerja ahli, jadi saling membutuhkan",positif,2021-11-10,2021,dengan adanya platform ini membantu bagi staf ahli dalam mencari pekerjaan dan memberikan informasi keahlianya bagi pencari tenaga kerja ahli jadi saling membutuhkan,23,23,dengan adanya platform ini membantu bagi staf ahli dalam mencari pekerjaan dan memberikan informasi keahlianya bagi pencari tenaga kerja ahli jadi saling membutuhkan,23,23,"['dengan', 'adanya', 'platform', 'ini', 'membantu', 'bagi', 'staf', 'ahli', 'dalam', 'mencari', 'pekerjaan', 'dan', 'memberikan', 'informasi', 'keahlianya', 'bagi', 'pencari', 'tenaga', 'kerja', 'ahli', 'jadi', 'saling', 'membutuhkan']","['platform', 'membantu', 'staf', 'ahli', 'mencari', 'pekerjaan', 'informasi', 'keahlianya', 'pencari', 'tenaga', 'kerja', 'ahli', 'membutuhkan']",23,13,10,platform bantu staf ahli cari kerja informasi keahlianya cari tenaga kerja ahli butuh,13,13
Search terbatas kecuali premium.,negatif,2022-10-13,2022,search terbatas kecuali premium,4,4,search terbatas kecuali premium,4,4,"['search', 'terbatas', 'kecuali', 'premium']","['search', 'terbatas', 'kecuali', 'premium']",4,4,0,search batas kecuali premium,4,4
sangat memuaskan meskipun belum ada hasil,positif,2021-07-19,2021,sangat memuaskan meskipun belum ada hasil,6,6,sangat memuaskan meskipun belum ada hasil,6,6,"['sangat', 'memuaskan', 'meskipun', 'belum', 'ada', 'hasil']","['memuaskan', 'hasil']",6,2,4,muas hasil,2,2
Login aja verifikasinya susah banget. Hadeh,negatif,2022-11-26,2022,login aja verifikasinya susah banget hadeh,6,6,login saja verifikasinya susah banget hadeh,6,6,"['login', 'saja', 'verifikasinya', 'susah', 'banget', 'hadeh']","['login', 'verifikasinya', 'susah', 'banget', 'hadeh']",6,5,1,login verifikasi susah banget hadeh,5,5
"Bagus sekali apk nya,mantap👍👍👍👍",positif,2022-05-14,2022,bagus sekali apk nya mantap,4,5,bagus sekali aplikasi nya mantap,5,5,"['bagus', 'sekali', 'aplikasi', 'nya', 'mantap']","['bagus', 'aplikasi', 'nya', 'mantap']",5,4,1,bagus aplikasi nya mantap,4,4
Lupa pasword mau login ulang minta verifikasi gambar tapi gagal terus,negatif,2022-08-01,2022,lupa pasword mau login ulang minta verifikasi gambar tapi gagal terus,11,11,lupa pasword mau login ulang minta verifikasi gambar tapi gagal terus,11,11,"['lupa', 'pasword', 'mau', 'login', 'ulang', 'minta', 'verifikasi', 'gambar', 'tapi', 'gagal', 'terus']","['lupa', 'pasword', 'login', 'ulang', 'verifikasi', 'gambar', 'gagal']",11,7,4,lupa pasword login ulang verifikasi gambar gagal,7,7
semoga saya bisa cepat dapat kerjaan melalui aplikasi Linkedln ini...aammiinnn,positif,2020-06-10,2020,semoga saya bisa cepat dapat kerjaan melalui aplikasi linkedln ini aammiinnn,10,11,semoga saya bisa cepat dapat kerjaan melalui aplikasi linkedln ini aammiinnn,11,11,"['semoga', 'saya', 'bisa', 'cepat', 'dapat', 'kerjaan', 'melalui', 'aplikasi', 'linkedln', 'ini', 'aammiinnn']","['semoga', 'cepat', 'kerjaan', 'aplikasi', 'linkedln', 'aammiinnn']",11,6,5,moga cepat kerja aplikasi linkedln aammiinnn,6,6
Sangat membantu pra perjuang mencari kerja,positif,2022-06-29,2022,sangat membantu pra perjuang mencari kerja,6,6,sangat membantu pra perjuang mencari kerja,6,6,"['sangat', 'membantu', 'pra', 'perjuang', 'mencari', 'kerja']","['membantu', 'pra', 'perjuang', 'mencari', 'kerja']",6,5,1,bantu pra juang cari kerja,5,5
"Vangke verifikasi gambar segala gua g masuk bisa akses link gw, verifikasi yg bener dong",negatif,2021-12-29,2021,vangke verifikasi gambar segala gua g masuk bisa akses link gw verifikasi yg bener dong,15,15,vangke verifikasi gambar segala saya tidak masuk bisa akses link saya verifikasi yang benar dong,15,15,"['vangke', 'verifikasi', 'gambar', 'segala', 'saya', 'tidak', 'masuk', 'bisa', 'akses', 'link', 'saya', 'verifikasi', 'yang', 'benar', 'dong']","['vangke', 'verifikasi', 'gambar', 'tidak', 'masuk', 'akses', 'link', 'verifikasi']",15,8,7,vangke verifikasi gambar tidak masuk akses link verifikasi,8,8
"Jelek kesalahan login terus, mending lewat web",negatif,2021-09-24,2021,jelek kesalahan login terus mending lewat web,7,7,jelek kesalahan login terus mending lewat web,7,7,"['jelek', 'kesalahan', 'login', 'terus', 'mending', 'lewat', 'web']","['jelek', 'kesalahan', 'login', 'mending', 'web']",7,5,2,jelek salah login mending web,5,5
"baru instal, tapi gak bisa daftar",negatif,2021-01-03,2021,baru instal tapi gak bisa daftar,6,6,baru memasang tapi tidak bisa daftar,6,6,"['baru', 'memasang', 'tapi', 'tidak', 'bisa', 'daftar']","['memasang', 'tidak', 'daftar']",6,3,3,pasang tidak daftar,3,3
Gk bisa log in tiap log in keluar terus,negatif,2021-08-29,2021,gk bisa log in tiap log in keluar terus,9,9,tidak bisa log in tiap log in keluar terus,9,9,"['tidak', 'bisa', 'log', 'in', 'tiap', 'log', 'in', 'keluar', 'terus']","['tidak', 'log', 'in', 'log', 'in']",9,5,4,tidak log in log in,5,5
Belum begitu paham tapi entak knapa aku merasa nyaman di Linkedln Mensos mositif,negatif,2020-07-08,2020,belum begitu paham tapi entak knapa aku merasa nyaman di linkedln mensos mositif,13,13,belum begitu paham tapi entak kenapa aku merasa nyaman di linkedln mensos mositif,13,13,"['belum', 'begitu', 'paham', 'tapi', 'entak', 'kenapa', 'aku', 'merasa', 'nyaman', 'di', 'linkedln', 'mensos', 'mositif']","['paham', 'entak', 'nyaman', 'linkedln', 'mensos', 'mositif']",13,6,7,paham entak nyaman linkedln mensos mositif,6,6
LinkedIn sangat bagus dapat membantu seseorang untuk mencari pekerjaan online,positif,2023-07-05,2023,linkedin sangat bagus dapat membantu seseorang untuk mencari pekerjaan online,10,10,linkedin sangat bagus dapat membantu seseorang untuk mencari pekerjaan daring,10,10,"['linkedin', 'sangat', 'bagus', 'dapat', 'membantu', 'seseorang', 'untuk', 'mencari', 'pekerjaan', 'daring']","['linkedin', 'bagus', 'membantu', 'mencari', 'pekerjaan', 'daring']",10,6,4,linkedin bagus bantu cari kerja daring,6,6
Kok nggk bisa kirim nomor hp padahal nomor gue aktif terus kenapa kirim kode verifikasi lama banget,negatif,2023-04-04,2023,kok nggk bisa kirim nomor hp padahal nomor gue aktif terus kenapa kirim kode verifikasi lama banget,17,17,kok tidak bisa kirim nomor handphone padahal nomor saya aktif terus kenapa kirim kode verifikasi lama banget,17,17,"['kok', 'tidak', 'bisa', 'kirim', 'nomor', 'handphone', 'padahal', 'nomor', 'saya', 'aktif', 'terus', 'kenapa', 'kirim', 'kode', 'verifikasi', 'lama', 'banget']","['tidak', 'kirim', 'nomor', 'handphone', 'nomor', 'aktif', 'kirim', 'kode', 'verifikasi', 'banget']",17,10,7,tidak kirim nomor handphone nomor aktif kirim kode verifikasi banget,10,10
Aplikasi yang sangat tidak ada gunanya sangat merugikan,negatif,2021-07-20,2021,aplikasi yang sangat tidak ada gunanya sangat merugikan,8,8,aplikasi yang sangat tidak ada gunanya sangat merugikan,8,8,"['aplikasi', 'yang', 'sangat', 'tidak', 'ada', 'gunanya', 'sangat', 'merugikan']","['aplikasi', 'tidak', 'gunanya', 'merugikan']",8,4,4,aplikasi tidak guna rugi,4,4
Belum pernah punya pengalaman mendapatkan pekerjaan dari Linkedn,negatif,2022-05-23,2022,belum pernah punya pengalaman mendapatkan pekerjaan dari linkedn,8,8,belum pernah punya pengalaman mendapatkan pekerjaan dari linkedn,8,8,"['belum', 'pernah', 'punya', 'pengalaman', 'mendapatkan', 'pekerjaan', 'dari', 'linkedn']","['pengalaman', 'pekerjaan', 'linkedn']",8,3,5,alam kerja linkedn,3,3
"orang nyari kerja bukan Lamah harus ngisi data kerjaan dan pt tempat kerja,, aplikasi aneuh",negatif,2020-09-03,2020,orang nyari kerja bukan lamah harus ngisi data kerjaan dan pt tempat kerja aplikasi aneuh,15,15,orang mencari kerja bukan lamah harus mengisi data kerjaan dan perseroan terbatas tempat kerja aplikasi aneuh,15,16,"['orang', 'mencari', 'kerja', 'bukan', 'lamah', 'harus', 'mengisi', 'data', 'kerjaan', 'dan', 'perseroan', 'terbatas', 'tempat', 'kerja', 'aplikasi', 'aneuh']","['orang', 'mencari', 'kerja', 'lamah', 'mengisi', 'data', 'kerjaan', 'perseroan', 'terbatas', 'kerja', 'aplikasi', 'aneuh']",16,12,4,orang cari kerja lamah isi data kerja persero batas kerja aplikasi aneuh,12,12
"Lumayan muda mudahan dapat kerja,",positif,2020-11-20,2020,lumayan muda mudahan dapat kerja,5,5,lumayan muda mudahan dapat kerja,5,5,"['lumayan', 'muda', 'mudahan', 'dapat', 'kerja']","['lumayan', 'muda', 'mudahan', 'kerja']",5,4,1,lumayan muda mudah kerja,4,4
Aplikasi tidak bisa di hapus padahal pake pe lang Me palang palangem bae,negatif,2022-12-30,2022,aplikasi tidak bisa di hapus padahal pake pe lang me palang palangem bae,13,13,aplikasi tidak bisa di hapus padahal pakai pe hilang me palang palangem bae,13,13,"['aplikasi', 'tidak', 'bisa', 'di', 'hapus', 'padahal', 'pakai', 'pe', 'hilang', 'me', 'palang', 'palangem', 'bae']","['aplikasi', 'tidak', 'hapus', 'pakai', 'pe', 'hilang', 'me', 'palang', 'palangem', 'bae']",13,10,3,aplikasi tidak hapus pakai pe hilang me palang palangem bae,10,10
"Mau login ko verivikasi trus sih, udah gitu ulang ulang trus",negatif,2023-07-28,2023,mau login ko verivikasi trus sih udah gitu ulang ulang trus,11,11,mau login kok verivikasi terus sih sudah begitu ulang ulang terus,11,11,"['mau', 'login', 'kok', 'verivikasi', 'terus', 'sih', 'sudah', 'begitu', 'ulang', 'ulang', 'terus']","['login', 'verivikasi', 'sih', 'ulang', 'ulang']",11,5,6,login verivikasi sih ulang ulang,5,5
Baik untuk komonikasi info pekerjaan,positif,2022-01-29,2022,baik untuk komonikasi info pekerjaan,5,5,baik untuk komonikasi informasi pekerjaan,5,5,"['baik', 'untuk', 'komonikasi', 'informasi', 'pekerjaan']","['komonikasi', 'informasi', 'pekerjaan']",5,3,2,komonikasi informasi kerja,3,3
Sangat membantu untuk promosi produk kita,positif,2021-04-17,2021,sangat membantu untuk promosi produk kita,6,6,sangat membantu untuk promosi produk kita,6,6,"['sangat', 'membantu', 'untuk', 'promosi', 'produk', 'kita']","['membantu', 'promosi', 'produk']",6,3,3,bantu promosi produk,3,3
Aplikasih bagus untuk mecari kerja,positif,2020-06-16,2020,aplikasih bagus untuk mecari kerja,5,5,aplikasih bagus untuk mecari kerja,5,5,"['aplikasih', 'bagus', 'untuk', 'mecari', 'kerja']","['aplikasih', 'bagus', 'mecari', 'kerja']",5,4,1,aplikasih bagus mecari kerja,4,4
Apk yg sangat bagus dan bisa membantu,positif,2021-04-05,2021,apk yg sangat bagus dan bisa membantu,7,7,aplikasi yang sangat bagus dan bisa membantu,7,7,"['aplikasi', 'yang', 'sangat', 'bagus', 'dan', 'bisa', 'membantu']","['aplikasi', 'bagus', 'membantu']",7,3,4,aplikasi bagus bantu,3,3
Lumayan kalau bisa penipuan kerja online bisa disaring kasihan kawan kawan pencari kerja terima kasih,positif,2020-02-28,2020,lumayan kalau bisa penipuan kerja online bisa disaring kasihan kawan kawan pencari kerja terima kasih,15,15,lumayan kalau bisa penipuan kerja daring bisa disaring kasihan kawan kawan pencari kerja terima kasih,15,15,"['lumayan', 'kalau', 'bisa', 'penipuan', 'kerja', 'daring', 'bisa', 'disaring', 'kasihan', 'kawan', 'kawan', 'pencari', 'kerja', 'terima', 'kasih']","['lumayan', 'penipuan', 'kerja', 'daring', 'disaring', 'kasihan', 'kawan', 'kawan', 'pencari', 'kerja', 'terima', 'kasih']",15,12,3,lumayan tipu kerja daring saring kasihan kawan kawan cari kerja terima kasih,12,12
MAU DAFTAR AJA DIPERSULIT... MASA SUSAH BANGET MAU VERIFIKASI AJA!!!!!!,negatif,2023-03-21,2023,mau daftar aja dipersulit masa susah banget mau verifikasi aja,10,10,mau daftar saja dipersulit masa susah banget mau verifikasi saja,10,10,"['mau', 'daftar', 'saja', 'dipersulit', 'masa', 'susah', 'banget', 'mau', 'verifikasi', 'saja']","['daftar', 'dipersulit', 'susah', 'banget', 'verifikasi']",10,5,5,daftar sulit susah banget verifikasi,5,5
Membantu banget buat pencari kerja,positif,2022-07-29,2022,membantu banget buat pencari kerja,5,5,membantu banget buat pencari kerja,5,5,"['membantu', 'banget', 'buat', 'pencari', 'kerja']","['membantu', 'banget', 'pencari', 'kerja']",5,4,1,bantu banget cari kerja,4,4
Ini kenapa saya tidak bisa schedule post ya? Nanti setelah bisa saya kasih bintang 5,negatif,2023-02-16,2023,ini kenapa saya tidak bisa schedule post ya nanti setelah bisa saya kasih bintang,15,14,ini kenapa saya tidak bisa schedule post ya nanti setelah bisa saya kasih bintang,14,14,"['ini', 'kenapa', 'saya', 'tidak', 'bisa', 'schedule', 'post', 'ya', 'nanti', 'setelah', 'bisa', 'saya', 'kasih', 'bintang']","['tidak', 'schedule', 'post', 'ya', 'kasih', 'bintang']",14,6,8,tidak schedule post ya kasih bintang,6,6
Profil gak bisa diperbarui. Sudah kirim email gak ada balesan,negatif,2022-08-29,2022,profil gak bisa diperbarui sudah kirim email gak ada balesan,10,10,profil tidak bisa diperbarui sudah kirim email tidak ada balesan,10,10,"['profil', 'tidak', 'bisa', 'diperbarui', 'sudah', 'kirim', 'email', 'tidak', 'ada', 'balesan']","['profil', 'tidak', 'diperbarui', 'kirim', 'email', 'tidak', 'balesan']",10,7,3,profil tidak baru kirim email tidak balesan,7,7
Mau daftar dah pake 3 data masih g bisa...payah,negatif,2021-05-31,2021,mau daftar dah pake data masih g bisa payah,9,9,mau daftar sudah pakai data masih tidak bisa payah,9,9,"['mau', 'daftar', 'sudah', 'pakai', 'data', 'masih', 'tidak', 'bisa', 'payah']","['daftar', 'pakai', 'data', 'tidak', 'payah']",9,5,4,daftar pakai data tidak payah,5,5
Bagus.. untuk melihat profile dari setiap individu dengan berbagai macam prosesi secara profesional di bidang masing masing individu,positif,2020-07-21,2020,bagus untuk melihat profile dari setiap individu dengan berbagai macam prosesi secara profesional di bidang masing masing individu,18,18,bagus untuk melihat profile dari setiap individu dengan berbagai macam prosesi secara profesional di bidang masing masing individu,18,18,"['bagus', 'untuk', 'melihat', 'profile', 'dari', 'setiap', 'individu', 'dengan', 'berbagai', 'macam', 'prosesi', 'secara', 'profesional', 'di', 'bidang', 'masing', 'masing', 'individu']","['bagus', 'profile', 'individu', 'prosesi', 'profesional', 'bidang', 'individu']",18,7,11,bagus profile individu prosesi profesional bidang individu,7,7
Senang dgn linked bisa menambah informasi dan sahabat,positif,2022-02-04,2022,senang dgn linked bisa menambah informasi dan sahabat,8,8,senang dengan linked bisa menambah informasi dan sahabat,8,8,"['senang', 'dengan', 'linked', 'bisa', 'menambah', 'informasi', 'dan', 'sahabat']","['senang', 'linked', 'menambah', 'informasi', 'sahabat']",8,5,3,senang linked tambah informasi sahabat,5,5
"Tolong iklan di youtubenya jangan keseringan, GANGGU COK",negatif,2022-04-05,2022,tolong iklan di youtubenya jangan keseringan ganggu cok,8,8,tolong iklan di youtubenya jangan keseringan ganggu cok,8,8,"['tolong', 'iklan', 'di', 'youtubenya', 'jangan', 'keseringan', 'ganggu', 'cok']","['tolong', 'iklan', 'youtubenya', 'keseringan', 'ganggu', 'cok']",8,6,2,tolong iklan youtubenya sering ganggu cok,6,6
Terus terang saya kesulitan buat masuk karna adanya teka teki kodok itu. saya kasih bintang 1 aja.,negatif,2022-01-29,2022,terus terang saya kesulitan buat masuk karna adanya teka teki kodok itu saya kasih bintang aja,17,16,terus terang saya kesulitan buat masuk karena adanya teka teki kodok itu saya kasih bintang saja,16,16,"['terus', 'terang', 'saya', 'kesulitan', 'buat', 'masuk', 'karena', 'adanya', 'teka', 'teki', 'kodok', 'itu', 'saya', 'kasih', 'bintang', 'saja']","['terang', 'kesulitan', 'masuk', 'teka', 'teki', 'kodok', 'kasih', 'bintang']",16,8,8,terang sulit masuk teka teki kodok kasih bintang,8,8
"Verifikasi gak ngotak, udah benar masi aja verifikasi",negatif,2023-04-20,2023,verifikasi gak ngotak udah benar masi aja verifikasi,8,8,verifikasi tidak ngotak sudah benar masih saja verifikasi,8,8,"['verifikasi', 'tidak', 'ngotak', 'sudah', 'benar', 'masih', 'saja', 'verifikasi']","['verifikasi', 'tidak', 'ngotak', 'verifikasi']",8,4,4,verifikasi tidak ngotak verifikasi,4,4
Membantu cari pekerjaan info juga shared of job,positif,2022-04-14,2022,membantu cari pekerjaan info juga shared of job,8,8,membantu cari pekerjaan informasi juga shared of kerja,8,8,"['membantu', 'cari', 'pekerjaan', 'informasi', 'juga', 'shared', 'of', 'kerja']","['membantu', 'cari', 'pekerjaan', 'informasi', 'shared', 'of', 'kerja']",8,7,1,bantu cari kerja informasi shared of kerja,7,7
"bagus, bisa terhubung langsung dengan jajaran HRD nya",positif,2022-04-13,2022,bagus bisa terhubung langsung dengan jajaran hrd nya,8,8,bagus bisa terhubung langsung dengan jajaran hrd nya,8,8,"['bagus', 'bisa', 'terhubung', 'langsung', 'dengan', 'jajaran', 'hrd', 'nya']","['bagus', 'terhubung', 'langsung', 'jajaran', 'hrd', 'nya']",8,6,2,bagus hubung langsung jajar hrd nya,6,6
Mantap bisa terhubung ke semua negara. Dan banyak mempunyai teman dari luar negara. Meningkatkan hubungan bisnis yang bisa menjankau ke seluruh negara,positif,2020-12-21,2020,mantap bisa terhubung ke semua negara dan banyak mempunyai teman dari luar negara meningkatkan hubungan bisnis yang bisa menjankau ke seluruh negara,22,22,mantap bisa terhubung ke semua negara dan banyak mempunyai teman dari luar negara meningkatkan hubungan bisnis yang bisa menjankau ke seluruh negara,22,22,"['mantap', 'bisa', 'terhubung', 'ke', 'semua', 'negara', 'dan', 'banyak', 'mempunyai', 'teman', 'dari', 'luar', 'negara', 'meningkatkan', 'hubungan', 'bisnis', 'yang', 'bisa', 'menjankau', 'ke', 'seluruh', 'negara']","['mantap', 'terhubung', 'negara', 'teman', 'negara', 'meningkatkan', 'hubungan', 'bisnis', 'menjankau', 'negara']",22,10,12,mantap hubung negara teman negara tingkat hubung bisnis menjankau negara,10,10
"Gak bisa daftar terosssssssssssss, gagal membuat akun gitu aja terus",negatif,2021-09-08,2021,gak bisa daftar terosssssssssssss gagal membuat akun gitu aja terus,10,10,tidak bisa daftar terosssssssssssss gagal membuat akun begitu saja terus,10,10,"['tidak', 'bisa', 'daftar', 'terosssssssssssss', 'gagal', 'membuat', 'akun', 'begitu', 'saja', 'terus']","['tidak', 'daftar', 'terosssssssssssss', 'gagal', 'akun']",10,5,5,tidak daftar terosssssssssssss gagal akun,5,5
Sangat membagongkan kukira link untuk cari kerja ternyata permainan menebak gambar hewan jungkir balik,negatif,2023-08-06,2023,sangat membagongkan kukira link untuk cari kerja ternyata permainan menebak gambar hewan jungkir balik,14,14,sangat membagongkan kukira link untuk cari kerja ternyata permainan menebak gambar hewan jungkir balik,14,14,"['sangat', 'membagongkan', 'kukira', 'link', 'untuk', 'cari', 'kerja', 'ternyata', 'permainan', 'menebak', 'gambar', 'hewan', 'jungkir', 'balik']","['membagongkan', 'kukira', 'link', 'cari', 'kerja', 'permainan', 'menebak', 'gambar', 'hewan', 'jungkir']",14,10,4,bagong kira link cari kerja main tebak gambar hewan jungkir,10,10
"Cuma cocok untuk D3/S1 ,yg lulusan SMA SMK bisa apa",negatif,2023-01-19,2023,cuma cocok untuk d s yg lulusan sma smk bisa apa,10,11,cuma cocok untuk di s yang lulusan sama smk bisa apa,11,11,"['cuma', 'cocok', 'untuk', 'di', 's', 'yang', 'lulusan', 'sama', 'smk', 'bisa', 'apa']","['cocok', 's', 'lulusan', 'smk']",11,4,7,cocok s lulus smk,4,4
"Gak bisa login! Verifikasi gak bisa"".",negatif,2023-06-08,2023,gak bisa login verifikasi gak bisa,6,6,tidak bisa login verifikasi tidak bisa,6,6,"['tidak', 'bisa', 'login', 'verifikasi', 'tidak', 'bisa']","['tidak', 'login', 'verifikasi', 'tidak']",6,4,2,tidak login verifikasi tidak,4,4
App gajelas disuruh ngisi captcha malah ga pernah bisa,negatif,2023-08-12,2023,app gajelas disuruh ngisi captcha malah ga pernah bisa,9,9,aplikasi tidak jelas disuruh mengisi captcha bahkan tidak pernah bisa,9,10,"['aplikasi', 'tidak', 'jelas', 'disuruh', 'mengisi', 'captcha', 'bahkan', 'tidak', 'pernah', 'bisa']","['aplikasi', 'tidak', 'disuruh', 'mengisi', 'captcha', 'tidak']",10,6,4,aplikasi tidak suruh isi captcha tidak,6,6
Gimana sih cara melamar kerja di aplikasi ini Kok saya ngak ngerti ya cuma mengikuti aja Tolong kasih tau dong🙏 Sementara ini saya kasih bintang 2 dulu ya Karna saya blum paham,negatif,2020-01-26,2020,gimana sih cara melamar kerja di aplikasi ini kok saya ngak ngerti ya cuma mengikuti aja tolong kasih tau dong sementara ini saya kasih bintang dulu ya karna saya blum paham,32,31,bagaimana sih cara melamar kerja di aplikasi ini kok saya tidak mengerti ya cuma mengikuti saja tolong kasih tahu dong sementara ini saya kasih bintang dahulu ya karena saya belum paham,31,31,"['bagaimana', 'sih', 'cara', 'melamar', 'kerja', 'di', 'aplikasi', 'ini', 'kok', 'saya', 'tidak', 'mengerti', 'ya', 'cuma', 'mengikuti', 'saja', 'tolong', 'kasih', 'tahu', 'dong', 'sementara', 'ini', 'saya', 'kasih', 'bintang', 'dahulu', 'ya', 'karena', 'saya', 'belum', 'paham']","['sih', 'melamar', 'kerja', 'aplikasi', 'tidak', 'mengerti', 'ya', 'mengikuti', 'tolong', 'kasih', 'kasih', 'bintang', 'ya', 'paham']",31,14,17,sih lamar kerja aplikasi tidak erti ya ikut tolong kasih kasih bintang ya paham,14,14
Saya mau buat akun malah di bikin bolak balik terus di menu pendaftaran,negatif,2022-10-03,2022,saya mau buat akun malah di bikin bolak balik terus di menu pendaftaran,13,13,saya mau buat akun bahkan di bikin bolak balik terus di menu pendaftaran,13,13,"['saya', 'mau', 'buat', 'akun', 'bahkan', 'di', 'bikin', 'bolak', 'balik', 'terus', 'di', 'menu', 'pendaftaran']","['akun', 'bikin', 'bolak', 'menu', 'pendaftaran']",13,5,8,akun bikin bolak menu daftar,5,5
Aplikasi ampas!! Buat apa sih tes pemeriksaan dengan cepat? Bikin ribet anjengg!!!!,negatif,2021-11-10,2021,aplikasi ampas buat apa sih tes pemeriksaan dengan cepat bikin ribet anjengg,12,12,aplikasi ampas buat apa sih tes pemeriksaan dengan cepat bikin rumit anjengg,12,12,"['aplikasi', 'ampas', 'buat', 'apa', 'sih', 'tes', 'pemeriksaan', 'dengan', 'cepat', 'bikin', 'rumit', 'anjengg']","['aplikasi', 'ampas', 'sih', 'tes', 'pemeriksaan', 'cepat', 'bikin', 'rumit', 'anjengg']",12,9,3,aplikasi ampas sih tes periksa cepat bikin rumit anjengg,9,9
Lumayan untuk aplikasi ini. Sangat berfungsi,positif,2020-09-18,2020,lumayan untuk aplikasi ini sangat berfungsi,6,6,lumayan untuk aplikasi ini sangat berfungsi,6,6,"['lumayan', 'untuk', 'aplikasi', 'ini', 'sangat', 'berfungsi']","['lumayan', 'aplikasi', 'berfungsi']",6,3,3,lumayan aplikasi fungsi,3,3
"Keren banget, dan bisa mengkoneksikan dengan para perusahaan",positif,2021-08-19,2021,keren banget dan bisa mengkoneksikan dengan para perusahaan,8,8,keren banget dan bisa mengkoneksikan dengan para perusahaan,8,8,"['keren', 'banget', 'dan', 'bisa', 'mengkoneksikan', 'dengan', 'para', 'perusahaan']","['keren', 'banget', 'mengkoneksikan', 'perusahaan']",8,4,4,keren banget koneksi usaha,4,4
"Aplikasi ini sangat membantu , saya sudah mendapatkan pekerjaan dari applikasi ini",positif,2021-12-18,2021,aplikasi ini sangat membantu saya sudah mendapatkan pekerjaan dari applikasi ini,12,11,aplikasi ini sangat membantu saya sudah mendapatkan pekerjaan dari aplikasi ini,11,11,"['aplikasi', 'ini', 'sangat', 'membantu', 'saya', 'sudah', 'mendapatkan', 'pekerjaan', 'dari', 'aplikasi', 'ini']","['aplikasi', 'membantu', 'pekerjaan', 'aplikasi']",11,4,7,aplikasi bantu kerja aplikasi,4,4
apliksi ini sangat bagus dn membantu sekali,positif,2020-04-14,2020,apliksi ini sangat bagus dn membantu sekali,7,7,apliksi ini sangat bagus dan membantu sekali,7,7,"['apliksi', 'ini', 'sangat', 'bagus', 'dan', 'membantu', 'sekali']","['apliksi', 'bagus', 'membantu']",7,3,4,apliksi bagus bantu,3,3
"Aplikasi gak guna, gak bisa login",negatif,2024-02-17,2024,aplikasi gak guna gak bisa login,6,6,aplikasi tidak guna tidak bisa login,6,6,"['aplikasi', 'tidak', 'guna', 'tidak', 'bisa', 'login']","['aplikasi', 'tidak', 'tidak', 'login']",6,4,2,aplikasi tidak tidak login,4,4
Lebih tenang berada di linkedIn dan terarah,positif,2020-03-02,2020,lebih tenang berada di linkedin dan terarah,7,7,lebih tenang berasa di linkedin dan terarah,7,7,"['lebih', 'tenang', 'berasa', 'di', 'linkedin', 'dan', 'terarah']","['tenang', 'berasa', 'linkedin', 'terarah']",7,4,3,tenang asa linkedin arah,4,4
Lah mau daftar aja suruh cocokin gambar binatang mengahadap ke atas? Lu mau bikin app info loker apa mau bikin game puzzel? Hh unin aja dah,negatif,2022-03-03,2022,lah mau daftar aja suruh cocokin gambar binatang mengahadap ke atas lu mau bikin app info loker apa mau bikin game puzzel hh unin aja dah,26,26,lah mau daftar saja suruh cocokin gambar binatang mengahadap ke atas lu mau bikin aplikasi informasi loker apa mau bikin game puzzel hh unin saja sudah,26,26,"['lah', 'mau', 'daftar', 'saja', 'suruh', 'cocokin', 'gambar', 'binatang', 'mengahadap', 'ke', 'atas', 'lu', 'mau', 'bikin', 'aplikasi', 'informasi', 'loker', 'apa', 'mau', 'bikin', 'game', 'puzzel', 'hh', 'unin', 'saja', 'sudah']","['daftar', 'suruh', 'cocokin', 'gambar', 'binatang', 'mengahadap', 'lu', 'bikin', 'aplikasi', 'informasi', 'loker', 'bikin', 'game', 'puzzel', 'hh', 'unin']",26,16,10,daftar suruh cocokin gambar binatang mengahadap lu bikin aplikasi informasi loker bikin game puzzel hh unin,16,16
Daftar perusahaan menyakinkan...eh tahu2nya dapat pesan wa dapat panggilan ujungnya yayasan bilangnya bukan yayasan sama aja keluar duit,negatif,2022-01-05,2022,daftar perusahaan menyakinkan eh tahu nya dapat pesan wa dapat panggilan ujungnya yayasan bilangnya bukan yayasan sama aja keluar duit,18,20,daftar perusahaan menyakinkan eh tahu nya dapat pesan whatsapp dapat panggilan ujungnya yayasan bilangnya bukan yayasan sama saja keluar uang,20,20,"['daftar', 'perusahaan', 'menyakinkan', 'eh', 'tahu', 'nya', 'dapat', 'pesan', 'whatsapp', 'dapat', 'panggilan', 'ujungnya', 'yayasan', 'bilangnya', 'bukan', 'yayasan', 'sama', 'saja', 'keluar', 'uang']","['daftar', 'perusahaan', 'menyakinkan', 'eh', 'nya', 'pesan', 'whatsapp', 'panggilan', 'ujungnya', 'yayasan', 'bilangnya', 'yayasan', 'uang']",20,13,7,daftar usaha menyakinkan eh nya pesan whatsapp panggil ujung yayasan bilang yayasan uang,13,13
Sangat membantu untuk pekerjaan,positif,2021-02-21,2021,sangat membantu untuk pekerjaan,4,4,sangat membantu untuk pekerjaan,4,4,"['sangat', 'membantu', 'untuk', 'pekerjaan']","['membantu', 'pekerjaan']",4,2,2,bantu kerja,2,2
Mantap tapi belum dapat pangilan yang saya pilih😔,positif,2021-04-29,2021,mantap tapi belum dapat pangilan yang saya pilih,8,8,mantap tapi belum dapat pangilan yang saya pilih,8,8,"['mantap', 'tapi', 'belum', 'dapat', 'pangilan', 'yang', 'saya', 'pilih']","['mantap', 'pangilan', 'pilih']",8,3,5,mantap pangilan pilih,3,3
"Hi LinkedIn, terimakasih telah hadir memberikan ruang untuk berbagi ilmu dan pengalaman dari orang orang hebat.",positif,2021-02-17,2021,hi linkedin terimakasih telah hadir memberikan ruang untuk berbagi ilmu dan pengalaman dari orang orang hebat,16,16,halo linkedin terima kasih telah hadir memberikan ruang untuk berbagi ilmu dan pengalaman dari orang orang hebat,16,17,"['halo', 'linkedin', 'terima', 'kasih', 'telah', 'hadir', 'memberikan', 'ruang', 'untuk', 'berbagi', 'ilmu', 'dan', 'pengalaman', 'dari', 'orang', 'orang', 'hebat']","['halo', 'linkedin', 'terima', 'kasih', 'hadir', 'ruang', 'berbagi', 'ilmu', 'pengalaman', 'orang', 'orang', 'hebat']",17,12,5,halo linkedin terima kasih hadir ruang bagi ilmu alam orang orang hebat,12,12
Aplikasi yg sangat membantu saya mendapatkan pekerjaan.,positif,2020-09-09,2020,aplikasi yg sangat membantu saya mendapatkan pekerjaan,7,7,aplikasi yang sangat membantu saya mendapatkan pekerjaan,7,7,"['aplikasi', 'yang', 'sangat', 'membantu', 'saya', 'mendapatkan', 'pekerjaan']","['aplikasi', 'membantu', 'pekerjaan']",7,3,4,aplikasi bantu kerja,3,3
Tolong perbaiki masalah captcha,negatif,2023-08-16,2023,tolong perbaiki masalah captcha,4,4,tolong perbaikan masalah captcha,4,4,"['tolong', 'perbaikan', 'masalah', 'captcha']","['tolong', 'perbaikan', 'captcha']",4,3,1,tolong baik captcha,3,3
Terhubung dgn orang2 baru dan teman2 baru di seluruh Indonesia bah kan dunia,positif,2023-05-29,2023,terhubung dgn orang baru dan teman baru di seluruh indonesia bah kan dunia,13,13,terhubung dengan orang baru dan teman baru di seluruh indonesia bah akan dunia,13,13,"['terhubung', 'dengan', 'orang', 'baru', 'dan', 'teman', 'baru', 'di', 'seluruh', 'indonesia', 'bah', 'akan', 'dunia']","['terhubung', 'orang', 'teman', 'indonesia', 'bah', 'dunia']",13,6,7,hubung orang teman indonesia bah dunia,6,6
Aplikasinya mantap&sangat membantu saya dalam beraktifitas,positif,2020-09-10,2020,aplikasinya mantap sangat membantu saya dalam beraktifitas,6,7,aplikasi nya mantap sangat membantu saya dalam beraktifitas,7,8,"['aplikasi', 'nya', 'mantap', 'sangat', 'membantu', 'saya', 'dalam', 'beraktifitas']","['aplikasi', 'nya', 'mantap', 'membantu', 'beraktifitas']",8,5,3,aplikasi nya mantap bantu beraktifitas,5,5
"Untuk pengisian bio mahasiswa kok ada kendala ya? Katanya ""maaf ada terjadi kesalahan. Coba lagi?"" Coba lagi tapi tetep ga bisa",negatif,2021-01-27,2021,untuk pengisian bio mahasiswa kok ada kendala ya katanya maaf ada terjadi kesalahan coba lagi coba lagi tapi tetep ga bisa,21,21,untuk pengisian bio mahasiswa kok ada kendala ya katanya maaf ada terjadi kesalahan coba lagi coba lagi tapi tetap tidak bisa,21,21,"['untuk', 'pengisian', 'bio', 'mahasiswa', 'kok', 'ada', 'kendala', 'ya', 'katanya', 'maaf', 'ada', 'terjadi', 'kesalahan', 'coba', 'lagi', 'coba', 'lagi', 'tapi', 'tetap', 'tidak', 'bisa']","['pengisian', 'bio', 'mahasiswa', 'kendala', 'ya', 'maaf', 'kesalahan', 'coba', 'coba', 'tidak']",21,10,11,isi bio mahasiswa kendala ya maaf salah coba coba tidak,10,10
Blm prnah dpt pnggilan kerja tuhh blm jelas ni aplikasi ny,negatif,2022-04-07,2022,blm prnah dpt pnggilan kerja tuhh blm jelas ni aplikasi ny,11,11,belum pernah dapat pnggilan kerja tuhh belum jelas ini aplikasi nya,11,11,"['belum', 'pernah', 'dapat', 'pnggilan', 'kerja', 'tuhh', 'belum', 'jelas', 'ini', 'aplikasi', 'nya']","['pnggilan', 'kerja', 'tuhh', 'aplikasi', 'nya']",11,5,6,pnggilan kerja tuhh aplikasi nya,5,5
"Akun saya terkena pembatasan terus menerus sudah 2x buat akun, sudah kirim verifikasi tetap saja",negatif,2023-08-22,2023,akun saya terkena pembatasan terus menerus sudah x buat akun sudah kirim verifikasi tetap saja,15,15,akun saya terkena pembatasan terus menerus sudah x buat akun sudah kirim verifikasi tetap saja,15,15,"['akun', 'saya', 'terkena', 'pembatasan', 'terus', 'menerus', 'sudah', 'x', 'buat', 'akun', 'sudah', 'kirim', 'verifikasi', 'tetap', 'saja']","['akun', 'terkena', 'pembatasan', 'menerus', 'x', 'akun', 'kirim', 'verifikasi']",15,8,7,akun kena batas terus x akun kirim verifikasi,8,8
Saya Sangat Tertarik dengan artikel yang ada Sistem operasi android,positif,2021-01-27,2021,saya sangat tertarik dengan artikel yang ada sistem operasi android,10,10,saya sangat tertarik dengan artikel yang ada sistem operasi android,10,10,"['saya', 'sangat', 'tertarik', 'dengan', 'artikel', 'yang', 'ada', 'sistem', 'operasi', 'android']","['tertarik', 'artikel', 'sistem', 'operasi', 'android']",10,5,5,tarik artikel sistem operasi android,5,5
Tolong kembalikan Akun LinkedIn Punya Saya sekarang ini karena akun saya tidak bisa diberikan akses akun LinkedIn Punya saya Hingga tolong buat Pihak LinkedIn Tolong Diproses akun LinkedIn Punya saya untuk dikembalikan Secara Normal sekarang,negatif,2021-12-29,2021,tolong kembalikan akun linkedin punya saya sekarang ini karena akun saya tidak bisa diberikan akses akun linkedin punya saya hingga tolong buat pihak linkedin tolong diproses akun linkedin punya saya untuk dikembalikan secara normal sekarang,35,35,tolong kembalikan akun linkedin punya saya sekarang ini karena akun saya tidak bisa diberikan akses akun linkedin punya saya hingga tolong buat pihak linkedin tolong diproses akun linkedin punya saya untuk dikembalikan secara normal sekarang,35,35,"['tolong', 'kembalikan', 'akun', 'linkedin', 'punya', 'saya', 'sekarang', 'ini', 'karena', 'akun', 'saya', 'tidak', 'bisa', 'diberikan', 'akses', 'akun', 'linkedin', 'punya', 'saya', 'hingga', 'tolong', 'buat', 'pihak', 'linkedin', 'tolong', 'diproses', 'akun', 'linkedin', 'punya', 'saya', 'untuk', 'dikembalikan', 'secara', 'normal', 'sekarang']","['tolong', 'kembalikan', 'akun', 'linkedin', 'akun', 'tidak', 'akses', 'akun', 'linkedin', 'tolong', 'linkedin', 'tolong', 'diproses', 'akun', 'linkedin', 'dikembalikan', 'normal']",35,17,18,tolong kembali akun linkedin akun tidak akses akun linkedin tolong linkedin tolong proses akun linkedin kembali normal,17,17
Wah saya sangat senang dan bagus dalam mencari kerja sangat mudah,positif,2023-08-10,2023,wah saya sangat senang dan bagus dalam mencari kerja sangat mudah,11,11,wah saya sangat senang dan bagus dalam mencari kerja sangat mudah,11,11,"['wah', 'saya', 'sangat', 'senang', 'dan', 'bagus', 'dalam', 'mencari', 'kerja', 'sangat', 'mudah']","['senang', 'bagus', 'mencari', 'kerja', 'mudah']",11,5,6,senang bagus cari kerja mudah,5,5
Aplikasi ini dapat membantu saya menemukan solusi tentang pekerjaan,positif,2020-07-12,2020,aplikasi ini dapat membantu saya menemukan solusi tentang pekerjaan,9,9,aplikasi ini dapat membantu saya menemukan solusi tentang pekerjaan,9,9,"['aplikasi', 'ini', 'dapat', 'membantu', 'saya', 'menemukan', 'solusi', 'tentang', 'pekerjaan']","['aplikasi', 'membantu', 'menemukan', 'solusi', 'pekerjaan']",9,5,4,aplikasi bantu temu solusi kerja,5,5
Apk yang patut dihapus dari playstore maupun appstore,negatif,2023-02-19,2023,apk yang patut dihapus dari playstore maupun appstore,8,8,aplikasi yang patut dihapus dari playstore maupun appstore,8,8,"['aplikasi', 'yang', 'patut', 'dihapus', 'dari', 'playstore', 'maupun', 'appstore']","['aplikasi', 'patut', 'dihapus', 'playstore', 'appstore']",8,5,3,aplikasi patut hapus playstore appstore,5,5
Salah satu aplikasi yang dapat memperluas jaringan kerja saya,positif,2020-08-06,2020,salah satu aplikasi yang dapat memperluas jaringan kerja saya,9,9,salah satu aplikasi yang dapat memperluas jaringan kerja saya,9,9,"['salah', 'satu', 'aplikasi', 'yang', 'dapat', 'memperluas', 'jaringan', 'kerja', 'saya']","['salah', 'aplikasi', 'memperluas', 'jaringan', 'kerja']",9,5,4,salah aplikasi luas jaring kerja,5,5
"Mau login ulang aja ribet banget pilih keatas yg benar ,,gue salah mulu,,,hadeeehhh...apa gua robot,,😂😂😂👎🏿",negatif,2021-02-05,2021,mau login ulang aja ribet banget pilih keatas yg benar gue salah mulu hadeeehhh apa gua robot,15,17,mau login ulang saja rumit banget pilih keatas yang benar saya salah mulu hadeeehhh apa saya robot,17,17,"['mau', 'login', 'ulang', 'saja', 'rumit', 'banget', 'pilih', 'keatas', 'yang', 'benar', 'saya', 'salah', 'mulu', 'hadeeehhh', 'apa', 'saya', 'robot']","['login', 'ulang', 'rumit', 'banget', 'pilih', 'keatas', 'salah', 'mulu', 'hadeeehhh', 'robot']",17,10,7,login ulang rumit banget pilih atas salah mulu hadeeehhh robot,10,10
"Alhamdulillah, bantu untuk mencari pekerjaan baru ... terima kasih",positif,2020-09-17,2020,alhamdulillah bantu untuk mencari pekerjaan baru terima kasih,9,8,alhamdulillah bantu untuk mencari pekerjaan baru terima kasih,8,8,"['alhamdulillah', 'bantu', 'untuk', 'mencari', 'pekerjaan', 'baru', 'terima', 'kasih']","['alhamdulillah', 'bantu', 'mencari', 'pekerjaan', 'terima', 'kasih']",8,6,2,alhamdulillah bantu cari kerja terima kasih,6,6
Berhenti buat aplikasi jika cuma mau verifikasi data aja susah 👎👎👎👎,negatif,2022-05-25,2022,berhenti buat aplikasi jika cuma mau verifikasi data aja susah,11,10,berhenti buat aplikasi jika cuma mau verifikasi data saja susah,10,10,"['berhenti', 'buat', 'aplikasi', 'jika', 'cuma', 'mau', 'verifikasi', 'data', 'saja', 'susah']","['berhenti', 'aplikasi', 'verifikasi', 'data', 'susah']",10,5,5,henti aplikasi verifikasi data susah,5,5
"Baru coba, sepertinya asssik dan bermanfaat.",positif,2021-02-12,2021,baru coba sepertinya asssik dan bermanfaat,6,6,baru coba sepertinya asssik dan bermanfaat,6,6,"['baru', 'coba', 'sepertinya', 'asssik', 'dan', 'bermanfaat']","['coba', 'asssik', 'bermanfaat']",6,3,3,coba asssik manfaat,3,3
Apk kgk jelas padahal cuman mau buat akun dan login malah di kasih tebak tebakan.,negatif,2024-01-29,2024,apk kgk jelas padahal cuman mau buat akun dan login malah di kasih tebak tebakan,15,15,aplikasi tidak jelas padahal cuman mau buat akun dan login bahkan di kasih tebak tebakan,15,15,"['aplikasi', 'tidak', 'jelas', 'padahal', 'cuman', 'mau', 'buat', 'akun', 'dan', 'login', 'bahkan', 'di', 'kasih', 'tebak', 'tebakan']","['aplikasi', 'tidak', 'cuman', 'akun', 'login', 'kasih', 'tebak', 'tebakan']",15,8,7,aplikasi tidak cuman akun login kasih tebak tebak,8,8
Sangat membantu dan menambah relatiin,positif,2021-09-06,2021,sangat membantu dan menambah relatiin,5,5,sangat membantu dan menambah relatiin,5,5,"['sangat', 'membantu', 'dan', 'menambah', 'relatiin']","['membantu', 'menambah', 'relatiin']",5,3,2,bantu tambah relatiin,3,3
Sangat membantu dalam menguatkan koneksi dalam dunia kerja. Terima kasih LinkedIn creator team xoxo,positif,2020-07-16,2020,sangat membantu dalam menguatkan koneksi dalam dunia kerja terima kasih linkedin creator team xoxo,14,14,sangat membantu dalam menguatkan koneksi dalam dunia kerja terima kasih linkedin creator team xoxo,14,14,"['sangat', 'membantu', 'dalam', 'menguatkan', 'koneksi', 'dalam', 'dunia', 'kerja', 'terima', 'kasih', 'linkedin', 'creator', 'team', 'xoxo']","['membantu', 'menguatkan', 'koneksi', 'dunia', 'kerja', 'terima', 'kasih', 'linkedin', 'creator', 'team', 'xoxo']",14,11,3,bantu kuat koneksi dunia kerja terima kasih linkedin creator team xoxo,11,11
Sangat membantu saya mencari informasi dgn pekerjaan,positif,2020-02-27,2020,sangat membantu saya mencari informasi dgn pekerjaan,7,7,sangat membantu saya mencari informasi dengan pekerjaan,7,7,"['sangat', 'membantu', 'saya', 'mencari', 'informasi', 'dengan', 'pekerjaan']","['membantu', 'mencari', 'informasi', 'pekerjaan']",7,4,3,bantu cari informasi kerja,4,4
"Memudahkan untuk cari pekerjaan dan sharing tentang pengalaman dunia pekerjaan, sangat rekomended nih buat yang lagi cari kerja atau sekedar berbagi pengalaman👍",positif,2023-03-05,2023,memudahkan untuk cari pekerjaan dan sharing tentang pengalaman dunia pekerjaan sangat rekomended nih buat yang lagi cari kerja atau sekedar berbagi pengalaman,22,22,memudahkan untuk cari pekerjaan dan sharing tentang pengalaman dunia pekerjaan sangat rekomendasi nih buat yang lagi cari kerja atau sekadar berbagi pengalaman,22,22,"['memudahkan', 'untuk', 'cari', 'pekerjaan', 'dan', 'sharing', 'tentang', 'pengalaman', 'dunia', 'pekerjaan', 'sangat', 'rekomendasi', 'nih', 'buat', 'yang', 'lagi', 'cari', 'kerja', 'atau', 'sekadar', 'berbagi', 'pengalaman']","['memudahkan', 'cari', 'pekerjaan', 'sharing', 'pengalaman', 'dunia', 'pekerjaan', 'rekomendasi', 'nih', 'cari', 'kerja', 'berbagi', 'pengalaman']",22,13,9,mudah cari kerja sharing alam dunia kerja rekomendasi nih cari kerja bagi alam,13,13
Di coba dulu min..mudah mudahan cocok dan bermanfaat ye..terimakasih,positif,2020-09-12,2020,di coba dulu min mudah mudahan cocok dan bermanfaat ye terimakasih,9,11,di coba dahulu minimal mudah mudahan cocok dan bermanfaat ye terima kasih,11,12,"['di', 'coba', 'dahulu', 'minimal', 'mudah', 'mudahan', 'cocok', 'dan', 'bermanfaat', 'ye', 'terima', 'kasih']","['coba', 'minimal', 'mudah', 'mudahan', 'cocok', 'bermanfaat', 'ye', 'terima', 'kasih']",12,9,3,coba minimal mudah mudah cocok manfaat ye terima kasih,9,9
Mantap fan jelas cepat semuanya,positif,2021-02-20,2021,mantap fan jelas cepat semuanya,5,5,mantap fan jelas cepat semuanya,5,5,"['mantap', 'fan', 'jelas', 'cepat', 'semuanya']","['mantap', 'fan', 'cepat']",5,3,2,mantap fan cepat,3,3
"dibatasi mulu akunnya, apk gaje pdhl gada ngapa""in...kerjaan jdi terhambat udh 2 akun kena batasi tbtb tanpa alasan. aneh",negatif,2023-12-14,2023,dibatasi mulu akunnya apk gaje pdhl gada ngapa in kerjaan jdi terhambat udh akun kena batasi tbtb tanpa alasan aneh,19,20,dibatasi mulu akunnya aplikasi gaje padahal tidak ada ngapa in kerjaan jadi terhambat sudah akun kena batasi tbtb tanpa alasan aneh,20,21,"['dibatasi', 'mulu', 'akunnya', 'aplikasi', 'gaje', 'padahal', 'tidak', 'ada', 'ngapa', 'in', 'kerjaan', 'jadi', 'terhambat', 'sudah', 'akun', 'kena', 'batasi', 'tbtb', 'tanpa', 'alasan', 'aneh']","['dibatasi', 'mulu', 'akunnya', 'aplikasi', 'gaje', 'tidak', 'ngapa', 'in', 'kerjaan', 'terhambat', 'akun', 'kena', 'batasi', 'tbtb', 'alasan', 'aneh']",21,16,5,batas mulu akun aplikasi gaje tidak ngapa in kerja hambat akun kena batas tbtb alas aneh,16,16
"Pas buat akun, verifikasi nya bolak-balik terus hmmmmmm",negatif,2021-07-22,2021,pas buat akun verifikasi nya bolak balik terus hmmmmmm,8,9,pas buat akun verifikasi nya bolak balik terus hmmmmmm,9,9,"['pas', 'buat', 'akun', 'verifikasi', 'nya', 'bolak', 'balik', 'terus', 'hmmmmmm']","['pas', 'akun', 'verifikasi', 'nya', 'bolak', 'hmmmmmm']",9,6,3,pas akun verifikasi nya bolak hmmmmmm,6,6
Aplikasi yang sangat membantu saya untuk mencari pekerjaan karena saya pekerja lepas,positif,2023-03-05,2023,aplikasi yang sangat membantu saya untuk mencari pekerjaan karena saya pekerja lepas,12,12,aplikasi yang sangat membantu saya untuk mencari pekerjaan karena saya yang kerja lepas,12,13,"['aplikasi', 'yang', 'sangat', 'membantu', 'saya', 'untuk', 'mencari', 'pekerjaan', 'karena', 'saya', 'yang', 'kerja', 'lepas']","['aplikasi', 'membantu', 'mencari', 'pekerjaan', 'kerja', 'lepas']",13,6,7,aplikasi bantu cari kerja kerja lepas,6,6
Daftarnya susah banget . . Banyak pertaanyaan bodoh,negatif,2023-01-23,2023,daftarnya susah banget banyak pertaanyaan bodoh,8,6,daftarnya susah banget banyak pertaanyaan bodoh,6,6,"['daftarnya', 'susah', 'banget', 'banyak', 'pertaanyaan', 'bodoh']","['daftarnya', 'susah', 'banget', 'pertaanyaan', 'bodoh']",6,5,1,daftar susah banget pertaanyaan bodoh,5,5
Aplikasi yang bagus untuk membangun Networking,positif,2021-10-22,2021,aplikasi yang bagus untuk membangun networking,6,6,aplikasi yang bagus untuk membangun networking,6,6,"['aplikasi', 'yang', 'bagus', 'untuk', 'membangun', 'networking']","['aplikasi', 'bagus', 'membangun', 'networking']",6,4,2,aplikasi bagus bangun networking,4,4
"Semoga bisa bekerja dengan baik, bisa memudahkan saya berkomunikasi secara efektif",positif,2022-06-23,2022,semoga bisa bekerja dengan baik bisa memudahkan saya berkomunikasi secara efektif,11,11,semoga bisa bekerja dengan baik bisa memudahkan saya berkomunikasi secara efektif,11,11,"['semoga', 'bisa', 'bekerja', 'dengan', 'baik', 'bisa', 'memudahkan', 'saya', 'berkomunikasi', 'secara', 'efektif']","['semoga', 'memudahkan', 'berkomunikasi', 'efektif']",11,4,7,moga mudah komunikasi efektif,4,4
LinkedIn Sangat Rekomended Untuk Menjalin Circle Pertemanan Yang Berkualitas. Best LinkedIn,positif,2024-01-25,2024,linkedin sangat rekomended untuk menjalin circle pertemanan yang berkualitas best linkedin,11,11,linkedin sangat rekomendasi untuk menjalin circle pertemanan yang berkualitas terbaik linkedin,11,11,"['linkedin', 'sangat', 'rekomendasi', 'untuk', 'menjalin', 'circle', 'pertemanan', 'yang', 'berkualitas', 'terbaik', 'linkedin']","['linkedin', 'rekomendasi', 'menjalin', 'circle', 'pertemanan', 'berkualitas', 'terbaik', 'linkedin']",11,8,3,linkedin rekomendasi jalin circle teman kualitas baik linkedin,8,8
Aplikasi untuk para profesional yang keren,positif,2020-06-12,2020,aplikasi untuk para profesional yang keren,6,6,aplikasi untuk para profesional yang keren,6,6,"['aplikasi', 'untuk', 'para', 'profesional', 'yang', 'keren']","['aplikasi', 'profesional', 'keren']",6,3,3,aplikasi profesional keren,3,3
"Baru buat akun belum sehari dipakai udah kena nonaktif dengan penjelasan ada pelanggaran, tidak dijelaskan pelanggaran apa",negatif,2021-07-28,2021,baru buat akun belum sehari dipakai udah kena nonaktif dengan penjelasan ada pelanggaran tidak dijelaskan pelanggaran apa,17,17,baru buat akun belum sehari dipakai sudah kena nonaktif dengan penjelasan ada pelanggaran tidak dijelaskan pelanggaran apa,17,17,"['baru', 'buat', 'akun', 'belum', 'sehari', 'dipakai', 'sudah', 'kena', 'nonaktif', 'dengan', 'penjelasan', 'ada', 'pelanggaran', 'tidak', 'dijelaskan', 'pelanggaran', 'apa']","['akun', 'sehari', 'dipakai', 'kena', 'nonaktif', 'penjelasan', 'pelanggaran', 'tidak', 'pelanggaran']",17,9,8,akun hari pakai kena nonaktif jelas langgar tidak langgar,9,9
Sangat membantu di dlm berkomunikasi,positif,2022-10-04,2022,sangat membantu di dlm berkomunikasi,5,5,sangat membantu di dalam berkomunikasi,5,5,"['sangat', 'membantu', 'di', 'dalam', 'berkomunikasi']","['membantu', 'berkomunikasi']",5,2,3,bantu komunikasi,2,2
Membantu sekali dalam mencari kerja.. Saya dapat pekerjaan ya dari Linked In.,positif,2020-06-18,2020,membantu sekali dalam mencari kerja saya dapat pekerjaan ya dari linked in,12,12,membantu sekali dalam mencari kerja saya dapat pekerjaan ya dari linked in,12,12,"['membantu', 'sekali', 'dalam', 'mencari', 'kerja', 'saya', 'dapat', 'pekerjaan', 'ya', 'dari', 'linked', 'in']","['membantu', 'mencari', 'kerja', 'pekerjaan', 'ya', 'linked', 'in']",12,7,5,bantu cari kerja kerja ya linked in,7,7
linkedln sangat membantu.semoga lebih maju lagi sukses selalu,positif,2021-11-04,2021,linkedln sangat membantu semoga lebih maju lagi sukses selalu,8,9,linkedln sangat membantu semoga lebih maju lagi sukses selalu,9,9,"['linkedln', 'sangat', 'membantu', 'semoga', 'lebih', 'maju', 'lagi', 'sukses', 'selalu']","['linkedln', 'membantu', 'semoga', 'maju', 'sukses']",9,5,4,linkedln bantu moga maju sukses,5,5
Error error gajelas banget ini aplikasi,negatif,2023-01-06,2023,error error gajelas banget ini aplikasi,6,6,error error tidak jelas banget ini aplikasi,6,7,"['error', 'error', 'tidak', 'jelas', 'banget', 'ini', 'aplikasi']","['error', 'error', 'tidak', 'banget', 'aplikasi']",7,5,2,error error tidak banget aplikasi,5,5
Linkedin bagus cuma lama donwload Alpikasinya,positif,2021-03-03,2021,linkedin bagus cuma lama donwload alpikasinya,6,6,linkedin bagus cuma lama donwload alpikasinya,6,6,"['linkedin', 'bagus', 'cuma', 'lama', 'donwload', 'alpikasinya']","['linkedin', 'bagus', 'donwload', 'alpikasinya']",6,4,2,linkedin bagus donwload alpikasinya,4,4
Terima kasih telah menjadikan LinkedIn sebagai portal yang menghubukan saya dengan orang-orang profesional.,positif,2020-02-06,2020,terima kasih telah menjadikan linkedin sebagai portal yang menghubukan saya dengan orang orang profesional,13,14,terima kasih telah menjadikan linkedin sebagai portal yang menghubukan saya dengan orang orang profesional,14,14,"['terima', 'kasih', 'telah', 'menjadikan', 'linkedin', 'sebagai', 'portal', 'yang', 'menghubukan', 'saya', 'dengan', 'orang', 'orang', 'profesional']","['terima', 'kasih', 'menjadikan', 'linkedin', 'portal', 'menghubukan', 'orang', 'orang', 'profesional']",14,9,5,terima kasih jadi linkedin portal menghubukan orang orang profesional,9,9
gk jelas aplikasi ini gak tentu bisa mendapat penghasilan,negatif,2021-10-18,2021,gk jelas aplikasi ini gak tentu bisa mendapat penghasilan,9,9,tidak jelas aplikasi ini tidak tentu bisa mendapat penghasilan,9,9,"['tidak', 'jelas', 'aplikasi', 'ini', 'tidak', 'tentu', 'bisa', 'mendapat', 'penghasilan']","['tidak', 'aplikasi', 'tidak', 'penghasilan']",9,4,5,tidak aplikasi tidak hasil,4,4
"Bagus sekali ,buat mengembangkan bisnis ,jadi kita bisa berbagi tentang bisnis",positif,2020-12-01,2020,bagus sekali buat mengembangkan bisnis jadi kita bisa berbagi tentang bisnis,11,11,bagus sekali buat mengembangkan bisnis jadi kita bisa berbagi tentang bisnis,11,11,"['bagus', 'sekali', 'buat', 'mengembangkan', 'bisnis', 'jadi', 'kita', 'bisa', 'berbagi', 'tentang', 'bisnis']","['bagus', 'mengembangkan', 'bisnis', 'berbagi', 'bisnis']",11,5,6,bagus kembang bisnis bagi bisnis,5,5
"Good, recommended aplikasi mudah dimengerti.",positif,2021-04-11,2021,good recommended aplikasi mudah dimengerti,5,5,bagus rekomendasi aplikasi mudah dimengerti,5,5,"['bagus', 'rekomendasi', 'aplikasi', 'mudah', 'dimengerti']","['bagus', 'rekomendasi', 'aplikasi', 'mudah', 'dimengerti']",5,5,0,bagus rekomendasi aplikasi mudah erti,5,5
Aplikasi tolol login aja terus stack di gatcha ga jelas tolol hapus aja apk nya dari play store,negatif,2023-07-08,2023,aplikasi tolol login aja terus stack di gatcha ga jelas tolol hapus aja apk nya dari play store,18,18,aplikasi tolol login saja terus stack di gatcha tidak jelas tolol hapus saja aplikasi nya dari play store,18,18,"['aplikasi', 'tolol', 'login', 'saja', 'terus', 'stack', 'di', 'gatcha', 'tidak', 'jelas', 'tolol', 'hapus', 'saja', 'aplikasi', 'nya', 'dari', 'play', 'store']","['aplikasi', 'tolol', 'login', 'stack', 'gatcha', 'tidak', 'tolol', 'hapus', 'aplikasi', 'nya', 'play', 'store']",18,12,6,aplikasi tolol login stack gatcha tidak tolol hapus aplikasi nya play store,12,12
Sangat membantu untuk para pencaker,positif,2022-02-03,2022,sangat membantu untuk para pencaker,5,5,sangat membantu untuk para pencaker,5,5,"['sangat', 'membantu', 'untuk', 'para', 'pencaker']","['membantu', 'pencaker']",5,2,3,bantu pencaker,2,2
Mau login ae susah kali verifikasi ngulang terus padahal udah bener,negatif,2023-08-11,2023,mau login ae susah kali verifikasi ngulang terus padahal udah bener,11,11,mau login ae susah kali verifikasi mengulang terus padahal sudah benar,11,11,"['mau', 'login', 'ae', 'susah', 'kali', 'verifikasi', 'mengulang', 'terus', 'padahal', 'sudah', 'benar']","['login', 'ae', 'susah', 'kali', 'verifikasi', 'mengulang']",11,6,5,login ae susah kali verifikasi ulang,6,6
Aplikasi yang sangat bermanfaat daripada app mobile legends bang bang.,positif,2023-08-30,2023,aplikasi yang sangat bermanfaat daripada app mobile legends bang bang,10,10,aplikasi yang sangat bermanfaat daripada aplikasi mobile legends bang bang,10,10,"['aplikasi', 'yang', 'sangat', 'bermanfaat', 'daripada', 'aplikasi', 'mobile', 'legends', 'bang', 'bang']","['aplikasi', 'bermanfaat', 'aplikasi', 'mobile', 'legends', 'bang', 'bang']",10,7,3,aplikasi manfaat aplikasi mobile legends bang bang,7,7
Aplikasi terbaik.membantu dalam kebutuhan saya.,positif,2020-09-20,2020,aplikasi terbaik membantu dalam kebutuhan saya,5,6,aplikasi terbaik membantu dalam kebutuhan saya,6,6,"['aplikasi', 'terbaik', 'membantu', 'dalam', 'kebutuhan', 'saya']","['aplikasi', 'terbaik', 'membantu', 'kebutuhan']",6,4,2,aplikasi baik bantu butuh,4,4
Gk bisa verifikasi Udh jwb benar tapi malah suruh ulangi,negatif,2021-08-12,2021,gk bisa verifikasi udh jwb benar tapi malah suruh ulangi,10,10,tidak bisa verifikasi sudah jawab benar tapi bahkan suruh ulang,10,10,"['tidak', 'bisa', 'verifikasi', 'sudah', 'jawab', 'benar', 'tapi', 'bahkan', 'suruh', 'ulang']","['tidak', 'verifikasi', 'suruh', 'ulang']",10,4,6,tidak verifikasi suruh ulang,4,4
"UPLOAD FOTO PROFIL DAN BACKGROUND LAMA SEKALI HAMPIR 1 JAM??? SINYAL OKE, WIFI OKE, BUT APP NYA ??@?!?@^-¥!;@ -_-",negatif,2022-07-13,2022,upload foto profil dan background lama sekali hampir jam sinyal oke wifi oke but app nya ¥,19,17,unggah foto profil dan background lama sekali hampir jam sinyal oke wifi oke but aplikasi nya ¥,17,17,"['unggah', 'foto', 'profil', 'dan', 'background', 'lama', 'sekali', 'hampir', 'jam', 'sinyal', 'oke', 'wifi', 'oke', 'but', 'aplikasi', 'nya', '¥']","['unggah', 'foto', 'profil', 'background', 'jam', 'sinyal', 'oke', 'wifi', 'oke', 'but', 'aplikasi', 'nya', '¥']",17,13,4,unggah foto profil background jam sinyal oke wifi oke but aplikasi nya,13,12
"Susah banget, mau masuk aja susahnya minta ampun verifikasinya",negatif,2022-08-07,2022,susah banget mau masuk aja susahnya minta ampun verifikasinya,9,9,susah banget mau masuk saja susahnya minta ampun verifikasinya,9,9,"['susah', 'banget', 'mau', 'masuk', 'saja', 'susahnya', 'minta', 'ampun', 'verifikasinya']","['susah', 'banget', 'masuk', 'susahnya', 'ampun', 'verifikasinya']",9,6,3,susah banget masuk susah ampun verifikasi,6,6
Lumayan bagus untuk cari lowongan kerja dan kenal banyak orang dgn profesi yang sama.,positif,2020-03-25,2020,lumayan bagus untuk cari lowongan kerja dan kenal banyak orang dgn profesi yang sama,14,14,lumayan bagus untuk cari lowongan kerja dan kenal banyak orang dengan profesi yang sama,14,14,"['lumayan', 'bagus', 'untuk', 'cari', 'lowongan', 'kerja', 'dan', 'kenal', 'banyak', 'orang', 'dengan', 'profesi', 'yang', 'sama']","['lumayan', 'bagus', 'cari', 'lowongan', 'kerja', 'kenal', 'orang', 'profesi']",14,8,6,lumayan bagus cari lowong kerja kenal orang profesi,8,8
Baru jg download.... Verifikasi nomor telp aja ribetnya ya Tuhan..,negatif,2023-04-27,2023,baru jg download verifikasi nomor telp aja ribetnya ya tuhan,10,10,baru juga unduh verifikasi nomor telepon saja ribetnya ya tuhan,10,10,"['baru', 'juga', 'unduh', 'verifikasi', 'nomor', 'telepon', 'saja', 'ribetnya', 'ya', 'tuhan']","['unduh', 'verifikasi', 'nomor', 'telepon', 'ribetnya', 'ya', 'tuhan']",10,7,3,unduh verifikasi nomor telepon ribetnya ya tuhan,7,7
Sangat membantu koneksi dalam lingkungan pekerjaan.,positif,2020-08-12,2020,sangat membantu koneksi dalam lingkungan pekerjaan,6,6,sangat membantu koneksi dalam lingkungan pekerjaan,6,6,"['sangat', 'membantu', 'koneksi', 'dalam', 'lingkungan', 'pekerjaan']","['membantu', 'koneksi', 'lingkungan', 'pekerjaan']",6,4,2,bantu koneksi lingkung kerja,4,4
"luar biasa sekali aplikasi ini,dan sangat membantu.",negatif,2022-09-21,2022,luar biasa sekali aplikasi ini dan sangat membantu,7,8,luar biasa sekali aplikasi ini dan sangat membantu,8,8,"['luar', 'biasa', 'sekali', 'aplikasi', 'ini', 'dan', 'sangat', 'membantu']","['aplikasi', 'membantu']",8,2,6,aplikasi bantu,2,2
Verifikasi disuru milih badak yang kearah atas. Udh dipilih masih aja salah. Gajelas ni aplikasi,negatif,2021-06-06,2021,verifikasi disuru milih badak yang kearah atas udh dipilih masih aja salah gajelas ni aplikasi,15,15,verifikasi disuru memilih badak yang kearah atas sudah dipilih masih saja salah tidak jelas ini aplikasi,15,16,"['verifikasi', 'disuru', 'memilih', 'badak', 'yang', 'kearah', 'atas', 'sudah', 'dipilih', 'masih', 'saja', 'salah', 'tidak', 'jelas', 'ini', 'aplikasi']","['verifikasi', 'disuru', 'memilih', 'badak', 'kearah', 'dipilih', 'salah', 'tidak', 'aplikasi']",16,9,7,verifikasi disuru pilih badak arah pilih salah tidak aplikasi,9,9
"ngapain maen tebak tebakan anj ini apk buat cari kerja bukan maen game, gw kasih bintang 1 karna jelek !!!!!",negatif,2022-01-27,2022,ngapain maen tebak tebakan anj ini apk buat cari kerja bukan maen game gw kasih bintang karna jelek,20,18,buat apa maen tebak tebakan anj ini aplikasi buat cari kerja bukan maen game saya kasih bintang karena jelek,18,19,"['buat', 'apa', 'maen', 'tebak', 'tebakan', 'anj', 'ini', 'aplikasi', 'buat', 'cari', 'kerja', 'bukan', 'maen', 'game', 'saya', 'kasih', 'bintang', 'karena', 'jelek']","['maen', 'tebak', 'tebakan', 'anj', 'aplikasi', 'cari', 'kerja', 'maen', 'game', 'kasih', 'bintang', 'jelek']",19,12,7,maen tebak tebak anj aplikasi cari kerja maen game kasih bintang jelek,12,12
Aplikasi yang tercepat untuk masa Depan,positif,2020-06-12,2020,aplikasi yang tercepat untuk masa depan,6,6,aplikasi yang tercepat untuk masa depan,6,6,"['aplikasi', 'yang', 'tercepat', 'untuk', 'masa', 'depan']","['aplikasi', 'tercepat']",6,2,4,aplikasi cepat,2,2
Berbayar tapi ngirim email gratis gak jelas bat,negatif,2021-03-23,2021,berbayar tapi ngirim email gratis gak jelas bat,8,8,berbayar tapi mengirim email gratis tidak jelas bat,8,8,"['berbayar', 'tapi', 'mengirim', 'email', 'gratis', 'tidak', 'jelas', 'bat']","['berbayar', 'mengirim', 'email', 'gratis', 'tidak', 'bat']",8,6,2,bayar kirim email gratis tidak bat,6,6
Trimakasih linkdln.hidup jadi lebih berwarna...,positif,2020-01-19,2020,trimakasih linkdln hidup jadi lebih berwarna,5,6,terima kasih linkdln hidup jadi lebih berwarna,6,7,"['terima', 'kasih', 'linkdln', 'hidup', 'jadi', 'lebih', 'berwarna']","['terima', 'kasih', 'linkdln', 'hidup', 'berwarna']",7,5,2,terima kasih linkdln hidup warna,5,5
Memanfaatkan kesempatan dalam kesempitan. Serahkan Segala Urusan Kepada yg Maha Kuasa Yaitu TUHAN YME. Mudah mudahan di beri kemudahan.,positif,2021-09-28,2021,memanfaatkan kesempatan dalam kesempitan serahkan segala urusan kepada yg maha kuasa yaitu tuhan yme mudah mudahan di beri kemudahan,19,19,memanfaatkan kesempatan dalam kesempitan serahkan segala urusan kepada yang maha kuasa yaitu tuhan yme mudah mudahan di beri kemudahan,19,19,"['memanfaatkan', 'kesempatan', 'dalam', 'kesempitan', 'serahkan', 'segala', 'urusan', 'kepada', 'yang', 'maha', 'kuasa', 'yaitu', 'tuhan', 'yme', 'mudah', 'mudahan', 'di', 'beri', 'kemudahan']","['memanfaatkan', 'kesempatan', 'kesempitan', 'serahkan', 'urusan', 'maha', 'kuasa', 'tuhan', 'yme', 'mudah', 'mudahan', 'kemudahan']",19,12,7,manfaat sempat sempit serah urus maha kuasa tuhan yme mudah mudah mudah,12,12
"Sebagai guru hidup penuh dengan suka duka ,tetapi itu saya hadapi dengan semangat penuh pengabdian mengharap rido Allah swt 1",positif,2020-01-08,2020,sebagai guru hidup penuh dengan suka duka tetapi itu saya hadapi dengan semangat penuh pengabdian mengharap rido allah swt,20,19,sebagai guru hidup penuh dengan suka duka tetapi itu saya hadapi dengan semangat penuh pengabdian mengharap rido allah swt,19,19,"['sebagai', 'guru', 'hidup', 'penuh', 'dengan', 'suka', 'duka', 'tetapi', 'itu', 'saya', 'hadapi', 'dengan', 'semangat', 'penuh', 'pengabdian', 'mengharap', 'rido', 'allah', 'swt']","['guru', 'hidup', 'penuh', 'suka', 'duka', 'hadapi', 'semangat', 'penuh', 'pengabdian', 'mengharap', 'rido', 'allah', 'swt']",19,13,6,guru hidup penuh suka duka hadap semangat penuh abdi harap rido allah swt,13,13
"Gjls ni app ngelag²/bugnya banyak, padahal hp gue SD865",negatif,2023-02-22,2023,gjls ni app ngelag² bugnya banyak padahal hp gue sd,9,10,gjls ini aplikasi ngelag² bugnya banyak padahal handphone saya sudah,10,10,"['gjls', 'ini', 'aplikasi', 'ngelag²', 'bugnya', 'banyak', 'padahal', 'handphone', 'saya', 'sudah']","['gjls', 'aplikasi', 'ngelag²', 'bugnya', 'handphone']",10,5,5,gjls aplikasi ngelag bugnya handphone,5,5
Gak bisa verifikasi security check padahal sudah betul,negatif,2023-08-18,2023,gak bisa verifikasi security check padahal sudah betul,8,8,tidak bisa verifikasi security cek padahal sudah betul,8,8,"['tidak', 'bisa', 'verifikasi', 'security', 'cek', 'padahal', 'sudah', 'betul']","['tidak', 'verifikasi', 'security', 'cek']",8,4,4,tidak verifikasi security cek,4,4
Susah dapat kerja juga sama aj instal ginian uninstal saja,negatif,2022-02-15,2022,susah dapat kerja juga sama aj instal ginian uninstal saja,10,10,susah dapat kerja juga sama saja memasang ginian hapus instalan saja,10,11,"['susah', 'dapat', 'kerja', 'juga', 'sama', 'saja', 'memasang', 'ginian', 'hapus', 'instalan', 'saja']","['susah', 'kerja', 'memasang', 'ginian', 'hapus', 'instalan']",11,6,5,susah kerja pasang ginian hapus instalan,6,6
Sangat bermanfaat untuk membina hubungan dengan relasi dan teman2 semya.,positif,2020-11-25,2020,sangat bermanfaat untuk membina hubungan dengan relasi dan teman semya,10,10,sangat bermanfaat untuk membina hubungan dengan relasi dan teman semya,10,10,"['sangat', 'bermanfaat', 'untuk', 'membina', 'hubungan', 'dengan', 'relasi', 'dan', 'teman', 'semya']","['bermanfaat', 'membina', 'hubungan', 'relasi', 'teman', 'semya']",10,6,4,manfaat bina hubung relasi teman semya,6,6
"Good, sebaiknya jika ada postingan dan video postingan jika banyak pengunjungnya dapat poin atau hadiah",positif,2021-03-23,2021,good sebaiknya jika ada postingan dan video postingan jika banyak pengunjungnya dapat poin atau hadiah,15,15,bagus sebaiknya jika ada postingan dan video postingan jika banyak pengunjungnya dapat poin atau hadiah,15,15,"['bagus', 'sebaiknya', 'jika', 'ada', 'postingan', 'dan', 'video', 'postingan', 'jika', 'banyak', 'pengunjungnya', 'dapat', 'poin', 'atau', 'hadiah']","['bagus', 'postingan', 'video', 'postingan', 'pengunjungnya', 'poin', 'hadiah']",15,7,8,bagus postingan video postingan unjung poin hadiah,7,7
Memudahkan saya untuk mencari lowongan pekerjaan dan banyak pilihan peluang pekerjaan,positif,2023-12-25,2023,memudahkan saya untuk mencari lowongan pekerjaan dan banyak pilihan peluang pekerjaan,11,11,memudahkan saya untuk mencari lowongan pekerjaan dan banyak pilihan peluang pekerjaan,11,11,"['memudahkan', 'saya', 'untuk', 'mencari', 'lowongan', 'pekerjaan', 'dan', 'banyak', 'pilihan', 'peluang', 'pekerjaan']","['memudahkan', 'mencari', 'lowongan', 'pekerjaan', 'pilihan', 'peluang', 'pekerjaan']",11,7,4,mudah cari lowong kerja pilih peluang kerja,7,7
Sejauh ini masih bagus dan informasinya bermanfaat,positif,2024-01-22,2024,sejauh ini masih bagus dan informasinya bermanfaat,7,7,sejauh ini masih bagus dan informasinya bermanfaat,7,7,"['sejauh', 'ini', 'masih', 'bagus', 'dan', 'informasinya', 'bermanfaat']","['bagus', 'informasinya', 'bermanfaat']",7,3,4,bagus informasi manfaat,3,3
"bug mohon segera diperbaiki, saya tidak bisa bergabung/login",negatif,2023-01-27,2023,bug mohon segera diperbaiki saya tidak bisa bergabung login,8,9,bug mohon segera di perbaiki saya tidak bisa bergabung login,9,10,"['bug', 'mohon', 'segera', 'di', 'perbaiki', 'saya', 'tidak', 'bisa', 'bergabung', 'login']","['bug', 'mohon', 'perbaiki', 'tidak', 'bergabung', 'login']",10,6,4,bug mohon baik tidak gabung login,6,6
Uninstall aja.. Kode captcha gak bermutu Cari aplikasi lain aja,negatif,2023-08-30,2023,uninstall aja kode captcha gak bermutu cari aplikasi lain aja,10,10,uninstall saja kode captcha tidak bermutu cari aplikasi lain saja,10,10,"['uninstall', 'saja', 'kode', 'captcha', 'tidak', 'bermutu', 'cari', 'aplikasi', 'lain', 'saja']","['uninstall', 'kode', 'captcha', 'tidak', 'bermutu', 'cari', 'aplikasi']",10,7,3,uninstall kode captcha tidak mutu cari aplikasi,7,7
Sangat bermanfaat dalam mencari pekerjaan...,positif,2021-11-29,2021,sangat bermanfaat dalam mencari pekerjaan,5,5,sangat bermanfaat dalam mencari pekerjaan,5,5,"['sangat', 'bermanfaat', 'dalam', 'mencari', 'pekerjaan']","['bermanfaat', 'mencari', 'pekerjaan']",5,3,2,manfaat cari kerja,3,3
Aplikasi untuk karyawan dan pencari kerja 👍...,positif,2021-10-29,2021,aplikasi untuk karyawan dan pencari kerja,7,6,aplikasi untuk karyawan dan pencari kerja,6,6,"['aplikasi', 'untuk', 'karyawan', 'dan', 'pencari', 'kerja']","['aplikasi', 'karyawan', 'pencari', 'kerja']",6,4,2,aplikasi karyawan cari kerja,4,4
Terimakasih Buat LINKEDIN Dan Tim sangat Bermanfaat Bagi Pengguna Individu Maupun Perusahaan Dan Sejenisnya,positif,2021-11-13,2021,terimakasih buat linkedin dan tim sangat bermanfaat bagi pengguna individu maupun perusahaan dan sejenisnya,14,14,terima kasih buat linkedin dan tim sangat bermanfaat bagi pengguna individu maupun perusahaan dan sejenisnya,14,15,"['terima', 'kasih', 'buat', 'linkedin', 'dan', 'tim', 'sangat', 'bermanfaat', 'bagi', 'pengguna', 'individu', 'maupun', 'perusahaan', 'dan', 'sejenisnya']","['terima', 'kasih', 'linkedin', 'tim', 'bermanfaat', 'pengguna', 'individu', 'perusahaan', 'sejenisnya']",15,9,6,terima kasih linkedin tim manfaat guna individu usaha jenis,9,9
Aplikasi yang cukup bagus untuk memperkenalkan diri kepada publik .,positif,2020-09-22,2020,aplikasi yang cukup bagus untuk memperkenalkan diri kepada publik,10,9,aplikasi yang cukup bagus untuk memperkenalkan diri kepada publik,9,9,"['aplikasi', 'yang', 'cukup', 'bagus', 'untuk', 'memperkenalkan', 'diri', 'kepada', 'publik']","['aplikasi', 'bagus', 'memperkenalkan', 'publik']",9,4,5,aplikasi bagus kenal publik,4,4
"Kok aplikasinya error ya, tiba² keluar.",negatif,2022-08-12,2022,kok aplikasinya error ya tiba² keluar,6,6,kok aplikasi nya error ya tiba² keluar,6,7,"['kok', 'aplikasi', 'nya', 'error', 'ya', 'tiba²', 'keluar']","['aplikasi', 'nya', 'error', 'ya', 'tiba²']",7,5,2,aplikasi nya error ya tiba,5,5
banyak update. sering lost connecting,negatif,2021-01-07,2021,banyak update sering lost connecting,5,5,banyak diperbarui sering lost connecting,5,5,"['banyak', 'diperbarui', 'sering', 'lost', 'connecting']","['diperbarui', 'lost', 'connecting']",5,3,2,baru lost connecting,3,3
"verifikasi keamanan gak selesai2, aplikasi pembodohan, cacat",negatif,2023-07-26,2023,verifikasi keamanan gak selesai aplikasi pembodohan cacat,7,7,verifikasi keamanan tidak selesai aplikasi pembodohan cacat,7,7,"['verifikasi', 'keamanan', 'tidak', 'selesai', 'aplikasi', 'pembodohan', 'cacat']","['verifikasi', 'keamanan', 'tidak', 'selesai', 'aplikasi', 'pembodohan', 'cacat']",7,7,0,verifikasi aman tidak selesai aplikasi bodoh cacat,7,7
Saya senang menggunakannya untuk melihat peluang karir,positif,2023-08-25,2023,saya senang menggunakannya untuk melihat peluang karir,7,7,saya senang menggunakannya untuk melihat peluang karir,7,7,"['saya', 'senang', 'menggunakannya', 'untuk', 'melihat', 'peluang', 'karir']","['senang', 'menggunakannya', 'peluang', 'karir']",7,4,3,senang guna peluang karir,4,4
Sangat membantu untuk membangun relasi,positif,2023-06-13,2023,sangat membantu untuk membangun relasi,5,5,sangat membantu untuk membangun relasi,5,5,"['sangat', 'membantu', 'untuk', 'membangun', 'relasi']","['membantu', 'membangun', 'relasi']",5,3,2,bantu bangun relasi,3,3
"Aplikasi rusak, mau verifikasi aja ribet banget",negatif,2023-06-15,2023,aplikasi rusak mau verifikasi aja ribet banget,7,7,aplikasi rusak mau verifikasi saja rumit banget,7,7,"['aplikasi', 'rusak', 'mau', 'verifikasi', 'saja', 'rumit', 'banget']","['aplikasi', 'rusak', 'verifikasi', 'rumit', 'banget']",7,5,2,aplikasi rusak verifikasi rumit banget,5,5
"Aplikasi in Linkedln ini juga seperti Facebook di seluruh dunia,(dunia)",positif,2023-11-16,2023,aplikasi in linkedln ini juga seperti facebook di seluruh dunia dunia,10,11,aplikasi in linkedln ini juga seperti facebook di seluruh dunia dunia,11,11,"['aplikasi', 'in', 'linkedln', 'ini', 'juga', 'seperti', 'facebook', 'di', 'seluruh', 'dunia', 'dunia']","['aplikasi', 'in', 'linkedln', 'facebook', 'dunia', 'dunia']",11,6,5,aplikasi in linkedln facebook dunia dunia,6,6
Ok banget bertambah informasi pekerjaan dan mengenal karakter senior senior,negatif,2024-01-30,2024,ok banget bertambah informasi pekerjaan dan mengenal karakter senior senior,10,10,oke banget bertambah informasi pekerjaan dan mengenal karakter senior senior,10,10,"['oke', 'banget', 'bertambah', 'informasi', 'pekerjaan', 'dan', 'mengenal', 'karakter', 'senior', 'senior']","['oke', 'banget', 'bertambah', 'informasi', 'pekerjaan', 'mengenal', 'karakter', 'senior', 'senior']",10,9,1,oke banget tambah informasi kerja kenal karakter senior senior,9,9
"Bagus untuk pencari kerja, lanjutkan",positif,2023-11-23,2023,bagus untuk pencari kerja lanjutkan,5,5,bagus untuk pencari kerja lanjutkan,5,5,"['bagus', 'untuk', 'pencari', 'kerja', 'lanjutkan']","['bagus', 'pencari', 'kerja', 'lanjutkan']",5,4,1,bagus cari kerja lanjut,4,4
sangat membantu dalam mencari dan mendapatkan pekerjaan di kapal,positif,2022-12-10,2022,sangat membantu dalam mencari dan mendapatkan pekerjaan di kapal,9,9,sangat membantu dalam mencari dan mendapatkan pekerjaan di kapal,9,9,"['sangat', 'membantu', 'dalam', 'mencari', 'dan', 'mendapatkan', 'pekerjaan', 'di', 'kapal']","['membantu', 'mencari', 'pekerjaan', 'kapal']",9,4,5,bantu cari kerja kapal,4,4
"Salah satu aplikasi jaringan komunitas bidang kerja terbaik saat ini, baik sebagai praktisi yang ingin berkembang dan owner perusahaan yang ingin menambahkan keyakinan bagi mitra perusahaannya.",positif,2024-01-07,2024,salah satu aplikasi jaringan komunitas bidang kerja terbaik saat ini baik sebagai praktisi yang ingin berkembang dan owner perusahaan yang ingin menambahkan keyakinan bagi mitra perusahaannya,26,26,salah satu aplikasi jaringan komunitas bidang kerja terbaik saat ini baik sebagai praktisi yang ingin berkembang dan owner perusahaan yang ingin menambahkan keyakinan bagi mitra perusahaannya,26,26,"['salah', 'satu', 'aplikasi', 'jaringan', 'komunitas', 'bidang', 'kerja', 'terbaik', 'saat', 'ini', 'baik', 'sebagai', 'praktisi', 'yang', 'ingin', 'berkembang', 'dan', 'owner', 'perusahaan', 'yang', 'ingin', 'menambahkan', 'keyakinan', 'bagi', 'mitra', 'perusahaannya']","['salah', 'aplikasi', 'jaringan', 'komunitas', 'bidang', 'kerja', 'terbaik', 'praktisi', 'berkembang', 'owner', 'perusahaan', 'keyakinan', 'mitra', 'perusahaannya']",26,14,12,salah aplikasi jaring komunitas bidang kerja baik praktisi kembang owner usaha yakin mitra usaha,14,14
Kenapa habis update tidak bisa login,negatif,2023-08-22,2023,kenapa habis update tidak bisa login,6,6,kenapa habis diperbarui tidak bisa login,6,6,"['kenapa', 'habis', 'diperbarui', 'tidak', 'bisa', 'login']","['habis', 'diperbarui', 'tidak', 'login']",6,4,2,habis baru tidak login,4,4
Informasi yg sangat berguna bagi para calon pelamar pekerjaan,positif,2023-10-17,2023,informasi yg sangat berguna bagi para calon pelamar pekerjaan,9,9,informasi yang sangat berguna bagi para calon pelamar pekerjaan,9,9,"['informasi', 'yang', 'sangat', 'berguna', 'bagi', 'para', 'calon', 'pelamar', 'pekerjaan']","['informasi', 'berguna', 'calon', 'pelamar', 'pekerjaan']",9,5,4,informasi guna calon lamar kerja,5,5
sangat membantu utk memperluas jaringan. tks,positif,2023-09-16,2023,sangat membantu utk memperluas jaringan tks,6,6,sangat membantu untuk memperluas jaringan terima kasih,6,7,"['sangat', 'membantu', 'untuk', 'memperluas', 'jaringan', 'terima', 'kasih']","['membantu', 'memperluas', 'jaringan', 'terima', 'kasih']",7,5,2,bantu luas jaring terima kasih,5,5
ni account saya kenapa berubah jadi profil orang terus!!,negatif,2023-08-12,2023,ni account saya kenapa berubah jadi profil orang terus,9,9,ini akun saya kenapa berubah jadi profil orang terus,9,9,"['ini', 'akun', 'saya', 'kenapa', 'berubah', 'jadi', 'profil', 'orang', 'terus']","['akun', 'berubah', 'profil', 'orang']",9,4,5,akun ubah profil orang,4,4
gak bisa login... verif captcha terus,negatif,2023-11-26,2023,gak bisa login verif captcha terus,6,6,tidak bisa login verif captcha terus,6,6,"['tidak', 'bisa', 'login', 'verif', 'captcha', 'terus']","['tidak', 'login', 'verif', 'captcha']",6,4,2,tidak login verif captcha,4,4
"Applikasi tidak berfaedah untuk saya, karna gak ada panggilan kerja hahahaa",negatif,2023-10-14,2023,applikasi tidak berfaedah untuk saya karna gak ada panggilan kerja hahahaa,11,11,aplikasi tidak berfaedah untuk saya karena tidak ada panggilan kerja hahahaa,11,11,"['aplikasi', 'tidak', 'berfaedah', 'untuk', 'saya', 'karena', 'tidak', 'ada', 'panggilan', 'kerja', 'hahahaa']","['aplikasi', 'tidak', 'berfaedah', 'tidak', 'panggilan', 'kerja', 'hahahaa']",11,7,4,aplikasi tidak faedah tidak panggil kerja hahahaa,7,7
"Buruk bukan main buruk banget,sudah bener email saya malah tak bisa buka.",negatif,2023-07-22,2023,buruk bukan main buruk banget sudah bener email saya malah tak bisa buka,12,13,buruk bukan main buruk banget sudah benar email saya bahkan tidak bisa buka,13,13,"['buruk', 'bukan', 'main', 'buruk', 'banget', 'sudah', 'benar', 'email', 'saya', 'bahkan', 'tidak', 'bisa', 'buka']","['buruk', 'main', 'buruk', 'banget', 'email', 'tidak', 'buka']",13,7,6,buruk main buruk banget email tidak buka,7,7
Sangat buruk!!!!!!!! Untuk verivikasi butuh 1 hari??????? Apakah kami terlalu guoblok hny untuk jawab teka teki????????? Dipermainkan & buang waktu!!!!!!!! GPA!!!!!!!,negatif,2023-12-01,2023,sangat buruk untuk verivikasi butuh hari apakah kami terlalu guoblok hny untuk jawab teka teki dipermainkan buang waktu gpa,21,19,sangat buruk untuk verivikasi butuh hari apakah kami terlalu guoblok hanya untuk jawab teka teki dipermainkan buang waktu gpa,19,19,"['sangat', 'buruk', 'untuk', 'verivikasi', 'butuh', 'hari', 'apakah', 'kami', 'terlalu', 'guoblok', 'hanya', 'untuk', 'jawab', 'teka', 'teki', 'dipermainkan', 'buang', 'waktu', 'gpa']","['buruk', 'verivikasi', 'butuh', 'guoblok', 'teka', 'teki', 'dipermainkan', 'buang', 'gpa']",19,9,10,buruk verivikasi butuh guoblok teka teki main buang gpa,9,9
Menikmati dengan bahagia (terimakasi) good job,positif,2023-08-17,2023,menikmati dengan bahagia terimakasi good job,6,6,menikmati dengan bahagia terimakasi bagus kerja,6,6,"['menikmati', 'dengan', 'bahagia', 'terimakasi', 'bagus', 'kerja']","['menikmati', 'bahagia', 'terimakasi', 'bagus', 'kerja']",6,5,1,nikmat bahagia terimakasi bagus kerja,5,5
"Bagus,membantu mencari kerja",positif,2023-11-18,2023,bagus membantu mencari kerja,3,4,bagus membantu mencari kerja,4,4,"['bagus', 'membantu', 'mencari', 'kerja']","['bagus', 'membantu', 'mencari', 'kerja']",4,4,0,bagus bantu cari kerja,4,4
Sangat membantu bisnis saya terimakasih aplikasinya sangat bermanfaat..,positif,2024-01-12,2024,sangat membantu bisnis saya terimakasih aplikasinya sangat bermanfaat,8,8,sangat membantu bisnis saya terima kasih aplikasi nya sangat bermanfaat,8,10,"['sangat', 'membantu', 'bisnis', 'saya', 'terima', 'kasih', 'aplikasi', 'nya', 'sangat', 'bermanfaat']","['membantu', 'bisnis', 'terima', 'kasih', 'aplikasi', 'nya', 'bermanfaat']",10,7,3,bantu bisnis terima kasih aplikasi nya manfaat,7,7
Aplikasi yg mempertemukan pencari dan memberi pekerjaan serta pencari dan membuat produk.,positif,2023-03-21,2023,aplikasi yg mempertemukan pencari dan memberi pekerjaan serta pencari dan membuat produk,12,12,aplikasi yang mempertemukan pencari dan memberi pekerjaan serta pencari dan membuat produk,12,12,"['aplikasi', 'yang', 'mempertemukan', 'pencari', 'dan', 'memberi', 'pekerjaan', 'serta', 'pencari', 'dan', 'membuat', 'produk']","['aplikasi', 'mempertemukan', 'pencari', 'pekerjaan', 'pencari', 'produk']",12,6,6,aplikasi temu cari kerja cari produk,6,6
Sangat mendukung untuk aktifitas,positif,2024-01-04,2024,sangat mendukung untuk aktifitas,4,4,sangat mendukung untuk aktifitas,4,4,"['sangat', 'mendukung', 'untuk', 'aktifitas']","['mendukung', 'aktifitas']",4,2,2,dukung aktifitas,2,2
Parah ini aplikasi Ga bisa login dari aplikasi disuruh verifikasi terus,negatif,2024-01-20,2024,parah ini aplikasi ga bisa login dari aplikasi disuruh verifikasi terus,11,11,parah ini aplikasi tidak bisa login dari aplikasi disuruh verifikasi terus,11,11,"['parah', 'ini', 'aplikasi', 'tidak', 'bisa', 'login', 'dari', 'aplikasi', 'disuruh', 'verifikasi', 'terus']","['parah', 'aplikasi', 'tidak', 'login', 'aplikasi', 'disuruh', 'verifikasi']",11,7,4,parah aplikasi tidak login aplikasi suruh verifikasi,7,7
"Verifikasi nya , SMS dan Kode Dari Tlpn gak masuk"" nomer sudah benar dll Mau",negatif,2023-10-17,2023,verifikasi nya sms dan kode dari tlpn gak masuk nomer sudah benar dll mau,15,14,verifikasi nya sms dan kode dari telpon tidak masuk nomor sudah benar dan lain lain mau,14,16,"['verifikasi', 'nya', 'sms', 'dan', 'kode', 'dari', 'telpon', 'tidak', 'masuk', 'nomor', 'sudah', 'benar', 'dan', 'lain', 'lain', 'mau']","['verifikasi', 'nya', 'sms', 'kode', 'telpon', 'tidak', 'masuk', 'nomor']",16,8,8,verifikasi nya sms kode telpon tidak masuk nomor,8,8
Sangat luar biasa dan keren tampil beda,positif,2021-06-24,2021,sangat luar biasa dan keren tampil beda,7,7,sangat luar biasa dan keren tampil beda,7,7,"['sangat', 'luar', 'biasa', 'dan', 'keren', 'tampil', 'beda']","['keren', 'tampil', 'beda']",7,3,4,keren tampil beda,3,3
"Kenapa verifikasi sudah benar tapi captha tidak ditemukan maksudnya apa, dasar tolol nih developernya",negatif,2023-07-06,2023,kenapa verifikasi sudah benar tapi captha tidak ditemukan maksudnya apa dasar tolol nih developernya,14,14,kenapa verifikasi sudah benar tapi captha tidak ditemukan maksudnya apa dasar tolol nih developernya,14,14,"['kenapa', 'verifikasi', 'sudah', 'benar', 'tapi', 'captha', 'tidak', 'ditemukan', 'maksudnya', 'apa', 'dasar', 'tolol', 'nih', 'developernya']","['verifikasi', 'captha', 'tidak', 'ditemukan', 'maksudnya', 'dasar', 'tolol', 'nih', 'developernya']",14,9,5,verifikasi captha tidak temu maksud dasar tolol nih developer,9,9
Mohon maaf kenapa saya tidak bisa log in ya...selalu pas tes maanusia tidak seperti manusia...agak susah mau buat akunnya,negatif,2023-09-18,2023,mohon maaf kenapa saya tidak bisa log in ya selalu pas tes maanusia tidak seperti manusia agak susah mau buat akunnya,19,21,mohon maaf kenapa saya tidak bisa log in ya selalu pas tes maanusia tidak seperti manusia agak susah mau buat akunnya,21,21,"['mohon', 'maaf', 'kenapa', 'saya', 'tidak', 'bisa', 'log', 'in', 'ya', 'selalu', 'pas', 'tes', 'maanusia', 'tidak', 'seperti', 'manusia', 'agak', 'susah', 'mau', 'buat', 'akunnya']","['mohon', 'maaf', 'tidak', 'log', 'in', 'ya', 'pas', 'tes', 'maanusia', 'tidak', 'manusia', 'susah', 'akunnya']",21,13,8,mohon maaf tidak log in ya pas tes maanusia tidak manusia susah akun,13,13
"Berfungsi dengan normal, terimakasih",positif,2024-01-24,2024,berfungsi dengan normal terimakasih,4,4,berfungsi dengan normal terima kasih,4,5,"['berfungsi', 'dengan', 'normal', 'terima', 'kasih']","['berfungsi', 'normal', 'terima', 'kasih']",5,4,1,fungsi normal terima kasih,4,4
Mau daftar masuk gak biso kode kirim sms daftar lewat nomer aja belom aneh bgt apk,negatif,2023-11-29,2023,mau daftar masuk gak biso kode kirim sms daftar lewat nomer aja belom aneh bgt apk,16,16,mau daftar masuk tidak biso kode kirim sms daftar lewat nomor saja belum aneh banget aplikasi,16,16,"['mau', 'daftar', 'masuk', 'tidak', 'biso', 'kode', 'kirim', 'sms', 'daftar', 'lewat', 'nomor', 'saja', 'belum', 'aneh', 'banget', 'aplikasi']","['daftar', 'masuk', 'tidak', 'biso', 'kode', 'kirim', 'sms', 'daftar', 'nomor', 'aneh', 'banget', 'aplikasi']",16,12,4,daftar masuk tidak biso kode kirim sms daftar nomor aneh banget aplikasi,12,12
Aplikasinya bagus dan respons dari para pengguna sangat bermanfaat,positif,2023-09-25,2023,aplikasinya bagus dan respons dari para pengguna sangat bermanfaat,9,9,aplikasi nya bagus dan respons dari para pengguna sangat bermanfaat,9,10,"['aplikasi', 'nya', 'bagus', 'dan', 'respons', 'dari', 'para', 'pengguna', 'sangat', 'bermanfaat']","['aplikasi', 'nya', 'bagus', 'respons', 'pengguna', 'bermanfaat']",10,6,4,aplikasi nya bagus respons guna manfaat,6,6
Saya sangat menyukai aplikasi ini. Semoga dapat memberi wawasan yang lebih meluas dalam kehidupan.,positif,2020-11-12,2020,saya sangat menyukai aplikasi ini semoga dapat memberi wawasan yang lebih meluas dalam kehidupan,14,14,saya sangat menyukai aplikasi ini semoga dapat memberi wawasan yang lebih meluas dalam kehidupan,14,14,"['saya', 'sangat', 'menyukai', 'aplikasi', 'ini', 'semoga', 'dapat', 'memberi', 'wawasan', 'yang', 'lebih', 'meluas', 'dalam', 'kehidupan']","['menyukai', 'aplikasi', 'semoga', 'wawasan', 'meluas', 'kehidupan']",14,6,8,suka aplikasi moga wawas luas hidup,6,6
Verifikasi login susah ganti aja yg gampang.,negatif,2023-08-02,2023,verifikasi login susah ganti aja yg gampang,7,7,verifikasi login susah ganti saja yang gampang,7,7,"['verifikasi', 'login', 'susah', 'ganti', 'saja', 'yang', 'gampang']","['verifikasi', 'login', 'susah', 'ganti', 'gampang']",7,5,2,verifikasi login susah ganti gampang,5,5
otomatis akan mendeteksi pasangan aplikasi ini dengan baik dan benar sesuai dengan Akun Facebook Anda,positif,2023-06-28,2023,otomatis akan mendeteksi pasangan aplikasi ini dengan baik dan benar sesuai dengan akun facebook anda,15,15,otomatis akan mendeteksi pasangan aplikasi ini dengan baik dan benar sesuai dengan akun facebook anda,15,15,"['otomatis', 'akan', 'mendeteksi', 'pasangan', 'aplikasi', 'ini', 'dengan', 'baik', 'dan', 'benar', 'sesuai', 'dengan', 'akun', 'facebook', 'anda']","['otomatis', 'mendeteksi', 'pasangan', 'aplikasi', 'sesuai', 'akun', 'facebook']",15,7,8,otomatis deteksi pasang aplikasi sesuai akun facebook,7,7
"Chapcha nya terlalu susah, saya sudah mencoba berulang kali tetap gagal",negatif,2023-10-05,2023,chapcha nya terlalu susah saya sudah mencoba berulang kali tetap gagal,11,11,chapcha nya terlalu susah saya sudah mencoba berulang kali tetap gagal,11,11,"['chapcha', 'nya', 'terlalu', 'susah', 'saya', 'sudah', 'mencoba', 'berulang', 'kali', 'tetap', 'gagal']","['chapcha', 'nya', 'susah', 'mencoba', 'berulang', 'kali', 'gagal']",11,7,4,chapcha nya susah coba ulang kali gagal,7,7
Mau login masuk aja dibikin ribet.. Malah bolak balik instal.,negatif,2020-06-22,2020,mau login masuk aja dibikin ribet malah bolak balik instal,10,10,mau login masuk saja dibikin rumit bahkan bolak balik memasang,10,10,"['mau', 'login', 'masuk', 'saja', 'dibikin', 'rumit', 'bahkan', 'bolak', 'balik', 'memasang']","['login', 'masuk', 'dibikin', 'rumit', 'bolak', 'memasang']",10,6,4,login masuk bikin rumit bolak pasang,6,6
Respon kode noCAPTCHA anda tidak valid terus padahal udah bener isinya,negatif,2023-06-21,2023,respon kode nocaptcha anda tidak valid terus padahal udah bener isinya,11,11,respons kode nocaptcha anda tidak valid terus padahal sudah benar isinya,11,11,"['respons', 'kode', 'nocaptcha', 'anda', 'tidak', 'valid', 'terus', 'padahal', 'sudah', 'benar', 'isinya']","['respons', 'kode', 'nocaptcha', 'tidak', 'valid', 'isinya']",11,6,5,respons kode nocaptcha tidak valid isi,6,6
Bagus dan mantap untuk bisnis,positif,2023-10-09,2023,bagus dan mantap untuk bisnis,5,5,bagus dan mantap untuk bisnis,5,5,"['bagus', 'dan', 'mantap', 'untuk', 'bisnis']","['bagus', 'mantap', 'bisnis']",5,3,2,bagus mantap bisnis,3,3
"Kok gaptcha nya gabisa"" ya, mau masuk ae susah",negatif,2023-08-26,2023,kok gaptcha nya gabisa ya mau masuk ae susah,9,9,kok gaptcha nya tidak bisa ya mau masuk ae susah,9,10,"['kok', 'gaptcha', 'nya', 'tidak', 'bisa', 'ya', 'mau', 'masuk', 'ae', 'susah']","['gaptcha', 'nya', 'tidak', 'ya', 'masuk', 'ae', 'susah']",10,7,3,gaptcha nya tidak ya masuk ae susah,7,7
Tampilan menu dan pilihan menunya simple,positif,2024-02-04,2024,tampilan menu dan pilihan menunya simple,6,6,tampilan menu dan pilihan menunya simpel,6,6,"['tampilan', 'menu', 'dan', 'pilihan', 'menunya', 'simpel']","['tampilan', 'menu', 'pilihan', 'menunya', 'simpel']",6,5,1,tampil menu pilih menu simpel,5,5
"Tiba2 akun saya ke blokir sementara dan tidak bisa login, admin mohon bantuannya",negatif,2024-01-05,2024,tiba akun saya ke blokir sementara dan tidak bisa login admin mohon bantuannya,13,13,tiba akun saya ke blokir sementara dan tidak bisa login admin mohon bantuannya,13,13,"['tiba', 'akun', 'saya', 'ke', 'blokir', 'sementara', 'dan', 'tidak', 'bisa', 'login', 'admin', 'mohon', 'bantuannya']","['akun', 'blokir', 'tidak', 'login', 'admin', 'mohon', 'bantuannya']",13,7,6,akun blokir tidak login admin mohon bantu,7,7
Kenapa verifikasi manusia nya ngulang terus? Gak bisa login,negatif,2024-01-09,2024,kenapa verifikasi manusia nya ngulang terus gak bisa login,9,9,kenapa verifikasi manusia nya mengulang terus tidak bisa login,9,9,"['kenapa', 'verifikasi', 'manusia', 'nya', 'mengulang', 'terus', 'tidak', 'bisa', 'login']","['verifikasi', 'manusia', 'nya', 'mengulang', 'tidak', 'login']",9,6,3,verifikasi manusia nya ulang tidak login,6,6
verivikasi not Robot error tidak dapat login,negatif,2023-06-21,2023,verivikasi not robot error tidak dapat login,7,7,verivikasi not robot error tidak dapat login,7,7,"['verivikasi', 'not', 'robot', 'error', 'tidak', 'dapat', 'login']","['verivikasi', 'not', 'robot', 'error', 'tidak', 'login']",7,6,1,verivikasi not robot error tidak login,6,6
Kenapa login kembali tidak bisa dibuka,negatif,2021-03-08,2021,kenapa login kembali tidak bisa dibuka,6,6,kenapa login kembali tidak bisa dibuka,6,6,"['kenapa', 'login', 'kembali', 'tidak', 'bisa', 'dibuka']","['login', 'tidak', 'dibuka']",6,3,3,login tidak buka,3,3
"Veryfikasi anda belum di isi, udh suruh milih dogi hampir 30x",negatif,2023-12-18,2023,veryfikasi anda belum di isi udh suruh milih dogi hampir x,11,11,veryfikasi anda belum di isi sudah suruh memilih dogi hampir x,11,11,"['veryfikasi', 'anda', 'belum', 'di', 'isi', 'sudah', 'suruh', 'memilih', 'dogi', 'hampir', 'x']","['veryfikasi', 'isi', 'suruh', 'memilih', 'dogi', 'x']",11,6,5,veryfikasi isi suruh pilih dog x,6,6
"Sangat membantu dalam mencari link pekerjaan,semoga segera dapat pekerjaan yang diinginkan Aamiin 🤲",positif,2024-02-06,2024,sangat membantu dalam mencari link pekerjaan semoga segera dapat pekerjaan yang diinginkan aamiin,13,13,sangat membantu dalam mencari link pekerjaan semoga segera dapat pekerjaan yang diinginkan aamiin,13,13,"['sangat', 'membantu', 'dalam', 'mencari', 'link', 'pekerjaan', 'semoga', 'segera', 'dapat', 'pekerjaan', 'yang', 'diinginkan', 'aamiin']","['membantu', 'mencari', 'link', 'pekerjaan', 'semoga', 'pekerjaan', 'aamiin']",13,7,6,bantu cari link kerja moga kerja aamiin,7,7
Mudah untuk mencari pekerjaan,positif,2023-08-29,2023,mudah untuk mencari pekerjaan,4,4,mudah untuk mencari pekerjaan,4,4,"['mudah', 'untuk', 'mencari', 'pekerjaan']","['mudah', 'mencari', 'pekerjaan']",4,3,1,mudah cari kerja,3,3
"MAU LOGIN DI LAPTOP AJA HARUS PAKE VERIFIKASI GAMBAR KODOK KAGAK JELAS, PADAHAL LOGIN DI HP GA SERIBET ITU, APLIKASI GA GUNA, GA JELAS, RIBET. UDAH BERHASIL VERIFIKASI DILAPTOP AJA MASIH GA BISA2. EMOSI GUE.",negatif,2021-10-03,2021,mau login di laptop aja harus pake verifikasi gambar kodok kagak jelas padahal login di hp ga seribet itu aplikasi ga guna ga jelas ribet udah berhasil verifikasi dilaptop aja masih ga bisa emosi gue,35,35,mau login di laptop saja harus pakai verifikasi gambar kodok tidak jelas padahal login di handphone tidak seribet itu aplikasi tidak guna tidak jelas rumit sudah berhasil verifikasi dilaptop saja masih tidak bisa emosi saya,35,35,"['mau', 'login', 'di', 'laptop', 'saja', 'harus', 'pakai', 'verifikasi', 'gambar', 'kodok', 'tidak', 'jelas', 'padahal', 'login', 'di', 'handphone', 'tidak', 'seribet', 'itu', 'aplikasi', 'tidak', 'guna', 'tidak', 'jelas', 'rumit', 'sudah', 'berhasil', 'verifikasi', 'dilaptop', 'saja', 'masih', 'tidak', 'bisa', 'emosi', 'saya']","['login', 'laptop', 'pakai', 'verifikasi', 'gambar', 'kodok', 'tidak', 'login', 'handphone', 'tidak', 'seribet', 'aplikasi', 'tidak', 'tidak', 'rumit', 'berhasil', 'verifikasi', 'dilaptop', 'tidak', 'emosi']",35,20,15,login laptop pakai verifikasi gambar kodok tidak login handphone tidak seribet aplikasi tidak tidak rumit hasil verifikasi laptop tidak emosi,20,20
Mempermudah mencari job,positif,2023-12-10,2023,mempermudah mencari job,3,3,mempermudah mencari kerja,3,3,"['mempermudah', 'mencari', 'kerja']","['mempermudah', 'mencari', 'kerja']",3,3,0,mudah cari kerja,3,3
"Akun saya terkena hack dan saya tidak dapat mengembalikannya, saya sangat sedih sekali",negatif,2023-08-14,2023,akun saya terkena hack dan saya tidak dapat mengembalikannya saya sangat sedih sekali,13,13,akun saya terkena hack dan saya tidak dapat mengembalikannya saya sangat sedih sekali,13,13,"['akun', 'saya', 'terkena', 'hack', 'dan', 'saya', 'tidak', 'dapat', 'mengembalikannya', 'saya', 'sangat', 'sedih', 'sekali']","['akun', 'terkena', 'hack', 'tidak', 'mengembalikannya', 'sedih']",13,6,7,akun kena hack tidak kembali sedih,6,6
Apk yang sangat membantu dlm mencari peluang kerja,positif,2023-11-13,2023,apk yang sangat membantu dlm mencari peluang kerja,8,8,aplikasi yang sangat membantu dalam mencari peluang kerja,8,8,"['aplikasi', 'yang', 'sangat', 'membantu', 'dalam', 'mencari', 'peluang', 'kerja']","['aplikasi', 'membantu', 'mencari', 'peluang', 'kerja']",8,5,3,aplikasi bantu cari peluang kerja,5,5
Sangat bagus untuk kalangan pencari kerja,positif,2022-05-30,2022,sangat bagus untuk kalangan pencari kerja,6,6,sangat bagus untuk kalangan pencari kerja,6,6,"['sangat', 'bagus', 'untuk', 'kalangan', 'pencari', 'kerja']","['bagus', 'kalangan', 'pencari', 'kerja']",6,4,2,bagus kalang cari kerja,4,4
"Ga bisa masuk, nyusahin alias bikin ribet orang, verifikasi nya",negatif,2024-01-30,2024,ga bisa masuk nyusahin alias bikin ribet orang verifikasi nya,10,10,tidak bisa masuk nyusahin alias bikin rumit orang verifikasi nya,10,10,"['tidak', 'bisa', 'masuk', 'nyusahin', 'alias', 'bikin', 'rumit', 'orang', 'verifikasi', 'nya']","['tidak', 'masuk', 'nyusahin', 'alias', 'bikin', 'rumit', 'orang', 'verifikasi', 'nya']",10,9,1,tidak masuk nyusahin alias bikin rumit orang verifikasi nya,9,9
Sangat mudah mencari pekerjaan,positif,2024-02-24,2024,sangat mudah mencari pekerjaan,4,4,sangat mudah mencari pekerjaan,4,4,"['sangat', 'mudah', 'mencari', 'pekerjaan']","['mudah', 'mencari', 'pekerjaan']",4,3,1,mudah cari kerja,3,3
Bagus akan lebih bagus bila saya dapat kan pekerjaan dari linkedln,positif,2024-02-09,2024,bagus akan lebih bagus bila saya dapat kan pekerjaan dari linkedln,11,11,bagus akan lebih bagus bila saya dapat akan pekerjaan dari linkedln,11,11,"['bagus', 'akan', 'lebih', 'bagus', 'bila', 'saya', 'dapat', 'akan', 'pekerjaan', 'dari', 'linkedln']","['bagus', 'bagus', 'pekerjaan', 'linkedln']",11,4,7,bagus bagus kerja linkedln,4,4
Apk yang sangat membantu terkoneksi dengan semua profesional,positif,2024-02-11,2024,apk yang sangat membantu terkoneksi dengan semua profesional,8,8,aplikasi yang sangat membantu terkoneksi dengan semua profesional,8,8,"['aplikasi', 'yang', 'sangat', 'membantu', 'terkoneksi', 'dengan', 'semua', 'profesional']","['aplikasi', 'membantu', 'terkoneksi', 'profesional']",8,4,4,aplikasi bantu koneksi profesional,4,4
"LinkedIn kena hack padahal udah banyak followers lebih dari 500 malah kena hack, keamanan nya dimana?",negatif,2023-08-03,2023,linkedin kena hack padahal udah banyak followers lebih dari malah kena hack keamanan nya dimana,16,15,linkedin kena hack padahal sudah banyak followers lebih dari bahkan kena hack keamanan nya dimana,15,15,"['linkedin', 'kena', 'hack', 'padahal', 'sudah', 'banyak', 'followers', 'lebih', 'dari', 'bahkan', 'kena', 'hack', 'keamanan', 'nya', 'dimana']","['linkedin', 'kena', 'hack', 'followers', 'kena', 'hack', 'keamanan', 'nya', 'dimana']",15,9,6,linkedin kena hack followers kena hack aman nya mana,9,9
"Memudahkan banget buat nyari job , good",positif,2023-10-19,2023,memudahkan banget buat nyari job good,7,6,memudahkan banget buat mencari kerja bagus,6,6,"['memudahkan', 'banget', 'buat', 'mencari', 'kerja', 'bagus']","['memudahkan', 'banget', 'mencari', 'kerja', 'bagus']",6,5,1,mudah banget cari kerja bagus,5,5
Pencarian Lowongan pekerjaan yg kemungkinan bisa memudahkan seseai dengan Kualifikasi pendidikan dan keahlian Terimakasih Linkedln,positif,2023-10-28,2023,pencarian lowongan pekerjaan yg kemungkinan bisa memudahkan seseai dengan kualifikasi pendidikan dan keahlian terimakasih linkedln,15,15,pencarian lowongan pekerjaan yang kemungkinan bisa memudahkan seseai dengan kualifikasi pendidikan dan keahlian terima kasih linkedln,15,16,"['pencarian', 'lowongan', 'pekerjaan', 'yang', 'kemungkinan', 'bisa', 'memudahkan', 'seseai', 'dengan', 'kualifikasi', 'pendidikan', 'dan', 'keahlian', 'terima', 'kasih', 'linkedln']","['pencarian', 'lowongan', 'pekerjaan', 'memudahkan', 'seseai', 'kualifikasi', 'pendidikan', 'keahlian', 'terima', 'kasih', 'linkedln']",16,11,5,cari lowong kerja mudah seseai kualifikasi didik ahli terima kasih linkedln,11,11
Sangat membantu dalam hal pencarian kerja,positif,2020-10-22,2020,sangat membantu dalam hal pencarian kerja,6,6,sangat membantu dalam hal pencarian kerja,6,6,"['sangat', 'membantu', 'dalam', 'hal', 'pencarian', 'kerja']","['membantu', 'pencarian', 'kerja']",6,3,3,bantu cari kerja,3,3
mau login juga susah ama lama,negatif,2023-11-10,2023,mau login juga susah ama lama,6,6,mau login juga susah sama lama,6,6,"['mau', 'login', 'juga', 'susah', 'sama', 'lama']","['login', 'susah']",6,2,4,login susah,2,2
Tiap di buka langsung kluar sendiri g bisa di pakai 😠,negatif,2023-11-09,2023,tiap di buka langsung kluar sendiri g bisa di pakai,11,10,tiap di buka langsung keluar sendiri tidak bisa di pakai,10,10,"['tiap', 'di', 'buka', 'langsung', 'keluar', 'sendiri', 'tidak', 'bisa', 'di', 'pakai']","['buka', 'langsung', 'tidak', 'pakai']",10,4,6,buka langsung tidak pakai,4,4
"Entah apa apa aplikasi ini , gak di instal pun muncul dengan sendirinya ,",negatif,2024-02-02,2024,entah apa apa aplikasi ini gak di instal pun muncul dengan sendirinya,14,12,entah apa apa aplikasi ini tidak di memasang pun muncul dengan sendirinya,12,12,"['entah', 'apa', 'apa', 'aplikasi', 'ini', 'tidak', 'di', 'memasang', 'pun', 'muncul', 'dengan', 'sendirinya']","['aplikasi', 'tidak', 'memasang', 'muncul']",12,4,8,aplikasi tidak pasang muncul,4,4
Aplikasi masih banyak bug nya,negatif,2023-07-29,2023,aplikasi masih banyak bug nya,5,5,aplikasi masih banyak bug nya,5,5,"['aplikasi', 'masih', 'banyak', 'bug', 'nya']","['aplikasi', 'bug', 'nya']",5,3,2,aplikasi bug nya,3,3
Aplikasi ga berguna. Mau login doang susah bgt. Nyesel bgt,negatif,2023-07-24,2023,aplikasi ga berguna mau login doang susah bgt nyesel bgt,10,10,aplikasi tidak berguna mau login saja susah banget menyesal banget,10,10,"['aplikasi', 'tidak', 'berguna', 'mau', 'login', 'saja', 'susah', 'banget', 'menyesal', 'banget']","['aplikasi', 'tidak', 'berguna', 'login', 'susah', 'banget', 'menyesal', 'banget']",10,8,2,aplikasi tidak guna login susah banget sesal banget,8,8
Kenapa saya tidak bisa daftar?padahal baru pertama kali log in.Tolong bantu saya,negatif,2024-01-22,2024,kenapa saya tidak bisa daftar padahal baru pertama kali log in tolong bantu saya,12,14,kenapa saya tidak bisa daftar padahal baru pertama kali log in tolong bantu saya,14,14,"['kenapa', 'saya', 'tidak', 'bisa', 'daftar', 'padahal', 'baru', 'pertama', 'kali', 'log', 'in', 'tolong', 'bantu', 'saya']","['tidak', 'daftar', 'kali', 'log', 'in', 'tolong', 'bantu']",14,7,7,tidak daftar kali log in tolong bantu,7,7
"Tebak gambar terooss sampe kiamat, aplikasi ngga jelas.",negatif,2023-08-04,2023,tebak gambar terooss sampe kiamat aplikasi ngga jelas,8,8,tebak gambar terooss sampai kiamat aplikasi tidak jelas,8,8,"['tebak', 'gambar', 'terooss', 'sampai', 'kiamat', 'aplikasi', 'tidak', 'jelas']","['tebak', 'gambar', 'terooss', 'kiamat', 'aplikasi', 'tidak']",8,6,2,tebak gambar terooss kiamat aplikasi tidak,6,6
Kenapa pas verifikasi CHAPTA sudah benar tapi mengulang terus menerus sampai upin ipin tamat SD??,negatif,2023-07-28,2023,kenapa pas verifikasi chapta sudah benar tapi mengulang terus menerus sampai upin ipin tamat sd,15,15,kenapa pas verifikasi chapta sudah benar tapi mengulang terus menerus sampai upin ipin tamat sudah,15,15,"['kenapa', 'pas', 'verifikasi', 'chapta', 'sudah', 'benar', 'tapi', 'mengulang', 'terus', 'menerus', 'sampai', 'upin', 'ipin', 'tamat', 'sudah']","['pas', 'verifikasi', 'chapta', 'mengulang', 'menerus', 'upin', 'ipin', 'tamat']",15,8,7,pas verifikasi chapta ulang terus upin ipin tamat,8,8
"Aplikasi untuk pencari kerja (karyawan) dan para profesional ( advokat, psikolog, direktur, manager, HRD, dll ) 👌👌👌",positif,2022-05-10,2022,aplikasi untuk pencari kerja karyawan dan para profesional advokat psikolog direktur manager hrd dll,17,14,aplikasi untuk pencari kerja karyawan dan para profesional advokat psikolog direktur manager hrd dan lain lain,14,16,"['aplikasi', 'untuk', 'pencari', 'kerja', 'karyawan', 'dan', 'para', 'profesional', 'advokat', 'psikolog', 'direktur', 'manager', 'hrd', 'dan', 'lain', 'lain']","['aplikasi', 'pencari', 'kerja', 'karyawan', 'profesional', 'advokat', 'psikolog', 'direktur', 'manager', 'hrd']",16,10,6,aplikasi cari kerja karyawan profesional advokat psikolog direktur manager hrd,10,10
mengecewakan sangat. aplikasi jelek. bubarkan saja aplikasi ini selamanya.,negatif,2023-12-29,2023,mengecewakan sangat aplikasi jelek bubarkan saja aplikasi ini selamanya,9,9,mengecewakan sangat aplikasi jelek bubarkan saja aplikasi ini selamanya,9,9,"['mengecewakan', 'sangat', 'aplikasi', 'jelek', 'bubarkan', 'saja', 'aplikasi', 'ini', 'selamanya']","['mengecewakan', 'aplikasi', 'jelek', 'bubarkan', 'aplikasi']",9,5,4,kecewa aplikasi jelek bubar aplikasi,5,5
"Ngasih captcha gausah ribet² lah, Mao masuk aja gagal terus",negatif,2022-08-14,2022,ngasih captcha gausah ribet² lah mao masuk aja gagal terus,10,10,memberikan captcha tidak perlu ribet² lah mau masuk saja gagal terus,10,11,"['memberikan', 'captcha', 'tidak', 'perlu', 'ribet²', 'lah', 'mau', 'masuk', 'saja', 'gagal', 'terus']","['captcha', 'tidak', 'ribet²', 'masuk', 'gagal']",11,5,6,captcha tidak ribet masuk gagal,5,5
Aplikask aneh. Minta kode verifikasi aja gak masuk masuk. Kocak,negatif,2023-09-06,2023,aplikask aneh minta kode verifikasi aja gak masuk masuk kocak,10,10,aplikask aneh minta kode verifikasi saja tidak masuk masuk kocak,10,10,"['aplikask', 'aneh', 'minta', 'kode', 'verifikasi', 'saja', 'tidak', 'masuk', 'masuk', 'kocak']","['aplikask', 'aneh', 'kode', 'verifikasi', 'tidak', 'masuk', 'masuk', 'kocak']",10,8,2,aplikask aneh kode verifikasi tidak masuk masuk kocak,8,8
Sungguh menambah wawasan dengan banyak terhubung kepada orang orang yang berpikiran POSITIF... Sehingga memudahkan kita berinteraksi sosial.. Harap dijaga dari postingan hal hal yang mengandung SARA.. Semoga selalu membaca postingan yg bersifat mendidik... Bravo LI.... God bless,positif,2020-08-01,2020,sungguh menambah wawasan dengan banyak terhubung kepada orang orang yang berpikiran positif sehingga memudahkan kita berinteraksi sosial harap dijaga dari postingan hal hal yang mengandung sara semoga selalu membaca postingan yg bersifat mendidik bravo li god bless,37,37,sungguh menambah wawasan dengan banyak terhubung kepada orang orang yang berpikiran positif sehingga memudahkan kita berinteraksi sosial harap dijaga dari postingan hal hal yang mengandung sara semoga selalu membaca postingan yang bersifat mendidik bravo li god bless,37,37,"['sungguh', 'menambah', 'wawasan', 'dengan', 'banyak', 'terhubung', 'kepada', 'orang', 'orang', 'yang', 'berpikiran', 'positif', 'sehingga', 'memudahkan', 'kita', 'berinteraksi', 'sosial', 'harap', 'dijaga', 'dari', 'postingan', 'hal', 'hal', 'yang', 'mengandung', 'sara', 'semoga', 'selalu', 'membaca', 'postingan', 'yang', 'bersifat', 'mendidik', 'bravo', 'li', 'god', 'bless']","['sungguh', 'menambah', 'wawasan', 'terhubung', 'orang', 'orang', 'berpikiran', 'positif', 'memudahkan', 'berinteraksi', 'sosial', 'harap', 'dijaga', 'postingan', 'mengandung', 'sara', 'semoga', 'membaca', 'postingan', 'bersifat', 'mendidik', 'bravo', 'li', 'god', 'bless']",37,25,12,sungguh tambah wawas hubung orang orang pikir positif mudah interaksi sosial harap jaga postingan kandung sara moga baca postingan sifat didik bravo li god bless,25,25
Aplikasi kontol apa si tas tes tas tes gambar mulu salah mulu goblok buang buang wktu aja woe benerin apk lu gk berguna,negatif,2024-01-19,2024,aplikasi kontol apa si tas tes tas tes gambar mulu salah mulu goblok buang buang wktu aja woe benerin apk lu gk berguna,23,23,aplikasi kontol apa sih tas tes tas tes gambar mulu salah mulu goblok buang buang waktu saja woe benerin aplikasi lu tidak berguna,23,23,"['aplikasi', 'kontol', 'apa', 'sih', 'tas', 'tes', 'tas', 'tes', 'gambar', 'mulu', 'salah', 'mulu', 'goblok', 'buang', 'buang', 'waktu', 'saja', 'woe', 'benerin', 'aplikasi', 'lu', 'tidak', 'berguna']","['aplikasi', 'kontol', 'sih', 'tas', 'tes', 'tas', 'tes', 'gambar', 'mulu', 'salah', 'mulu', 'goblok', 'buang', 'buang', 'woe', 'benerin', 'aplikasi', 'lu', 'tidak', 'berguna']",23,20,3,aplikasi kontol sih tas tes tas tes gambar mulu salah mulu goblok buang buang woe benerin aplikasi lu tidak guna,20,20
recommended untuk cari kerja,positif,2023-12-18,2023,recommended untuk cari kerja,4,4,rekomendasi untuk cari kerja,4,4,"['rekomendasi', 'untuk', 'cari', 'kerja']","['rekomendasi', 'cari', 'kerja']",4,3,1,rekomendasi cari kerja,3,3
kenapa akun tidak bisa di akses?ketika mau verifikasi lagi tidak bisa?,negatif,2023-08-23,2023,kenapa akun tidak bisa di akses ketika mau verifikasi lagi tidak bisa,11,12,kenapa akun tidak bisa di akses ketika mau verifikasi lagi tidak bisa,12,12,"['kenapa', 'akun', 'tidak', 'bisa', 'di', 'akses', 'ketika', 'mau', 'verifikasi', 'lagi', 'tidak', 'bisa']","['akun', 'tidak', 'akses', 'verifikasi', 'tidak']",12,5,7,akun tidak akses verifikasi tidak,5,5
Aplikasi tolol cmn login pun harus pake teka-teki babi d ulang terus walaupun udh bnr juga jawaban ny,negatif,2024-02-17,2024,aplikasi tolol cmn login pun harus pake teka teki babi d ulang terus walaupun udh bnr juga jawaban ny,18,19,aplikasi tolol cuman login pun harus pakai teka teki babi di ulang terus walaupun sudah benar juga jawaban nya,19,19,"['aplikasi', 'tolol', 'cuman', 'login', 'pun', 'harus', 'pakai', 'teka', 'teki', 'babi', 'di', 'ulang', 'terus', 'walaupun', 'sudah', 'benar', 'juga', 'jawaban', 'nya']","['aplikasi', 'tolol', 'cuman', 'login', 'pakai', 'teka', 'teki', 'babi', 'ulang', 'nya']",19,10,9,aplikasi tolol cuman login pakai teka teki babi ulang nya,10,10
Wah keren tampilan sekarang ada Histori nya,positif,2020-10-23,2020,wah keren tampilan sekarang ada histori nya,7,7,wah keren tampilan sekarang ada histori nya,7,7,"['wah', 'keren', 'tampilan', 'sekarang', 'ada', 'histori', 'nya']","['keren', 'tampilan', 'histori', 'nya']",7,4,3,keren tampil histori nya,4,4
"Sangat bagus sejak saya jadi FG (2016), apalagi untuk Personal Branding, justru pekerjaan yang akan mencari Anda. Regards, (Linkedin : Khulafaur Rosyidin | Digital Creator of Food Quality)",positif,2024-01-06,2024,sangat bagus sejak saya jadi fg apalagi untuk personal branding justru pekerjaan yang akan mencari anda regards linkedin khulafaur rosyidin digital creator of food quality,28,25,sangat bagus sejak saya jadi fg apalagi untuk personal branding justru pekerjaan yang akan mencari anda regards linkedin khulafaur rosyidin digital creator of food kualitas,25,25,"['sangat', 'bagus', 'sejak', 'saya', 'jadi', 'fg', 'apalagi', 'untuk', 'personal', 'branding', 'justru', 'pekerjaan', 'yang', 'akan', 'mencari', 'anda', 'regards', 'linkedin', 'khulafaur', 'rosyidin', 'digital', 'creator', 'of', 'food', 'kualitas']","['bagus', 'fg', 'personal', 'branding', 'pekerjaan', 'mencari', 'regards', 'linkedin', 'khulafaur', 'rosyidin', 'digital', 'creator', 'of', 'food', 'kualitas']",25,15,10,bagus fg personal branding kerja cari regards linkedin khulafaur rosyidin digital creator of food kualitas,15,15
Apps ini memberikan warna yang baik untuk kita yang ingin bekerja kita dengan berremu dengan orang yang hebat hebat,positif,2020-12-31,2020,apps ini memberikan warna yang baik untuk kita yang ingin bekerja kita dengan berremu dengan orang yang hebat hebat,19,19,aplikasi ini memberikan warna yang baik untuk kita yang ingin bekerja kita dengan berremu dengan orang yang hebat hebat,19,19,"['aplikasi', 'ini', 'memberikan', 'warna', 'yang', 'baik', 'untuk', 'kita', 'yang', 'ingin', 'bekerja', 'kita', 'dengan', 'berremu', 'dengan', 'orang', 'yang', 'hebat', 'hebat']","['aplikasi', 'warna', 'berremu', 'orang', 'hebat', 'hebat']",19,6,13,aplikasi warna berremu orang hebat hebat,6,6
Sbgai sumber berita ulasan lintas berita yg penting bgi pembaca dan penyampai berita,positif,2020-08-24,2020,sbgai sumber berita ulasan lintas berita yg penting bgi pembaca dan penyampai berita,13,13,sbgai sumber berita ulasan lintas berita yang penting bgi pembaca dan penyampai berita,13,13,"['sbgai', 'sumber', 'berita', 'ulasan', 'lintas', 'berita', 'yang', 'penting', 'bgi', 'pembaca', 'dan', 'penyampai', 'berita']","['sbgai', 'sumber', 'berita', 'ulasan', 'lintas', 'berita', 'bgi', 'pembaca', 'penyampai', 'berita']",13,10,3,sbgai sumber berita ulas lintas berita bgi baca sampai berita,10,10
Sangat bagus bagi pencari kerja,positif,2023-11-18,2023,sangat bagus bagi pencari kerja,5,5,sangat bagus bagi pencari kerja,5,5,"['sangat', 'bagus', 'bagi', 'pencari', 'kerja']","['bagus', 'pencari', 'kerja']",5,3,2,bagus cari kerja,3,3
"Ini aplikasi dah kayak sampah menurut gue, verifikasi ribet. Programmer apaan ini ? Hadeh , apyuuunn...",negatif,2023-07-29,2023,ini aplikasi dah kayak sampah menurut gue verifikasi ribet programmer apaan ini hadeh apyuuunn,16,14,ini aplikasi sudah kayak sampah menurut saya verifikasi rumit programmer apa ini hadeh apyuuunn,14,14,"['ini', 'aplikasi', 'sudah', 'kayak', 'sampah', 'menurut', 'saya', 'verifikasi', 'rumit', 'programmer', 'apa', 'ini', 'hadeh', 'apyuuunn']","['aplikasi', 'kayak', 'sampah', 'verifikasi', 'rumit', 'programmer', 'hadeh', 'apyuuunn']",14,8,6,aplikasi kayak sampah verifikasi rumit programmer hadeh apyuuunn,8,8
Plattform terbaik dalam jobseeker and find networking👍,positif,2024-02-28,2024,plattform terbaik dalam jobseeker and find networking,7,7,plattform terbaik dalam jobseeker and find networking,7,7,"['plattform', 'terbaik', 'dalam', 'jobseeker', 'and', 'find', 'networking']","['plattform', 'terbaik', 'jobseeker', 'and', 'find', 'networking']",7,6,1,plattform baik jobseeker and find networking,6,6
"Susah Daftar , VERIFIKASI KODOK ZUMA GAGAL TERUS GAMBAR MENGHADAP KEATAS TAPI GA ADA PILIHAN KODOK ZUMA KEATAS , JANGAN MENYUSAHKAN PARA PENCARI KERJA , plissss",negatif,2021-09-06,2021,susah daftar verifikasi kodok zuma gagal terus gambar menghadap keatas tapi ga ada pilihan kodok zuma keatas jangan menyusahkan para pencari kerja plissss,26,23,susah daftar verifikasi kodok zuma gagal terus gambar menghadap keatas tapi tidak ada pilihan kodok zuma keatas jangan menyusahkan para pencari kerja plissss,23,23,"['susah', 'daftar', 'verifikasi', 'kodok', 'zuma', 'gagal', 'terus', 'gambar', 'menghadap', 'keatas', 'tapi', 'tidak', 'ada', 'pilihan', 'kodok', 'zuma', 'keatas', 'jangan', 'menyusahkan', 'para', 'pencari', 'kerja', 'plissss']","['susah', 'daftar', 'verifikasi', 'kodok', 'zuma', 'gagal', 'gambar', 'menghadap', 'keatas', 'tidak', 'pilihan', 'kodok', 'zuma', 'keatas', 'menyusahkan', 'pencari', 'kerja', 'plissss']",23,18,5,susah daftar verifikasi kodok zuma gagal gambar hadap atas tidak pilih kodok zuma atas susah cari kerja plissss,18,18
"tolong dong apa ada call center, saya mau login akun tapi ga bisa via email dan telepon",negatif,2024-02-26,2024,tolong dong apa ada call center saya mau login akun tapi ga bisa via email dan telepon,17,17,tolong dong apa ada call center saya mau login akun tapi tidak bisa melalui email dan telpon,17,17,"['tolong', 'dong', 'apa', 'ada', 'call', 'center', 'saya', 'mau', 'login', 'akun', 'tapi', 'tidak', 'bisa', 'melalui', 'email', 'dan', 'telpon']","['tolong', 'call', 'center', 'login', 'akun', 'tidak', 'email', 'telpon']",17,8,9,tolong call center login akun tidak email telpon,8,8
di perbarui malah makin ruwet bukan mudahin penguna,negatif,2024-03-03,2024,di perbarui malah makin ruwet bukan mudahin penguna,8,8,di perbarui bahkan makin ruwet bukan mudahin penguna,8,8,"['di', 'perbarui', 'bahkan', 'makin', 'ruwet', 'bukan', 'mudahin', 'penguna']","['perbarui', 'ruwet', 'mudahin', 'penguna']",8,4,4,baru ruwet mudahin penguna,4,4
"Apk gak guna, mau masuk aja disuruh verifikasi ribet, dikira robot yang pakai hp bukan manusia sungguhan 👎👎👎👎👎👎",negatif,2023-11-09,2023,apk gak guna mau masuk aja disuruh verifikasi ribet dikira robot yang pakai hp bukan manusia sungguhan,18,17,aplikasi tidak guna mau masuk saja disuruh verifikasi rumit dikira robot yang pakai handphone bukan manusia sungguhan,17,17,"['aplikasi', 'tidak', 'guna', 'mau', 'masuk', 'saja', 'disuruh', 'verifikasi', 'rumit', 'dikira', 'robot', 'yang', 'pakai', 'handphone', 'bukan', 'manusia', 'sungguhan']","['aplikasi', 'tidak', 'masuk', 'disuruh', 'verifikasi', 'rumit', 'robot', 'pakai', 'handphone', 'manusia', 'sungguhan']",17,11,6,aplikasi tidak masuk suruh verifikasi rumit robot pakai handphone manusia sungguh,11,11
"Gak guna, isinya cuman orang pamer jabatan, pamer kerjaan baru, sok-sokan ngasih motivasi tapi isinya sampah. Lo semua cuman budak kagak usah belagu dah.",negatif,2022-07-03,2022,gak guna isinya cuman orang pamer jabatan pamer kerjaan baru sok sokan ngasih motivasi tapi isinya sampah lo semua cuman budak kagak usah belagu dah,24,25,tidak guna isinya cuman orang pamer jabatan pamer kerjaan baru sok sokan memberikan motivasi tapi isinya sampah lo semua cuman budak tidak usah belagu sudah,25,25,"['tidak', 'guna', 'isinya', 'cuman', 'orang', 'pamer', 'jabatan', 'pamer', 'kerjaan', 'baru', 'sok', 'sokan', 'memberikan', 'motivasi', 'tapi', 'isinya', 'sampah', 'lo', 'semua', 'cuman', 'budak', 'tidak', 'usah', 'belagu', 'sudah']","['tidak', 'isinya', 'cuman', 'orang', 'pamer', 'jabatan', 'pamer', 'kerjaan', 'sok', 'sokan', 'motivasi', 'isinya', 'sampah', 'lo', 'cuman', 'budak', 'tidak', 'belagu']",25,18,7,tidak isi cuman orang pamer jabat pamer kerja sok sok motivasi isi sampah lo cuman budak tidak belagu,18,18
Aplikasinya sangat membantu untuk menghubungkan saya dengan informasi seputar info pekerjaan,positif,2024-02-24,2024,aplikasinya sangat membantu untuk menghubungkan saya dengan informasi seputar info pekerjaan,11,11,aplikasi nya sangat membantu untuk menghubungkan saya dengan informasi seputar informasi pekerjaan,11,12,"['aplikasi', 'nya', 'sangat', 'membantu', 'untuk', 'menghubungkan', 'saya', 'dengan', 'informasi', 'seputar', 'informasi', 'pekerjaan']","['aplikasi', 'nya', 'membantu', 'menghubungkan', 'informasi', 'seputar', 'informasi', 'pekerjaan']",12,8,4,aplikasi nya bantu hubung informasi putar informasi kerja,8,8
setelah di update tambah ribet,negatif,2024-03-04,2024,setelah di update tambah ribet,5,5,setelah di diperbarui tambah rumit,5,5,"['setelah', 'di', 'diperbarui', 'tambah', 'rumit']","['diperbarui', 'rumit']",5,2,3,baru rumit,2,2
"kenapa akun saya sudah 3 kali di nonaktifkan, PAYAH 😡😡 padahal tidak ad niatan saya mau berbuat jahat ataupun iseng",negatif,2021-10-14,2021,kenapa akun saya sudah kali di nonaktifkan payah padahal tidak ad niatan saya mau berbuat jahat ataupun iseng,20,18,kenapa akun saya sudah kali di nonaktifkan payah padahal tidak ada niatan saya mau berbuat jahat ataupun iseng,18,18,"['kenapa', 'akun', 'saya', 'sudah', 'kali', 'di', 'nonaktifkan', 'payah', 'padahal', 'tidak', 'ada', 'niatan', 'saya', 'mau', 'berbuat', 'jahat', 'ataupun', 'iseng']","['akun', 'kali', 'nonaktifkan', 'payah', 'tidak', 'niatan', 'berbuat', 'jahat', 'iseng']",18,9,9,akun kali nonaktif payah tidak niat buat jahat iseng,9,9
tolong di filter lagi perusahaannya supaya tidak ada perusahaan pialang di LinkedIn.,negatif,2024-02-29,2024,tolong di filter lagi perusahaannya supaya tidak ada perusahaan pialang di linkedin,12,12,tolong di filter lagi perusahaannya supaya tidak ada perusahaan pialang di linkedin,12,12,"['tolong', 'di', 'filter', 'lagi', 'perusahaannya', 'supaya', 'tidak', 'ada', 'perusahaan', 'pialang', 'di', 'linkedin']","['tolong', 'filter', 'perusahaannya', 'tidak', 'perusahaan', 'pialang', 'linkedin']",12,7,5,tolong filter usaha tidak usaha pialang linkedin,7,7
"mau masuk aplikasi ajja pake ktp segala, ngeri data pribadi diupload sembarangan padahal bukan bagian dari pemerintahan atau perbankan.",negatif,2023-12-03,2023,mau masuk aplikasi ajja pake ktp segala ngeri data pribadi diupload sembarangan padahal bukan bagian dari pemerintahan atau perbankan,19,19,mau masuk aplikasi ajja pakai ktp segala mengerikan data pribadi diupload sembarangan padahal bukan bagian dari pemerintahan atau perbankan,19,19,"['mau', 'masuk', 'aplikasi', 'ajja', 'pakai', 'ktp', 'segala', 'mengerikan', 'data', 'pribadi', 'diupload', 'sembarangan', 'padahal', 'bukan', 'bagian', 'dari', 'pemerintahan', 'atau', 'perbankan']","['masuk', 'aplikasi', 'ajja', 'pakai', 'ktp', 'mengerikan', 'data', 'pribadi', 'diupload', 'sembarangan', 'pemerintahan', 'perbankan']",19,12,7,masuk aplikasi ajja pakai ktp keri data pribadi diupload sembarang perintah perban,12,12
"Kemarin Mash bisa apply lamaran, dan ini mau apply malah eror, bolak balik loh in coba lagi Mulu,pdhal byak prushaan bonafit lah.. merugikan banyak orang ini aplikasi",negatif,2023-07-25,2023,kemarin mash bisa apply lamaran dan ini mau apply malah eror bolak balik loh in coba lagi mulu pdhal byak prushaan bonafit lah merugikan banyak orang ini aplikasi,27,28,kemarin masih bisa apply lamaran dan ini mau apply bahkan error bolak balik loh in coba lagi mulu pdhal byak prushaan bonafit lah merugikan banyak orang ini aplikasi,28,28,"['kemarin', 'masih', 'bisa', 'apply', 'lamaran', 'dan', 'ini', 'mau', 'apply', 'bahkan', 'error', 'bolak', 'balik', 'loh', 'in', 'coba', 'lagi', 'mulu', 'pdhal', 'byak', 'prushaan', 'bonafit', 'lah', 'merugikan', 'banyak', 'orang', 'ini', 'aplikasi']","['kemarin', 'apply', 'lamaran', 'apply', 'error', 'bolak', 'loh', 'in', 'coba', 'mulu', 'pdhal', 'byak', 'prushaan', 'bonafit', 'merugikan', 'orang', 'aplikasi']",28,17,11,kemarin apply lamar apply error bolak loh in coba mulu pdhal byak prushaan bonafit rugi orang aplikasi,17,17
Tolong di tingkatkan lagi jangan...saya masih kcewa bnyak lowongan di sinih yang masih minta uang sbelum di pekerjakan...pnipuan lagi,negatif,2020-08-29,2020,tolong di tingkatkan lagi jangan saya masih kcewa bnyak lowongan di sinih yang masih minta uang sbelum di pekerjakan pnipuan lagi,19,21,tolong di tingkatkan lagi jangan saya masih kecewa banyak lowongan di sinih yang masih minta uang sbelum di pekerjakan pnipuan lagi,21,21,"['tolong', 'di', 'tingkatkan', 'lagi', 'jangan', 'saya', 'masih', 'kecewa', 'banyak', 'lowongan', 'di', 'sinih', 'yang', 'masih', 'minta', 'uang', 'sbelum', 'di', 'pekerjakan', 'pnipuan', 'lagi']","['tolong', 'tingkatkan', 'kecewa', 'lowongan', 'sinih', 'uang', 'sbelum', 'pekerjakan', 'pnipuan']",21,9,12,tolong tingkat kecewa lowong sih uang sbelum kerja pnipuan,9,9
"Ribet nyari2 kerjaannya, masuk2 lagi ke link sana, link sini.....",negatif,2022-07-25,2022,ribet nyari kerjaannya masuk lagi ke link sana link sini,10,10,rumit mencari kerjaannya masuk lagi ke link sana link sini,10,10,"['rumit', 'mencari', 'kerjaannya', 'masuk', 'lagi', 'ke', 'link', 'sana', 'link', 'sini']","['rumit', 'mencari', 'kerjaannya', 'masuk', 'link', 'link']",10,6,4,rumit cari kerja masuk link link,6,6
"Kebanyakan penipu lokernya, udah dateng ke kantornya ehh malah di minta biaya admin, hadehhhh parahh lahhh",negatif,2020-09-12,2020,kebanyakan penipu lokernya udah dateng ke kantornya ehh malah di minta biaya admin hadehhhh parahh lahhh,16,16,kebanyakan penipu lokernya sudah datang ke kantornya eh bahkan di minta biaya admin hadehhhh parahh lahhh,16,16,"['kebanyakan', 'penipu', 'lokernya', 'sudah', 'datang', 'ke', 'kantornya', 'eh', 'bahkan', 'di', 'minta', 'biaya', 'admin', 'hadehhhh', 'parahh', 'lahhh']","['kebanyakan', 'penipu', 'lokernya', 'kantornya', 'eh', 'biaya', 'admin', 'hadehhhh', 'parahh', 'lahhh']",16,10,6,banyak tipu lokernya kantor eh biaya admin hadehhhh parahh lahhh,10,10
Aplikasi Linkdeln membantu dalam mengembangkan bisnis Makanan online saya,positif,2022-01-02,2022,aplikasi linkdeln membantu dalam mengembangkan bisnis makanan online saya,9,9,aplikasi linkdeln membantu dalam mengembangkan bisnis makanan daring saya,9,9,"['aplikasi', 'linkdeln', 'membantu', 'dalam', 'mengembangkan', 'bisnis', 'makanan', 'daring', 'saya']","['aplikasi', 'linkdeln', 'membantu', 'mengembangkan', 'bisnis', 'makanan', 'daring']",9,7,2,aplikasi linkdeln bantu kembang bisnis makan daring,7,7
sangat tepat untuk Karir n sharing job juga utk mengetahui tentang profil Perusahaan,positif,2023-10-26,2023,sangat tepat untuk karir n sharing job juga utk mengetahui tentang profil perusahaan,13,13,sangat tepat untuk karir dan sharing kerja juga untuk mengetahui tentang profil perusahaan,13,13,"['sangat', 'tepat', 'untuk', 'karir', 'dan', 'sharing', 'kerja', 'juga', 'untuk', 'mengetahui', 'tentang', 'profil', 'perusahaan']","['karir', 'sharing', 'kerja', 'profil', 'perusahaan']",13,5,8,karir sharing kerja profil usaha,5,5
"Hello admin, saya mau bertanya kenapa akun saya di nonaktif sama pihak Linked ? Tolong di klarifikasinya ya",negatif,2020-02-22,2020,hello admin saya mau bertanya kenapa akun saya di nonaktif sama pihak linked tolong di klarifikasinya ya,18,17,hello admin saya mau bertanya kenapa akun saya di nonaktif sama pihak linked tolong di klarifikasinya ya,17,17,"['hello', 'admin', 'saya', 'mau', 'bertanya', 'kenapa', 'akun', 'saya', 'di', 'nonaktif', 'sama', 'pihak', 'linked', 'tolong', 'di', 'klarifikasinya', 'ya']","['hello', 'admin', 'akun', 'nonaktif', 'linked', 'tolong', 'klarifikasinya', 'ya']",17,8,9,hello admin akun nonaktif linked tolong klarifikasi ya,8,8
Apk aneh .kita download apk ini untuk cari kerja .mau log in mlah isi profil tanya kerjaan,negatif,2024-02-17,2024,apk aneh kita download apk ini untuk cari kerja mau log in mlah isi profil tanya kerjaan,17,17,aplikasi aneh kita unduh aplikasi ini untuk cari kerja mau log in malah isi profil tanya kerjaan,17,17,"['aplikasi', 'aneh', 'kita', 'unduh', 'aplikasi', 'ini', 'untuk', 'cari', 'kerja', 'mau', 'log', 'in', 'malah', 'isi', 'profil', 'tanya', 'kerjaan']","['aplikasi', 'aneh', 'unduh', 'aplikasi', 'cari', 'kerja', 'log', 'in', 'isi', 'profil', 'kerjaan']",17,11,6,aplikasi aneh unduh aplikasi cari kerja log in isi profil kerja,11,11
"Beralih dari Platform Bisnis dan Pekerjaan, menjadi platform Sosial Media. Sedih Rasanya, Jika Komentar ini di balas. sudah di pastikan itu adalah ROBOT, Bukan Developer / Customer Support",negatif,2021-06-15,2021,beralih dari platform bisnis dan pekerjaan menjadi platform sosial media sedih rasanya jika komentar ini di balas sudah di pastikan itu adalah robot bukan developer customer support,28,27,beralih dari platform bisnis dan pekerjaan menjadi platform sosial media sedih rasanya jika komentar ini di balas sudah di pastikan itu adalah robot bukan developer pelanggan support,27,27,"['beralih', 'dari', 'platform', 'bisnis', 'dan', 'pekerjaan', 'menjadi', 'platform', 'sosial', 'media', 'sedih', 'rasanya', 'jika', 'komentar', 'ini', 'di', 'balas', 'sudah', 'di', 'pastikan', 'itu', 'adalah', 'robot', 'bukan', 'developer', 'pelanggan', 'support']","['beralih', 'platform', 'bisnis', 'pekerjaan', 'platform', 'sosial', 'media', 'sedih', 'komentar', 'balas', 'pastikan', 'robot', 'developer', 'pelanggan', 'support']",27,15,12,alih platform bisnis kerja platform sosial media sedih komentar balas pasti robot developer langgan support,15,15
"Terus verifikasi tp gk masuk masuk, heran",negatif,2023-08-11,2023,terus verifikasi tp gk masuk masuk heran,7,7,terus verifikasi tapi tidak masuk masuk heran,7,7,"['terus', 'verifikasi', 'tapi', 'tidak', 'masuk', 'masuk', 'heran']","['verifikasi', 'tidak', 'masuk', 'masuk', 'heran']",7,5,2,verifikasi tidak masuk masuk heran,5,5
Apk yg lumayan gk guna terlebih ferytifikasi yg susah sekali di mengerti,negatif,2023-07-27,2023,apk yg lumayan gk guna terlebih ferytifikasi yg susah sekali di mengerti,12,12,aplikasi yang lumayan tidak guna terlebih ferytifikasi yang susah sekali di mengerti,12,12,"['aplikasi', 'yang', 'lumayan', 'tidak', 'guna', 'terlebih', 'ferytifikasi', 'yang', 'susah', 'sekali', 'di', 'mengerti']","['aplikasi', 'lumayan', 'tidak', 'ferytifikasi', 'susah', 'mengerti']",12,6,6,aplikasi lumayan tidak ferytifikasi susah erti,6,6
AQ mau cari pekerjaan kok Malah di suruh bayar perbulan Itu bagaimana..,negatif,2022-11-09,2022,aq mau cari pekerjaan kok malah di suruh bayar perbulan itu bagaimana,12,12,saya mau cari pekerjaan kok bahkan di suruh bayar perbulan itu bagaimana,12,12,"['saya', 'mau', 'cari', 'pekerjaan', 'kok', 'bahkan', 'di', 'suruh', 'bayar', 'perbulan', 'itu', 'bagaimana']","['cari', 'pekerjaan', 'suruh', 'bayar', 'perbulan']",12,5,7,cari kerja suruh bayar bulan,5,5
Verifikasinya susah gambar mengarah keatas bolak - balik GK bisa Repot ini apps,negatif,2022-06-24,2022,verifikasinya susah gambar mengarah keatas bolak balik gk bisa repot ini apps,13,12,verifikasinya susah gambar mengarah keatas bolak balik tidak bisa repot ini aplikasi,12,12,"['verifikasinya', 'susah', 'gambar', 'mengarah', 'keatas', 'bolak', 'balik', 'tidak', 'bisa', 'repot', 'ini', 'aplikasi']","['verifikasinya', 'susah', 'gambar', 'mengarah', 'keatas', 'bolak', 'tidak', 'repot', 'aplikasi']",12,9,3,verifikasi susah gambar arah atas bolak tidak repot aplikasi,9,9
Yang buat apk tolol Susah kali mau daftar aja ribet Verifikasinya muter2 gak jelas,negatif,2021-09-18,2021,yang buat apk tolol susah kali mau daftar aja ribet verifikasinya muter gak jelas,14,14,yang buat aplikasi tolol susah kali mau daftar saja rumit verifikasinya memutar tidak jelas,14,14,"['yang', 'buat', 'aplikasi', 'tolol', 'susah', 'kali', 'mau', 'daftar', 'saja', 'rumit', 'verifikasinya', 'memutar', 'tidak', 'jelas']","['aplikasi', 'tolol', 'susah', 'kali', 'daftar', 'rumit', 'verifikasinya', 'memutar', 'tidak']",14,9,5,aplikasi tolol susah kali daftar rumit verifikasi putar tidak,9,9
"Hidup ini simpel Brooo,, kenapa dibuat ribet??????? Verifikasi aja ribet banget..",negatif,2022-07-06,2022,hidup ini simpel brooo kenapa dibuat ribet verifikasi aja ribet banget,11,11,hidup ini simpel brooo kenapa dibuat rumit verifikasi saja rumit banget,11,11,"['hidup', 'ini', 'simpel', 'brooo', 'kenapa', 'dibuat', 'rumit', 'verifikasi', 'saja', 'rumit', 'banget']","['hidup', 'simpel', 'brooo', 'rumit', 'verifikasi', 'rumit', 'banget']",11,7,4,hidup simpel brooo rumit verifikasi rumit banget,7,7
sangat membantu sekali untuk informasi lowongan pkerjaan.,positif,2022-02-14,2022,sangat membantu sekali untuk informasi lowongan pkerjaan,7,7,sangat membantu sekali untuk informasi lowongan pkerjaan,7,7,"['sangat', 'membantu', 'sekali', 'untuk', 'informasi', 'lowongan', 'pkerjaan']","['membantu', 'informasi', 'lowongan', 'pkerjaan']",7,4,3,bantu informasi lowong pkerjaan,4,4
"Ini beneran linkedln asli kah? Kok gak bisa masuk, saya takut data saya disalahgunakan, soalnya udh kirim ktp",negatif,2021-12-28,2021,ini beneran linkedln asli kah kok gak bisa masuk saya takut data saya disalahgunakan soalnya udh kirim ktp,18,18,ini benaran linkedln asli kah kok tidak bisa masuk saya takut data saya disalahgunakan soalnya sudah kirim ktp,18,18,"['ini', 'benaran', 'linkedln', 'asli', 'kah', 'kok', 'tidak', 'bisa', 'masuk', 'saya', 'takut', 'data', 'saya', 'disalahgunakan', 'soalnya', 'sudah', 'kirim', 'ktp']","['benaran', 'linkedln', 'asli', 'kah', 'tidak', 'masuk', 'takut', 'data', 'disalahgunakan', 'kirim', 'ktp']",18,11,7,benar linkedln asli kah tidak masuk takut data disalahgunakan kirim ktp,11,11
"Sesama para pejuang kerja, mohon doanya dan saya mendoakan kalian semua agar dapat pekerjaan yang diinginkan 🙏",positif,2021-07-02,2021,sesama para pejuang kerja mohon doanya dan saya mendoakan kalian semua agar dapat pekerjaan yang diinginkan,17,16,sesama para pejuang kerja mohon doanya dan saya mendoakan kalian semua agar dapat pekerjaan yang diinginkan,16,16,"['sesama', 'para', 'pejuang', 'kerja', 'mohon', 'doanya', 'dan', 'saya', 'mendoakan', 'kalian', 'semua', 'agar', 'dapat', 'pekerjaan', 'yang', 'diinginkan']","['pejuang', 'kerja', 'mohon', 'doanya', 'mendoakan', 'pekerjaan']",16,6,10,juang kerja mohon doa doa kerja,6,6
Tolong jangan ada yg pake atas nama husen d aplikasi mana pun ya makasih,negatif,2023-06-14,2023,tolong jangan ada yg pake atas nama husen d aplikasi mana pun ya makasih,14,14,tolong jangan ada yang pakai atas nama husen di aplikasi mana pun ya terima kasih,14,15,"['tolong', 'jangan', 'ada', 'yang', 'pakai', 'atas', 'nama', 'husen', 'di', 'aplikasi', 'mana', 'pun', 'ya', 'terima', 'kasih']","['tolong', 'pakai', 'nama', 'husen', 'aplikasi', 'ya', 'terima', 'kasih']",15,8,7,tolong pakai nama husen aplikasi ya terima kasih,8,8
Saya pikir lowongan kerja . Ternyata banyak sales yayasan yang ribet ya,negatif,2022-10-24,2022,saya pikir lowongan kerja ternyata banyak sales yayasan yang ribet ya,12,11,saya pikir lowongan kerja ternyata banyak sales yayasan yang rumit ya,11,11,"['saya', 'pikir', 'lowongan', 'kerja', 'ternyata', 'banyak', 'sales', 'yayasan', 'yang', 'rumit', 'ya']","['pikir', 'lowongan', 'kerja', 'sales', 'yayasan', 'rumit', 'ya']",11,7,4,pikir lowong kerja sales yayasan rumit ya,7,7
Waah siip membantu juga untuk yg butuh pekerjaan yg serius,positif,2020-03-29,2020,waah siip membantu juga untuk yg butuh pekerjaan yg serius,10,10,waah siip membantu juga untuk yang butuh pekerjaan yang serius,10,10,"['waah', 'siip', 'membantu', 'juga', 'untuk', 'yang', 'butuh', 'pekerjaan', 'yang', 'serius']","['waah', 'siip', 'membantu', 'butuh', 'pekerjaan', 'serius']",10,6,4,waah siip bantu butuh kerja serius,6,6
"Aplikasi BERAK belum dapat kerja udah minta bayar 500 perbulan, GILA LU Yaa. Saraff",negatif,2022-01-01,2022,aplikasi berak belum dapat kerja udah minta bayar perbulan gila lu yaa saraff,14,13,aplikasi berak belum dapat kerja sudah minta bayar perbulan gila lu ya saraff,13,13,"['aplikasi', 'berak', 'belum', 'dapat', 'kerja', 'sudah', 'minta', 'bayar', 'perbulan', 'gila', 'lu', 'ya', 'saraff']","['aplikasi', 'berak', 'kerja', 'bayar', 'perbulan', 'gila', 'lu', 'ya', 'saraff']",13,9,4,aplikasi berak kerja bayar bulan gila lu ya saraff,9,9
Bagus dan keren aplikasinya. Tapi jangan berpuas diri...yaaa Mas & Mbak.,positif,2021-02-10,2021,bagus dan keren aplikasinya tapi jangan berpuas diri yaaa mas mbak,11,11,bagus dan keren aplikasi nya tapi jangan berpuas diri yaaa mas mbak,11,12,"['bagus', 'dan', 'keren', 'aplikasi', 'nya', 'tapi', 'jangan', 'berpuas', 'diri', 'yaaa', 'mas', 'mbak']","['bagus', 'keren', 'aplikasi', 'nya', 'berpuas', 'yaaa', 'mas', 'mbak']",12,8,4,bagus keren aplikasi nya puas yaaa mas mbak,8,8
Semakin jelek..semua serba dibatasi..sangat mengecewakan...tks,negatif,2023-09-15,2023,semakin jelek semua serba dibatasi sangat mengecewakan tks,5,8,semakin jelek semua serba dibatasi sangat mengecewakan terima kasih,8,9,"['semakin', 'jelek', 'semua', 'serba', 'dibatasi', 'sangat', 'mengecewakan', 'terima', 'kasih']","['jelek', 'serba', 'dibatasi', 'mengecewakan', 'terima', 'kasih']",9,6,3,jelek serba batas kecewa terima kasih,6,6
Verifikasinya ga jelas. Masa udah ngisi berapa kali gabisa masuk juga. Gimana sih!,negatif,2024-03-02,2024,verifikasinya ga jelas masa udah ngisi berapa kali gabisa masuk juga gimana sih,13,13,verifikasinya tidak jelas masa sudah mengisi berapa kali tidak bisa masuk juga bagaimana sih,13,14,"['verifikasinya', 'tidak', 'jelas', 'masa', 'sudah', 'mengisi', 'berapa', 'kali', 'tidak', 'bisa', 'masuk', 'juga', 'bagaimana', 'sih']","['verifikasinya', 'tidak', 'mengisi', 'kali', 'tidak', 'masuk', 'sih']",14,7,7,verifikasi tidak isi kali tidak masuk sih,7,7
Tolong yahhh saya sudah berhenti akun tapi masih pemotongan saldo gimana yah merugikan,negatif,2023-07-09,2023,tolong yahhh saya sudah berhenti akun tapi masih pemotongan saldo gimana yah merugikan,13,13,tolong yahhh saya sudah berhenti akun tapi masih pemotongan saldo bagaimana ya merugikan,13,13,"['tolong', 'yahhh', 'saya', 'sudah', 'berhenti', 'akun', 'tapi', 'masih', 'pemotongan', 'saldo', 'bagaimana', 'ya', 'merugikan']","['tolong', 'yahhh', 'berhenti', 'akun', 'pemotongan', 'saldo', 'ya', 'merugikan']",13,8,5,tolong yahhh henti akun potong saldo ya rugi,8,8
"Tolong dong biar di permudahkan buat login,gambar bikin ribet",negatif,2023-01-29,2023,tolong dong biar di permudahkan buat login gambar bikin ribet,9,10,tolong dong biar di permudahkan buat login gambar bikin rumit,10,10,"['tolong', 'dong', 'biar', 'di', 'permudahkan', 'buat', 'login', 'gambar', 'bikin', 'rumit']","['tolong', 'biar', 'permudahkan', 'login', 'gambar', 'bikin', 'rumit']",10,7,3,tolong biar mudah login gambar bikin rumit,7,7
Tetap tingkatkan kualitas dan kuantitas untuk memuaskan kebutuhan para pelanggan 👍🏻👍🏻👍🏻. Terima Kasih,positif,2022-06-09,2022,tetap tingkatkan kualitas dan kuantitas untuk memuaskan kebutuhan para pelanggan terima kasih,13,12,tetap tingkatkan kualitas dan kuantitas untuk memuaskan kebutuhan para pelanggan terima kasih,12,12,"['tetap', 'tingkatkan', 'kualitas', 'dan', 'kuantitas', 'untuk', 'memuaskan', 'kebutuhan', 'para', 'pelanggan', 'terima', 'kasih']","['tingkatkan', 'kualitas', 'kuantitas', 'memuaskan', 'kebutuhan', 'pelanggan', 'terima', 'kasih']",12,8,4,tingkat kualitas kuantitas muas butuh langgan terima kasih,8,8
Membantu untuk meningkatkan relasi dan sebagai forum dikusi,positif,2022-07-19,2022,membantu untuk meningkatkan relasi dan sebagai forum dikusi,8,8,membantu untuk meningkatkan relasi dan sebagai forum dikusi,8,8,"['membantu', 'untuk', 'meningkatkan', 'relasi', 'dan', 'sebagai', 'forum', 'dikusi']","['membantu', 'meningkatkan', 'relasi', 'forum', 'dikusi']",8,5,3,bantu tingkat relasi forum kus,5,5
Terimakasih LinkedIn telah menjadi platform sharing portfolio profesional. Thanks,positif,2021-08-22,2021,terimakasih linkedin telah menjadi platform sharing portfolio profesional thanks,9,9,terima kasih linkedin telah menjadi platform sharing portfolio profesional terima kasih,9,11,"['terima', 'kasih', 'linkedin', 'telah', 'menjadi', 'platform', 'sharing', 'portfolio', 'profesional', 'terima', 'kasih']","['terima', 'kasih', 'linkedin', 'platform', 'sharing', 'portfolio', 'profesional', 'terima', 'kasih']",11,9,2,terima kasih linkedin platform sharing portfolio profesional terima kasih,9,9
"Aplikasi tolol verivikasi login sampe 10x nggak masuk""",negatif,2022-08-03,2022,aplikasi tolol verivikasi login sampe x nggak masuk,8,8,aplikasi tolol verivikasi login sampai x tidak masuk,8,8,"['aplikasi', 'tolol', 'verivikasi', 'login', 'sampai', 'x', 'tidak', 'masuk']","['aplikasi', 'tolol', 'verivikasi', 'login', 'x', 'tidak', 'masuk']",8,7,1,aplikasi tolol verivikasi login x tidak masuk,7,7
Dapet banyak kerjaan lewat sini. Malah lebih banyak daripada platform lain yang nggak pecah telor pecah telor. Wkwkwkwk,positif,2021-08-19,2021,dapet banyak kerjaan lewat sini malah lebih banyak daripada platform lain yang nggak pecah telor pecah telor wkwkwkwk,18,18,dapat banyak kerjaan lewat sini bahkan lebih banyak daripada platform lain yang tidak pecah telor pecah telor wkwkwkwk,18,18,"['dapat', 'banyak', 'kerjaan', 'lewat', 'sini', 'bahkan', 'lebih', 'banyak', 'daripada', 'platform', 'lain', 'yang', 'tidak', 'pecah', 'telor', 'pecah', 'telor', 'wkwkwkwk']","['kerjaan', 'platform', 'tidak', 'pecah', 'telor', 'pecah', 'telor', 'wkwkwkwk']",18,8,10,kerja platform tidak pecah telor pecah telor wkwkwkwk,8,8
"Sosial media yang paling saya sukai iklimnya. Benar benar positif, membantu banyak orang mendapatkan pekerjaan dan membantu banyak perusahaan menemukan karyawan. Semoga taun ini saya dapat jon yang sesuai dengan harapan",positif,2020-11-07,2020,sosial media yang paling saya sukai iklimnya benar benar positif membantu banyak orang mendapatkan pekerjaan dan membantu banyak perusahaan menemukan karyawan semoga taun ini saya dapat jon yang sesuai dengan harapan,31,31,sosial media yang paling saya suka iklimnya benar benar positif membantu banyak orang mendapatkan pekerjaan dan membantu banyak perusahaan menemukan karyawan semoga taun ini saya dapat jon yang sesuai dengan harapan,31,31,"['sosial', 'media', 'yang', 'paling', 'saya', 'suka', 'iklimnya', 'benar', 'benar', 'positif', 'membantu', 'banyak', 'orang', 'mendapatkan', 'pekerjaan', 'dan', 'membantu', 'banyak', 'perusahaan', 'menemukan', 'karyawan', 'semoga', 'taun', 'ini', 'saya', 'dapat', 'jon', 'yang', 'sesuai', 'dengan', 'harapan']","['sosial', 'media', 'suka', 'iklimnya', 'positif', 'membantu', 'orang', 'pekerjaan', 'membantu', 'perusahaan', 'menemukan', 'karyawan', 'semoga', 'taun', 'jon', 'sesuai', 'harapan']",31,17,14,sosial media suka iklim positif bantu orang kerja bantu usaha temu karyawan moga taun jon sesuai harap,17,17
"Apk kontol mau masuk/daftar aja harus verifikasi chaptcha, mana gagal mulu padahal bener.... Lu pikir robot bakal nyari loker?",negatif,2023-06-21,2023,apk kontol mau masuk daftar aja harus verifikasi chaptcha mana gagal mulu padahal bener lu pikir robot bakal nyari loker,19,20,aplikasi kontol mau masuk daftar saja harus verifikasi chaptcha mana gagal mulu padahal benar lu pikir robot bakal mencari loker,20,20,"['aplikasi', 'kontol', 'mau', 'masuk', 'daftar', 'saja', 'harus', 'verifikasi', 'chaptcha', 'mana', 'gagal', 'mulu', 'padahal', 'benar', 'lu', 'pikir', 'robot', 'bakal', 'mencari', 'loker']","['aplikasi', 'kontol', 'masuk', 'daftar', 'verifikasi', 'chaptcha', 'gagal', 'mulu', 'lu', 'pikir', 'robot', 'mencari', 'loker']",20,13,7,aplikasi kontol masuk daftar verifikasi chaptcha gagal mulu lu pikir robot cari loker,13,13
Gak semua lowker disini bisa langsng ke lamar ya kdng hrus unduh aplikasi laink kayak glits atau jobstrest gtggt ribet,negatif,2022-07-03,2022,gak semua lowker disini bisa langsng ke lamar ya kdng hrus unduh aplikasi laink kayak glits atau jobstrest gtggt ribet,20,20,tidak semua lowker disini bisa langsng ke lamar ya kadang harus unduh aplikasi laink kayak glits atau jobstrest gtggt rumit,20,20,"['tidak', 'semua', 'lowker', 'disini', 'bisa', 'langsng', 'ke', 'lamar', 'ya', 'kadang', 'harus', 'unduh', 'aplikasi', 'laink', 'kayak', 'glits', 'atau', 'jobstrest', 'gtggt', 'rumit']","['tidak', 'lowker', 'langsng', 'lamar', 'ya', 'kadang', 'unduh', 'aplikasi', 'laink', 'kayak', 'glits', 'jobstrest', 'gtggt', 'rumit']",20,14,6,tidak lowker langsng lamar ya kadang unduh aplikasi laink kayak glits jobstrest gtggt rumit,14,14
nyari kerja disini susah data malah kesebar kemana mana aplikasi tidak bermanfaat merugikan,negatif,2023-08-02,2023,nyari kerja disini susah data malah kesebar kemana mana aplikasi tidak bermanfaat merugikan,13,13,mencari kerja disini susah data bahkan kesebar kemana mana aplikasi tidak bermanfaat merugikan,13,13,"['mencari', 'kerja', 'disini', 'susah', 'data', 'bahkan', 'kesebar', 'kemana', 'mana', 'aplikasi', 'tidak', 'bermanfaat', 'merugikan']","['mencari', 'kerja', 'susah', 'data', 'kesebar', 'kemana', 'aplikasi', 'tidak', 'bermanfaat', 'merugikan']",13,10,3,cari kerja susah data sebar mana aplikasi tidak manfaat rugi,10,10
Suruh muterin bola susah serasa di ejekkkk . Malah ngatain klo bener manusia lagi emnk anjing bisa main hp,negatif,2020-07-02,2020,suruh muterin bola susah serasa di ejekkkk malah ngatain klo bener manusia lagi emnk anjing bisa main hp,19,18,suruh muterin bola susah serasa di ejekkkk bahkan ngatain kalau benar manusia lagi emnk anjing bisa main handphone,18,18,"['suruh', 'muterin', 'bola', 'susah', 'serasa', 'di', 'ejekkkk', 'bahkan', 'ngatain', 'kalau', 'benar', 'manusia', 'lagi', 'emnk', 'anjing', 'bisa', 'main', 'handphone']","['suruh', 'muterin', 'bola', 'susah', 'serasa', 'ejekkkk', 'ngatain', 'manusia', 'emnk', 'anjing', 'main', 'handphone']",18,12,6,suruh muterin bola susah serasa ejekkkk ngatain manusia emnk anjing main handphone,12,12
Kenapa yah akun LinkedIn ku eror sudah 4hari ga bisa akses LinkedIn Bisa tolong dibantu?,negatif,2020-12-08,2020,kenapa yah akun linkedin ku eror sudah hari ga bisa akses linkedin bisa tolong dibantu,15,15,kenapa ya akun linkedin saya error sudah hari tidak bisa akses linkedin bisa tolong dibantu,15,15,"['kenapa', 'ya', 'akun', 'linkedin', 'saya', 'error', 'sudah', 'hari', 'tidak', 'bisa', 'akses', 'linkedin', 'bisa', 'tolong', 'dibantu']","['ya', 'akun', 'linkedin', 'error', 'tidak', 'akses', 'linkedin', 'tolong', 'dibantu']",15,9,6,ya akun linkedin error tidak akses linkedin tolong bantu,9,9
Dari apk ini kita tau bahwa pemerintah gagal Mengurangi pengangguran Dilihat dari persyaratan yg tinggi Lowongan hanya untuk kalangan orang mampu sekolah tinggi Bukan untuk menengah ke bawah.,negatif,2024-01-30,2024,dari apk ini kita tau bahwa pemerintah gagal mengurangi pengangguran dilihat dari persyaratan yg tinggi lowongan hanya untuk kalangan orang mampu sekolah tinggi bukan untuk menengah ke bawah,28,28,dari aplikasi ini kita tahu bahwa pemerintah gagal mengurangi pengangguran dilihat dari persyaratan yang tinggi lowongan hanya untuk kalangan orang mampu sekolah tinggi bukan untuk menengah ke bawah,28,28,"['dari', 'aplikasi', 'ini', 'kita', 'tahu', 'bahwa', 'pemerintah', 'gagal', 'mengurangi', 'pengangguran', 'dilihat', 'dari', 'persyaratan', 'yang', 'tinggi', 'lowongan', 'hanya', 'untuk', 'kalangan', 'orang', 'mampu', 'sekolah', 'tinggi', 'bukan', 'untuk', 'menengah', 'ke', 'bawah']","['aplikasi', 'pemerintah', 'gagal', 'mengurangi', 'pengangguran', 'persyaratan', 'lowongan', 'kalangan', 'orang', 'sekolah', 'menengah']",28,11,17,aplikasi perintah gagal kurang anggur syarat lowong kalang orang sekolah tengah,11,11
Nunggu otp sampe setengah mati gak muncul²,negatif,2023-09-07,2023,nunggu otp sampe setengah mati gak muncul²,7,7,tunggu one time password sampai setengah mati tidak muncul²,7,9,"['tunggu', 'one', 'time', 'password', 'sampai', 'setengah', 'mati', 'tidak', 'muncul²']","['tunggu', 'one', 'time', 'password', 'mati', 'tidak', 'muncul²']",9,7,2,tunggu one time password mati tidak muncul,7,7
"Please, saya melamar kok yg kirim panggilan kerja sampai 4 orang. Dan itupun panggilan bukan di gedung perusahaan, melainkan ruko. Ada apa gerangan ? Mohon di evaluasi jika ada rekruitmen nakal",negatif,2022-08-25,2022,please saya melamar kok yg kirim panggilan kerja sampai orang dan itupun panggilan bukan di gedung perusahaan melainkan ruko ada apa gerangan mohon di evaluasi jika ada rekruitmen nakal,31,29,please saya melamar kok yang kirim panggilan kerja sampai orang dan itupun panggilan bukan di gedung perusahaan melainkan ruko ada apa gerangan mohon di evaluasi jika ada rekruitmen nakal,29,29,"['please', 'saya', 'melamar', 'kok', 'yang', 'kirim', 'panggilan', 'kerja', 'sampai', 'orang', 'dan', 'itupun', 'panggilan', 'bukan', 'di', 'gedung', 'perusahaan', 'melainkan', 'ruko', 'ada', 'apa', 'gerangan', 'mohon', 'di', 'evaluasi', 'jika', 'ada', 'rekruitmen', 'nakal']","['please', 'melamar', 'kirim', 'panggilan', 'kerja', 'orang', 'itupun', 'panggilan', 'gedung', 'perusahaan', 'ruko', 'gerangan', 'mohon', 'evaluasi', 'rekruitmen', 'nakal']",29,16,13,please lamar kirim panggil kerja orang itu panggil gedung usaha ruko gerangan mohon evaluasi rekruitmen nakal,16,16
"Sangat Membantu sekali,untuk terhubung dengan teman teman yang berkarier di bergai perusahaan.",positif,2020-07-08,2020,sangat membantu sekali untuk terhubung dengan teman teman yang berkarier di bergai perusahaan,12,13,sangat membantu sekali untuk terhubung dengan teman teman yang berkarier di bergai perusahaan,13,13,"['sangat', 'membantu', 'sekali', 'untuk', 'terhubung', 'dengan', 'teman', 'teman', 'yang', 'berkarier', 'di', 'bergai', 'perusahaan']","['membantu', 'terhubung', 'teman', 'teman', 'berkarier', 'bergai', 'perusahaan']",13,7,6,bantu hubung teman teman karier gai usaha,7,7
"Sangat membantu saya di dalam karier saya, membangun networking",positif,2020-07-28,2020,sangat membantu saya di dalam karier saya membangun networking,9,9,sangat membantu saya di dalam karier saya membangun networking,9,9,"['sangat', 'membantu', 'saya', 'di', 'dalam', 'karier', 'saya', 'membangun', 'networking']","['membantu', 'karier', 'membangun', 'networking']",9,4,5,bantu karier bangun networking,4,4
"Lupa password, tapi di persulit untuk masuk kembali. Hapus aja ... Ga guna lagi",negatif,2023-03-16,2023,lupa password tapi di persulit untuk masuk kembali hapus aja ga guna lagi,14,13,lupa password tapi di persulit untuk masuk kembali hapus saja tidak guna lagi,13,13,"['lupa', 'password', 'tapi', 'di', 'persulit', 'untuk', 'masuk', 'kembali', 'hapus', 'saja', 'tidak', 'guna', 'lagi']","['lupa', 'password', 'persulit', 'masuk', 'hapus', 'tidak']",13,6,7,lupa password sulit masuk hapus tidak,6,6
Saya ga visa memsaukan nomor tlpn saat mendaftar,negatif,2023-01-10,2023,saya ga visa memsaukan nomor tlpn saat mendaftar,8,8,saya tidak visa memsaukan nomor telpon saat mendaftar,8,8,"['saya', 'tidak', 'visa', 'memsaukan', 'nomor', 'telpon', 'saat', 'mendaftar']","['tidak', 'visa', 'memsaukan', 'nomor', 'telpon', 'mendaftar']",8,6,2,tidak visa memsaukan nomor telpon daftar,6,6
Saya kasih bintang 2 karna saya blom mencoba nya nnt kalau sdh bagus tak kasih bintang full,negatif,2020-12-28,2020,saya kasih bintang karna saya blom mencoba nya nnt kalau sdh bagus tak kasih bintang full,17,16,saya kasih bintang karena saya belum mencoba nya nanti kalau sudah bagus tidak kasih bintang full,16,16,"['saya', 'kasih', 'bintang', 'karena', 'saya', 'belum', 'mencoba', 'nya', 'nanti', 'kalau', 'sudah', 'bagus', 'tidak', 'kasih', 'bintang', 'full']","['kasih', 'bintang', 'mencoba', 'nya', 'bagus', 'tidak', 'kasih', 'bintang', 'full']",16,9,7,kasih bintang coba nya bagus tidak kasih bintang full,9,9
"Mw login aja ribet verification nya, uninstall lagi",negatif,2023-03-24,2023,mw login aja ribet verification nya uninstall lagi,8,8,mau login saja rumit verification nya uninstall lagi,8,8,"['mau', 'login', 'saja', 'rumit', 'verification', 'nya', 'uninstall', 'lagi']","['login', 'rumit', 'verification', 'nya', 'uninstall']",8,5,3,login rumit verification nya uninstall,5,5
Ingi belajar terus diusia lanjut terima kasih atas semua ilmu yg saya dapat dari sini...Trims,positif,2022-02-26,2022,ingi belajar terus diusia lanjut terima kasih atas semua ilmu yg saya dapat dari sini trims,15,16,ingi belajar terus diusia lanjut terima kasih atas semua ilmu yang saya dapat dari sini terima kasih,16,17,"['ingi', 'belajar', 'terus', 'diusia', 'lanjut', 'terima', 'kasih', 'atas', 'semua', 'ilmu', 'yang', 'saya', 'dapat', 'dari', 'sini', 'terima', 'kasih']","['ingi', 'belajar', 'diusia', 'terima', 'kasih', 'ilmu', 'terima', 'kasih']",17,8,9,ingi ajar usia terima kasih ilmu terima kasih,8,8
dari aplikasi ini saya mendapat alamat teman saya yg sudahlaama tak bersua alhmdulillah. allah hu. Akbar. syukron masha allah...,positif,2020-06-16,2020,dari aplikasi ini saya mendapat alamat teman saya yg sudahlaama tak bersua alhmdulillah allah hu akbar syukron masha allah,19,19,dari aplikasi ini saya mendapat alamat teman saya yang sudahlaama tidak bersua alhamdulillah allah hu akbar syukron masha allah,19,19,"['dari', 'aplikasi', 'ini', 'saya', 'mendapat', 'alamat', 'teman', 'saya', 'yang', 'sudahlaama', 'tidak', 'bersua', 'alhamdulillah', 'allah', 'hu', 'akbar', 'syukron', 'masha', 'allah']","['aplikasi', 'alamat', 'teman', 'sudahlaama', 'tidak', 'bersua', 'alhamdulillah', 'allah', 'hu', 'akbar', 'syukron', 'masha', 'allah']",19,13,6,aplikasi alamat teman sudahlaama tidak sua alhamdulillah allah hu akbar syukron masha allah,13,13
Pelayanan nya sangat memuaskan dan saya sangat suka.,positif,2021-10-08,2021,pelayanan nya sangat memuaskan dan saya sangat suka,8,8,pelayanan nya sangat memuaskan dan saya sangat suka,8,8,"['pelayanan', 'nya', 'sangat', 'memuaskan', 'dan', 'saya', 'sangat', 'suka']","['pelayanan', 'nya', 'memuaskan', 'suka']",8,4,4,layan nya muas suka,4,4
Banyak panggilan tidak sehat mengatas namakan perusahaan dari apliasi ini,negatif,2021-11-13,2021,banyak panggilan tidak sehat mengatas namakan perusahaan dari apliasi ini,10,10,banyak panggilan tidak sehat mengatas namakan perusahaan dari apliasi ini,10,10,"['banyak', 'panggilan', 'tidak', 'sehat', 'mengatas', 'namakan', 'perusahaan', 'dari', 'apliasi', 'ini']","['panggilan', 'tidak', 'sehat', 'mengatas', 'namakan', 'perusahaan', 'apliasi']",10,7,3,panggil tidak sehat atas nama usaha apliasi,7,7
Terima kasih banyak membantu saya dalam berinteraksi dengan publik,positif,2024-01-12,2024,terima kasih banyak membantu saya dalam berinteraksi dengan publik,9,9,terima kasih banyak membantu saya dalam berinteraksi dengan publik,9,9,"['terima', 'kasih', 'banyak', 'membantu', 'saya', 'dalam', 'berinteraksi', 'dengan', 'publik']","['terima', 'kasih', 'membantu', 'berinteraksi', 'publik']",9,5,4,terima kasih bantu interaksi publik,5,5
"Apk ga bermutu, nebak gambar ga jelas wkwk payah",negatif,2021-12-13,2021,apk ga bermutu nebak gambar ga jelas wkwk payah,9,9,aplikasi tidak bermutu nebak gambar tidak jelas wkwk payah,9,9,"['aplikasi', 'tidak', 'bermutu', 'nebak', 'gambar', 'tidak', 'jelas', 'wkwk', 'payah']","['aplikasi', 'tidak', 'bermutu', 'nebak', 'gambar', 'tidak', 'wkwk', 'payah']",9,8,1,aplikasi tidak mutu nebak gambar tidak wkwk payah,8,8
Yakin apk bagus jadi langsung saya kasih bintang 5 dah,positif,2022-09-22,2022,yakin apk bagus jadi langsung saya kasih bintang dah,10,9,yakin aplikasi bagus jadi langsung saya kasih bintang sudah,9,9,"['yakin', 'aplikasi', 'bagus', 'jadi', 'langsung', 'saya', 'kasih', 'bintang', 'sudah']","['aplikasi', 'bagus', 'langsung', 'kasih', 'bintang']",9,5,4,aplikasi bagus langsung kasih bintang,5,5
"Saya mendapat pekerjaan sebagai Software Engineer dari sini untuk Full Remote WFH, mantap🎉",positif,2022-08-01,2022,saya mendapat pekerjaan sebagai software engineer dari sini untuk full remote wfh mantap,13,13,saya mendapat pekerjaan sebagai software engineer dari sini untuk full remote work from home mantap,13,15,"['saya', 'mendapat', 'pekerjaan', 'sebagai', 'software', 'engineer', 'dari', 'sini', 'untuk', 'full', 'remote', 'work', 'from', 'home', 'mantap']","['pekerjaan', 'software', 'engineer', 'full', 'remote', 'work', 'from', 'home', 'mantap']",15,9,6,kerja software engineer full remote work from home mantap,9,9
Membuat mudah perkenalan dgn siapapuj yg kita inginkan,positif,2020-09-14,2020,membuat mudah perkenalan dgn siapapuj yg kita inginkan,8,8,membuat mudah perkenalan dengan siapapuj yang kita inginkan,8,8,"['membuat', 'mudah', 'perkenalan', 'dengan', 'siapapuj', 'yang', 'kita', 'inginkan']","['mudah', 'perkenalan', 'siapapuj']",8,3,5,mudah kenal siapapuj,3,3
Bermanfaat untuk meningkatkan portofolio profesional kita,positif,2023-10-29,2023,bermanfaat untuk meningkatkan portofolio profesional kita,6,6,bermanfaat untuk meningkatkan portofolio profesional kita,6,6,"['bermanfaat', 'untuk', 'meningkatkan', 'portofolio', 'profesional', 'kita']","['bermanfaat', 'meningkatkan', 'portofolio', 'profesional']",6,4,2,manfaat tingkat portofolio profesional,4,4
Semoga jobseeker semua mendapat kesempatan untuk menunjukkan skill diperusahaan yang di inginkan,positif,2022-11-01,2022,semoga jobseeker semua mendapat kesempatan untuk menunjukkan skill diperusahaan yang di inginkan,12,12,semoga jobseeker semua mendapat kesempatan untuk menunjukkan skill diperusahaan yang di inginkan,12,12,"['semoga', 'jobseeker', 'semua', 'mendapat', 'kesempatan', 'untuk', 'menunjukkan', 'skill', 'diperusahaan', 'yang', 'di', 'inginkan']","['semoga', 'jobseeker', 'kesempatan', 'skill', 'diperusahaan']",12,5,7,moga jobseeker sempat skill usaha,5,5
"tiap mau kirim lamaran diarahin melamar via jooble, dapet panggilan interview tapi penipuan semua. hedeuh -,-",negatif,2021-07-08,2021,tiap mau kirim lamaran diarahin melamar via jooble dapet panggilan interview tapi penipuan semua hedeuh,16,15,tiap mau kirim lamaran diarahin melamar melalui jooble dapat panggilan interview tapi penipuan semua hedeuh,15,15,"['tiap', 'mau', 'kirim', 'lamaran', 'diarahin', 'melamar', 'melalui', 'jooble', 'dapat', 'panggilan', 'interview', 'tapi', 'penipuan', 'semua', 'hedeuh']","['kirim', 'lamaran', 'diarahin', 'melamar', 'jooble', 'panggilan', 'interview', 'penipuan', 'hedeuh']",15,9,6,kirim lamar diarahin lamar jooble panggil interview tipu hedeuh,9,9
"Udah selesai verifikasi padahal udah terbukti manusia, tapi ngulang terus",negatif,2023-11-25,2023,udah selesai verifikasi padahal udah terbukti manusia tapi ngulang terus,10,10,sudah selesai verifikasi padahal sudah terbukti manusia tapi mengulang terus,10,10,"['sudah', 'selesai', 'verifikasi', 'padahal', 'sudah', 'terbukti', 'manusia', 'tapi', 'mengulang', 'terus']","['selesai', 'verifikasi', 'terbukti', 'manusia', 'mengulang']",10,5,5,selesai verifikasi bukti manusia ulang,5,5
"Lambat loadingnya, sehingga lama masuk pada lama",negatif,2020-10-25,2020,lambat loadingnya sehingga lama masuk pada lama,7,7,lambat loading nya sehingga lama masuk pada lama,7,8,"['lambat', 'loading', 'nya', 'sehingga', 'lama', 'masuk', 'pada', 'lama']","['lambat', 'loading', 'nya', 'masuk']",8,4,4,lambat loading nya masuk,4,4
"Terlalu ribet, daritadi verifikasi data terus",negatif,2023-12-03,2023,terlalu ribet daritadi verifikasi data terus,6,6,terlalu rumit daritadi verifikasi data terus,6,6,"['terlalu', 'rumit', 'daritadi', 'verifikasi', 'data', 'terus']","['rumit', 'daritadi', 'verifikasi', 'data']",6,4,2,rumit daritadi verifikasi data,4,4
"Perbaiki fitur verifikasi pakai ktp di persona, masa indonesia ga support",negatif,2024-02-22,2024,perbaiki fitur verifikasi pakai ktp di persona masa indonesia ga support,11,11,perbaikan fitur verifikasi pakai ktp di persona masa indonesia tidak support,11,11,"['perbaikan', 'fitur', 'verifikasi', 'pakai', 'ktp', 'di', 'persona', 'masa', 'indonesia', 'tidak', 'support']","['perbaikan', 'fitur', 'verifikasi', 'pakai', 'ktp', 'persona', 'indonesia', 'tidak', 'support']",11,9,2,baik fitur verifikasi pakai ktp persona indonesia tidak support,9,9
Untuk verifikasi via aplikasi tidak bisa dilakukan,negatif,2023-11-22,2023,untuk verifikasi via aplikasi tidak bisa dilakukan,7,7,untuk verifikasi melalui aplikasi tidak bisa dilakukan,7,7,"['untuk', 'verifikasi', 'melalui', 'aplikasi', 'tidak', 'bisa', 'dilakukan']","['verifikasi', 'aplikasi', 'tidak']",7,3,4,verifikasi aplikasi tidak,3,3
Verifikasi nya gimanaaa :( lagi butuh buat ngerjain tugas lagi pusing tambah pusing dah :',negatif,2023-04-18,2023,verifikasi nya gimanaaa lagi butuh buat ngerjain tugas lagi pusing tambah pusing dah,15,13,verifikasi nya gimanaaa lagi butuh buat ngerjain tugas lagi pusing tambah pusing sudah,13,13,"['verifikasi', 'nya', 'gimanaaa', 'lagi', 'butuh', 'buat', 'ngerjain', 'tugas', 'lagi', 'pusing', 'tambah', 'pusing', 'sudah']","['verifikasi', 'nya', 'gimanaaa', 'butuh', 'ngerjain', 'tugas', 'pusing', 'pusing']",13,8,5,verifikasi nya gimanaaa butuh ngerjain tugas pusing pusing,8,8
Wadah pencari kerja terbaik di alam semesta,positif,2022-02-21,2022,wadah pencari kerja terbaik di alam semesta,7,7,wadah pencari kerja terbaik di alam semesta,7,7,"['wadah', 'pencari', 'kerja', 'terbaik', 'di', 'alam', 'semesta']","['wadah', 'pencari', 'kerja', 'terbaik', 'alam', 'semesta']",7,6,1,wadah cari kerja baik alam semesta,6,6
Baik terimakasih atas informasinya sangat membantu saya dalam proses waktu juga lah yang menentukan nya kita sesama Amin Terimakasih,positif,2024-03-09,2024,baik terimakasih atas informasinya sangat membantu saya dalam proses waktu juga lah yang menentukan nya kita sesama amin terimakasih,19,19,baik terima kasih atas informasinya sangat membantu saya dalam proses waktu juga lah yang menentukan nya kita sesama aamiin terima kasih,19,21,"['baik', 'terima', 'kasih', 'atas', 'informasinya', 'sangat', 'membantu', 'saya', 'dalam', 'proses', 'waktu', 'juga', 'lah', 'yang', 'menentukan', 'nya', 'kita', 'sesama', 'aamiin', 'terima', 'kasih']","['terima', 'kasih', 'informasinya', 'membantu', 'proses', 'menentukan', 'nya', 'aamiin', 'terima', 'kasih']",21,10,11,terima kasih informasi bantu proses tentu nya aamiin terima kasih,10,10
:( di install ga guna Ga di install tapi perlu Dipake tapi harus punya cc Apk apaaaaaa ini?,negatif,2020-04-09,2020,di install ga guna ga di install tapi perlu dipake tapi harus punya cc apk apaaaaaa ini,18,17,di install tidak guna tidak di install tapi perlu di pakai tapi harus punya cc aplikasi apaaaaaa ini,17,18,"['di', 'install', 'tidak', 'guna', 'tidak', 'di', 'install', 'tapi', 'perlu', 'di', 'pakai', 'tapi', 'harus', 'punya', 'cc', 'aplikasi', 'apaaaaaa', 'ini']","['install', 'tidak', 'tidak', 'install', 'pakai', 'cc', 'aplikasi', 'apaaaaaa']",18,8,10,install tidak tidak install pakai cc aplikasi apaaaaaa,8,8
Linkedin banyak memberikan ilmu dan lowongan,positif,2020-06-11,2020,linkedin banyak memberikan ilmu dan lowongan,6,6,linkedin banyak memberikan ilmu dan lowongan,6,6,"['linkedin', 'banyak', 'memberikan', 'ilmu', 'dan', 'lowongan']","['linkedin', 'ilmu', 'lowongan']",6,3,3,linkedin ilmu lowong,3,3
Apk anjingg udah bener bener segala rupa gapernah bisa masuk terus di ulang ulang.. Setan banget yaaa.. Bangkrut loo anjir ga guna jiji bikin males,negatif,2023-12-06,2023,apk anjingg udah bener bener segala rupa gapernah bisa masuk terus di ulang ulang setan banget yaaa bangkrut loo anjir ga guna jiji bikin males,25,25,aplikasi anjingg sudah benar benar segala rupa tidak pernah bisa masuk terus di ulang ulang setan banget yaaa bangkrut loo anjir tidak guna jiji bikin malas,25,26,"['aplikasi', 'anjingg', 'sudah', 'benar', 'benar', 'segala', 'rupa', 'tidak', 'pernah', 'bisa', 'masuk', 'terus', 'di', 'ulang', 'ulang', 'setan', 'banget', 'yaaa', 'bangkrut', 'loo', 'anjir', 'tidak', 'guna', 'jiji', 'bikin', 'malas']","['aplikasi', 'anjingg', 'rupa', 'tidak', 'masuk', 'ulang', 'ulang', 'setan', 'banget', 'yaaa', 'bangkrut', 'loo', 'anjir', 'tidak', 'jiji', 'bikin', 'malas']",26,17,9,aplikasi anjingg rupa tidak masuk ulang ulang setan banget yaaa bangkrut loo anjir tidak jiji bikin malas,17,17
Sangat membantu info job pekerjaan terimakasih linkedln,positif,2022-01-19,2022,sangat membantu info job pekerjaan terimakasih linkedln,7,7,sangat membantu informasi kerja pekerjaan terima kasih linkedln,7,8,"['sangat', 'membantu', 'informasi', 'kerja', 'pekerjaan', 'terima', 'kasih', 'linkedln']","['membantu', 'informasi', 'kerja', 'pekerjaan', 'terima', 'kasih', 'linkedln']",8,7,1,bantu informasi kerja kerja terima kasih linkedln,7,7
"Gak jelas, udah dimasukin dengan bener verifikasinya ngulang mulu sampe ada tulisan anda malampauin batas",negatif,2021-04-14,2021,gak jelas udah dimasukin dengan bener verifikasinya ngulang mulu sampe ada tulisan anda malampauin batas,15,15,tidak jelas sudah di masuk in dengan benar verifikasinya mengulang mulu sampai ada tulisan anda malampauin batas,15,17,"['tidak', 'jelas', 'sudah', 'di', 'masuk', 'in', 'dengan', 'benar', 'verifikasinya', 'mengulang', 'mulu', 'sampai', 'ada', 'tulisan', 'anda', 'malampauin', 'batas']","['tidak', 'masuk', 'in', 'verifikasinya', 'mengulang', 'mulu', 'tulisan', 'malampauin', 'batas']",17,9,8,tidak masuk in verifikasi ulang mulu tulis malampauin batas,9,9
"Apaan sih, minta verifikasi, di verifikasi gk bisa2, sebel",negatif,2022-04-06,2022,apaan sih minta verifikasi di verifikasi gk bisa sebel,9,9,apa sih minta verifikasi di verifikasi tidak bisa sebel,9,9,"['apa', 'sih', 'minta', 'verifikasi', 'di', 'verifikasi', 'tidak', 'bisa', 'sebel']","['sih', 'verifikasi', 'verifikasi', 'tidak', 'sebel']",9,5,4,sih verifikasi verifikasi tidak sebel,5,5
"Kog saya pas masukin no hp gak bisa mulu,sya sdh pakai 2 nomor tetap gk bisa,udh sya coba trus mlh no hp sya jdi gk bisa smua🖓",negatif,2020-01-14,2020,kog saya pas masukin no hp gak bisa mulu sya sdh pakai nomor tetap gk bisa udh sya coba trus mlh no hp sya jdi gk bisa smua,27,28,kok saya pas masukkan nomor handphone tidak bisa mulu saya sudah pakai nomor tetap tidak bisa sudah saya coba terus malah nomor handphone saya jadi tidak bisa semua,28,28,"['kok', 'saya', 'pas', 'masukkan', 'nomor', 'handphone', 'tidak', 'bisa', 'mulu', 'saya', 'sudah', 'pakai', 'nomor', 'tetap', 'tidak', 'bisa', 'sudah', 'saya', 'coba', 'terus', 'malah', 'nomor', 'handphone', 'saya', 'jadi', 'tidak', 'bisa', 'semua']","['pas', 'masukkan', 'nomor', 'handphone', 'tidak', 'mulu', 'pakai', 'nomor', 'tidak', 'coba', 'nomor', 'handphone', 'tidak']",28,13,15,pas masuk nomor handphone tidak mulu pakai nomor tidak coba nomor handphone tidak,13,13
LinkedIn buat verifikasi aja ribet nauzubillah... Ini mah ga bermutu banget yang pinter dikit napa😏,negatif,2022-05-30,2022,linkedin buat verifikasi aja ribet nauzubillah ini mah ga bermutu banget yang pinter dikit napa,15,15,linkedin buat verifikasi saja rumit nauzubillah ini mah tidak bermutu banget yang pinter dikit napa,15,15,"['linkedin', 'buat', 'verifikasi', 'saja', 'rumit', 'nauzubillah', 'ini', 'mah', 'tidak', 'bermutu', 'banget', 'yang', 'pinter', 'dikit', 'napa']","['linkedin', 'verifikasi', 'rumit', 'nauzubillah', 'mah', 'tidak', 'bermutu', 'banget', 'pinter', 'dikit', 'napa']",15,11,4,linkedin verifikasi rumit nauzubillah mah tidak mutu banget pinter dikit napa,11,11
Berbagai macam informasi ..semoga lebih bermanfaat yg banyak,positif,2020-06-13,2020,berbagai macam informasi semoga lebih bermanfaat yg banyak,8,8,berbagai macam informasi semoga lebih bermanfaat yang banyak,8,8,"['berbagai', 'macam', 'informasi', 'semoga', 'lebih', 'bermanfaat', 'yang', 'banyak']","['informasi', 'semoga', 'bermanfaat']",8,3,5,informasi moga manfaat,3,3
Tolong baca komen jangan bodo amat dosa mempersulit orang segera tanganin kami kesulitan login,negatif,2024-02-17,2024,tolong baca komen jangan bodo amat dosa mempersulit orang segera tanganin kami kesulitan login,14,14,tolong baca komen jangan bodo amat dosa mempersulit orang segera tanganin kami kesulitan login,14,14,"['tolong', 'baca', 'komen', 'jangan', 'bodo', 'amat', 'dosa', 'mempersulit', 'orang', 'segera', 'tanganin', 'kami', 'kesulitan', 'login']","['tolong', 'baca', 'komen', 'bodo', 'dosa', 'mempersulit', 'orang', 'tanganin', 'kesulitan', 'login']",14,10,4,tolong baca komen bodo dosa sulit orang tanganin sulit login,10,10
"Banyak ragam.dan manfaat yang didapat di Apl Linkedin ini. Ilmu dan pengalaman orang orang yang expert di bidangnya bakal menambah kepercayaan kita untuk sukses dan maju ke depan. Jangan sia siakan waktumu u hal yang tidak jelas. Hanya dengan bergabung bersama Linkedin, yang bisa membuatmu tersenyum bahagia. Ayo...bergabung lah segera ke Linkedin!!.",positif,2021-08-19,2021,banyak ragam dan manfaat yang didapat di apl linkedin ini ilmu dan pengalaman orang orang yang expert di bidangnya bakal menambah kepercayaan kita untuk sukses dan maju ke depan jangan sia siakan waktumu u hal yang tidak jelas hanya dengan bergabung bersama linkedin yang bisa membuatmu tersenyum bahagia ayo bergabung lah segera ke linkedin,52,54,banyak ragam dan manfaat yang didapat di aplikasi linkedin ini ilmu dan pengalaman orang orang yang expert di bidangnya bakal menambah kepercayaan kita untuk sukses dan maju ke depan jangan sia siakan waktumu untuk hal yang tidak jelas hanya dengan bergabung bersama linkedin yang bisa membuatmu tersenyum bahagia ayo bergabung lah segera ke linkedin,54,54,"['banyak', 'ragam', 'dan', 'manfaat', 'yang', 'didapat', 'di', 'aplikasi', 'linkedin', 'ini', 'ilmu', 'dan', 'pengalaman', 'orang', 'orang', 'yang', 'expert', 'di', 'bidangnya', 'bakal', 'menambah', 'kepercayaan', 'kita', 'untuk', 'sukses', 'dan', 'maju', 'ke', 'depan', 'jangan', 'sia', 'siakan', 'waktumu', 'untuk', 'hal', 'yang', 'tidak', 'jelas', 'hanya', 'dengan', 'bergabung', 'bersama', 'linkedin', 'yang', 'bisa', 'membuatmu', 'tersenyum', 'bahagia', 'ayo', 'bergabung', 'lah', 'segera', 'ke', 'linkedin']","['ragam', 'manfaat', 'aplikasi', 'linkedin', 'ilmu', 'pengalaman', 'orang', 'orang', 'expert', 'bidangnya', 'menambah', 'kepercayaan', 'sukses', 'maju', 'sia', 'siakan', 'waktumu', 'tidak', 'bergabung', 'linkedin', 'membuatmu', 'tersenyum', 'bahagia', 'ayo', 'bergabung', 'linkedin']",54,26,28,ragam manfaat aplikasi linkedin ilmu alam orang orang expert bidang tambah percaya sukses maju sia sia waktu tidak gabung linkedin buat senyum bahagia ayo gabung linkedin,26,26
Susah banget mau login aja bangkee.. verifikasi apaan kaga bisa2.. tot,negatif,2023-06-07,2023,susah banget mau login aja bangkee verifikasi apaan kaga bisa tot,11,11,susah banget mau login saja bangkee verifikasi apa tidak bisa tot,11,11,"['susah', 'banget', 'mau', 'login', 'saja', 'bangkee', 'verifikasi', 'apa', 'tidak', 'bisa', 'tot']","['susah', 'banget', 'login', 'bangkee', 'verifikasi', 'tidak', 'tot']",11,7,4,susah banget login bangkee verifikasi tidak tot,7,7
"karna linkedIn saya bisa mengenal banyak orang orang baik, mulai dari yg freshgraduate hingga ceo perusahaan. dan semoga dari sini juga lah saya bisa mendapatkan pekerjaan. aamiin😇",positif,2020-07-02,2020,karna linkedin saya bisa mengenal banyak orang orang baik mulai dari yg freshgraduate hingga ceo perusahaan dan semoga dari sini juga lah saya bisa mendapatkan pekerjaan aamiin,27,27,karena linkedin saya bisa mengenal banyak orang orang baik mulai dari yang freshgraduate hingga ceo perusahaan dan semoga dari sini juga lah saya bisa mendapatkan pekerjaan aamiin,27,27,"['karena', 'linkedin', 'saya', 'bisa', 'mengenal', 'banyak', 'orang', 'orang', 'baik', 'mulai', 'dari', 'yang', 'freshgraduate', 'hingga', 'ceo', 'perusahaan', 'dan', 'semoga', 'dari', 'sini', 'juga', 'lah', 'saya', 'bisa', 'mendapatkan', 'pekerjaan', 'aamiin']","['linkedin', 'mengenal', 'orang', 'orang', 'freshgraduate', 'ceo', 'perusahaan', 'semoga', 'pekerjaan', 'aamiin']",27,10,17,linkedin kenal orang orang freshgraduate ceo usaha moga kerja aamiin,10,10
Memudahkan dalam mencari peluang lapangan pekerjaan sesuai dengan pengalaman... good luck untuk LinkedIn,positif,2020-07-14,2020,memudahkan dalam mencari peluang lapangan pekerjaan sesuai dengan pengalaman good luck untuk linkedin,13,13,memudahkan dalam mencari peluang lapangan pekerjaan sesuai dengan pengalaman bagus luck untuk linkedin,13,13,"['memudahkan', 'dalam', 'mencari', 'peluang', 'lapangan', 'pekerjaan', 'sesuai', 'dengan', 'pengalaman', 'bagus', 'luck', 'untuk', 'linkedin']","['memudahkan', 'mencari', 'peluang', 'lapangan', 'pekerjaan', 'sesuai', 'pengalaman', 'bagus', 'luck', 'linkedin']",13,10,3,mudah cari peluang lapang kerja sesuai alam bagus luck linkedin,10,10
Apa lah masa ga bisa log in bulak balik tes terus,negatif,2023-09-11,2023,apa lah masa ga bisa log in bulak balik tes terus,11,11,apa lah masa tidak bisa log in bulak balik tes terus,11,11,"['apa', 'lah', 'masa', 'tidak', 'bisa', 'log', 'in', 'bulak', 'balik', 'tes', 'terus']","['tidak', 'log', 'in', 'bulak', 'tes']",11,5,6,tidak log in bulak tes,5,5
Susah banget buat masuk apk nya Gak suka,negatif,2022-06-16,2022,susah banget buat masuk apk nya gak suka,8,8,susah banget buat masuk aplikasi nya tidak suka,8,8,"['susah', 'banget', 'buat', 'masuk', 'aplikasi', 'nya', 'tidak', 'suka']","['susah', 'banget', 'masuk', 'aplikasi', 'nya', 'tidak', 'suka']",8,7,1,susah banget masuk aplikasi nya tidak suka,7,7
Aplikasi apa ini ndak bisa daftar akun dari tdi,negatif,2022-04-30,2022,aplikasi apa ini ndak bisa daftar akun dari tdi,9,9,aplikasi apa ini tidak bisa daftar akun dari tadi,9,9,"['aplikasi', 'apa', 'ini', 'tidak', 'bisa', 'daftar', 'akun', 'dari', 'tadi']","['aplikasi', 'tidak', 'daftar', 'akun']",9,4,5,aplikasi tidak daftar akun,4,4
Semenjak ganti baru saya tidak bisa login capta salah mulu... Kesel sendiri gw,negatif,2023-09-03,2023,semenjak ganti baru saya tidak bisa login capta salah mulu kesel sendiri gw,13,13,semenjak ganti baru saya tidak bisa login capta salah mulu kesel sendiri saya,13,13,"['semenjak', 'ganti', 'baru', 'saya', 'tidak', 'bisa', 'login', 'capta', 'salah', 'mulu', 'kesel', 'sendiri', 'saya']","['semenjak', 'ganti', 'tidak', 'login', 'capta', 'salah', 'mulu', 'kesel']",13,8,5,semenjak ganti tidak login capta salah mulu kesel,8,8
Apk apaan ini ..udah masukin kode verikasi lwt telpon masih aja g bisa,negatif,2022-08-23,2022,apk apaan ini udah masukin kode verikasi lwt telpon masih aja g bisa,13,13,aplikasi apa ini sudah masukkan kode verikasi lwt telpon masih saja tidak bisa,13,13,"['aplikasi', 'apa', 'ini', 'sudah', 'masukkan', 'kode', 'verikasi', 'lwt', 'telpon', 'masih', 'saja', 'tidak', 'bisa']","['aplikasi', 'masukkan', 'kode', 'verikasi', 'lwt', 'telpon', 'tidak']",13,7,6,aplikasi masuk kode verikasi lwt telpon tidak,7,7
"Saya dituduh menggunakan alat otomasi mengirimkan undangan, padahal saya tidak menggunakannya",negatif,2020-08-20,2020,saya dituduh menggunakan alat otomasi mengirimkan undangan padahal saya tidak menggunakannya,11,11,saya dituduh menggunakan alat otomasi mengirimkan undangan padahal saya tidak menggunakannya,11,11,"['saya', 'dituduh', 'menggunakan', 'alat', 'otomasi', 'mengirimkan', 'undangan', 'padahal', 'saya', 'tidak', 'menggunakannya']","['dituduh', 'alat', 'otomasi', 'mengirimkan', 'undangan', 'tidak', 'menggunakannya']",11,7,4,tuduh alat otomasi kirim undang tidak guna,7,7
Memberikan motivasi n membangkitkan semangat utk melakukan sesuatu ke DPN karna rezeki sulit diprediksi siapapun.,positif,2022-05-01,2022,memberikan motivasi n membangkitkan semangat utk melakukan sesuatu ke dpn karna rezeki sulit diprediksi siapapun,15,15,memberikan motivasi dan membangkitkan semangat untuk melakukan sesuatu ke depan karena rezeki sulit diprediksi siapapun,15,15,"['memberikan', 'motivasi', 'dan', 'membangkitkan', 'semangat', 'untuk', 'melakukan', 'sesuatu', 'ke', 'depan', 'karena', 'rezeki', 'sulit', 'diprediksi', 'siapapun']","['motivasi', 'membangkitkan', 'semangat', 'rezeki', 'sulit', 'diprediksi']",15,6,9,motivasi bangkit semangat rezeki sulit prediksi,6,6
aplikasi tolol suru verivikasi terus gaada yg beres gambarnya,negatif,2024-01-04,2024,aplikasi tolol suru verivikasi terus gaada yg beres gambarnya,9,9,aplikasi tolol suru verivikasi terus tidak ada yang beres gambarnya,9,10,"['aplikasi', 'tolol', 'suru', 'verivikasi', 'terus', 'tidak', 'ada', 'yang', 'beres', 'gambarnya']","['aplikasi', 'tolol', 'suru', 'verivikasi', 'tidak', 'beres', 'gambarnya']",10,7,3,aplikasi tolol suru verivikasi tidak beres gambar,7,7
"Sangat mudah, mudah""an saya dapat pekerjaan melalui bantuan ini",positif,2020-07-24,2020,sangat mudah mudah an saya dapat pekerjaan melalui bantuan ini,9,10,sangat mudah mudah an saya dapat pekerjaan melalui bantuan ini,10,10,"['sangat', 'mudah', 'mudah', 'an', 'saya', 'dapat', 'pekerjaan', 'melalui', 'bantuan', 'ini']","['mudah', 'mudah', 'an', 'pekerjaan', 'bantuan']",10,5,5,mudah mudah an kerja bantu,5,5
"Hybrid App. Cari Kerja, Online Portfolio, dan Buat Profil Kamu jadi makin Pro di Sini.",positif,2021-11-13,2021,hybrid app cari kerja online portfolio dan buat profil kamu jadi makin pro di sini,15,15,hybrid aplikasi cari kerja daring portfolio dan buat profil kamu jadi makin pro di sini,15,15,"['hybrid', 'aplikasi', 'cari', 'kerja', 'daring', 'portfolio', 'dan', 'buat', 'profil', 'kamu', 'jadi', 'makin', 'pro', 'di', 'sini']","['hybrid', 'aplikasi', 'cari', 'kerja', 'daring', 'portfolio', 'profil', 'pro']",15,8,7,hybrid aplikasi cari kerja daring portfolio profil pro,8,8
"Lebih stres aku nyelesaiin verifikasi keamanan daripada nyari kerja, kamfret-_-",negatif,2022-07-14,2022,lebih stres aku nyelesaiin verifikasi keamanan daripada nyari kerja kamfret,10,10,lebih stres aku nyelesaiin verifikasi keamanan daripada mencari kerja kamfret,10,10,"['lebih', 'stres', 'aku', 'nyelesaiin', 'verifikasi', 'keamanan', 'daripada', 'mencari', 'kerja', 'kamfret']","['stres', 'nyelesaiin', 'verifikasi', 'keamanan', 'mencari', 'kerja', 'kamfret']",10,7,3,stres nyelesaiin verifikasi aman cari kerja kamfret,7,7
"Bagus JD mudah mencari lowongan kerja,to",positif,2022-09-21,2022,bagus jd mudah mencari lowongan kerja to,6,7,bagus jadi mudah mencari lowongan kerja to,7,7,"['bagus', 'jadi', 'mudah', 'mencari', 'lowongan', 'kerja', 'to']","['bagus', 'mudah', 'mencari', 'lowongan', 'kerja', 'to']",7,6,1,bagus mudah cari lowong kerja to,6,6
"Apk ga jelas, verifikasi ulang² banyak kali ga selesai²",negatif,2023-07-27,2023,apk ga jelas verifikasi ulang² banyak kali ga selesai²,9,9,aplikasi tidak jelas verifikasi ulang² banyak kali tidak selesai²,9,9,"['aplikasi', 'tidak', 'jelas', 'verifikasi', 'ulang²', 'banyak', 'kali', 'tidak', 'selesai²']","['aplikasi', 'tidak', 'verifikasi', 'ulang²', 'kali', 'tidak', 'selesai²']",9,7,2,aplikasi tidak verifikasi ulang kali tidak selesai,7,7
Sangat membantu,positif,2024-05-30,2024,sangat membantu,2,2,sangat membantu,2,2,"['sangat', 'membantu']",['membantu'],2,1,1,bantu,1,1
"parah akun susah banget mau login, kek dicekal padahal udah benar truss jawab, udah susah dpet kerja, ini malah dipersulit, ya allah mau nyari makan aja dipersulit orang",negatif,2023-08-13,2023,parah akun susah banget mau login kek dicekal padahal udah benar truss jawab udah susah dpet kerja ini malah dipersulit ya allah mau nyari makan aja dipersulit orang,28,28,parah akun susah banget mau login seperti dicekal padahal sudah benar truss jawab sudah susah dapat kerja ini bahkan dipersulit ya allah mau mencari makan saja dipersulit orang,28,28,"['parah', 'akun', 'susah', 'banget', 'mau', 'login', 'seperti', 'dicekal', 'padahal', 'sudah', 'benar', 'truss', 'jawab', 'sudah', 'susah', 'dapat', 'kerja', 'ini', 'bahkan', 'dipersulit', 'ya', 'allah', 'mau', 'mencari', 'makan', 'saja', 'dipersulit', 'orang']","['parah', 'akun', 'susah', 'banget', 'login', 'dicekal', 'truss', 'susah', 'kerja', 'dipersulit', 'ya', 'allah', 'mencari', 'makan', 'dipersulit', 'orang']",28,16,12,parah akun susah banget login cekal truss susah kerja sulit ya allah cari makan sulit orang,16,16
koneksi massih kurang setabil,negatif,2024-04-26,2024,koneksi massih kurang setabil,4,4,koneksi massih kurang setabil,4,4,"['koneksi', 'massih', 'kurang', 'setabil']","['koneksi', 'massih', 'setabil']",4,3,1,koneksi massih setabil,3,3
"sejauh ini aplikasi LinkedIn oke, terutama buat personal branding",positif,2022-05-26,2022,sejauh ini aplikasi linkedin oke terutama buat personal branding,9,9,sejauh ini aplikasi linkedin oke terutama buat personal branding,9,9,"['sejauh', 'ini', 'aplikasi', 'linkedin', 'oke', 'terutama', 'buat', 'personal', 'branding']","['aplikasi', 'linkedin', 'oke', 'personal', 'branding']",9,5,4,aplikasi linkedin oke personal branding,5,5
Sangat bermanfaat untuk dunia karir,positif,2024-03-06,2024,sangat bermanfaat untuk dunia karir,5,5,sangat bermanfaat untuk dunia karir,5,5,"['sangat', 'bermanfaat', 'untuk', 'dunia', 'karir']","['bermanfaat', 'dunia', 'karir']",5,3,2,manfaat dunia karir,3,3
"Untuk menyebarluaskan ide ide ber Hak Paten , dan mbuat alat optik pembaca keping cakram VCD , CD , DVD , BRD dari lensa belakang camera smartphone",positif,2021-05-31,2021,untuk menyebarluaskan ide ide ber hak paten dan mbuat alat optik pembaca keping cakram vcd cd dvd brd dari lensa belakang camera smartphone,27,23,untuk menyebarluaskan ide ide ber hak paten dan mbuat alat optik pembaca keping cakram vcd cd dvd brd dari lensa belakang camera smartphone,23,23,"['untuk', 'menyebarluaskan', 'ide', 'ide', 'ber', 'hak', 'paten', 'dan', 'mbuat', 'alat', 'optik', 'pembaca', 'keping', 'cakram', 'vcd', 'cd', 'dvd', 'brd', 'dari', 'lensa', 'belakang', 'camera', 'smartphone']","['menyebarluaskan', 'ide', 'ide', 'ber', 'hak', 'paten', 'mbuat', 'alat', 'optik', 'pembaca', 'keping', 'cakram', 'vcd', 'cd', 'dvd', 'brd', 'lensa', 'camera', 'smartphone']",23,19,4,menyebarluaskan ide ide ber hak paten mbuat alat optik baca keping cakram vcd cd dvd brd lensa camera smartphone,19,19
Membangun karier lebih baik dan sesui keahlian,positif,2020-08-23,2020,membangun karier lebih baik dan sesui keahlian,7,7,membangun karier lebih baik dan sesui keahlian,7,7,"['membangun', 'karier', 'lebih', 'baik', 'dan', 'sesui', 'keahlian']","['membangun', 'karier', 'sesui', 'keahlian']",7,4,3,bangun karier sesui ahli,4,4
Sejauh ini mantap,positif,2024-04-25,2024,sejauh ini mantap,3,3,sejauh ini mantap,3,3,"['sejauh', 'ini', 'mantap']",['mantap'],3,1,2,mantap,1,1
"Ga jelas nih aplikasi sampah, mau login aja di persulit",negatif,2023-08-09,2023,ga jelas nih aplikasi sampah mau login aja di persulit,10,10,tidak jelas nih aplikasi sampah mau login saja di persulit,10,10,"['tidak', 'jelas', 'nih', 'aplikasi', 'sampah', 'mau', 'login', 'saja', 'di', 'persulit']","['tidak', 'nih', 'aplikasi', 'sampah', 'login', 'persulit']",10,6,4,tidak nih aplikasi sampah login sulit,6,6
"Verif nya susah amat sih, udh mumet cari kerja makin mumet sama verif nya. Gajelas jga clue nya. Yg bener aja dong masa bgtu_- Dipersulit banget!",negatif,2021-09-14,2021,verif nya susah amat sih udh mumet cari kerja makin mumet sama verif nya gajelas jga clue nya yg bener aja dong masa bgtu dipersulit banget,26,26,verif nya susah amat sih sudah mumet cari kerja makin mumet sama verif nya tidak jelas juga clue nya yang benar saja dong masa begitu dipersulit banget,26,27,"['verif', 'nya', 'susah', 'amat', 'sih', 'sudah', 'mumet', 'cari', 'kerja', 'makin', 'mumet', 'sama', 'verif', 'nya', 'tidak', 'jelas', 'juga', 'clue', 'nya', 'yang', 'benar', 'saja', 'dong', 'masa', 'begitu', 'dipersulit', 'banget']","['verif', 'nya', 'susah', 'sih', 'mumet', 'cari', 'kerja', 'mumet', 'verif', 'nya', 'tidak', 'clue', 'nya', 'dipersulit', 'banget']",27,15,12,verif nya susah sih mumet cari kerja mumet verif nya tidak clue nya sulit banget,15,15
"Akun saya sudah di batasi 5 hari, dan belum ada pemberitahuan apapun di email saya. Padahal saya sudah verifikasi? Mohon bantuannya",negatif,2023-08-01,2023,akun saya sudah di batasi hari dan belum ada pemberitahuan apapun di email saya padahal saya sudah verifikasi mohon bantuannya,21,20,akun saya sudah di batasi hari dan belum ada pemberitahuan apapun di email saya padahal saya sudah verifikasi mohon bantuannya,20,20,"['akun', 'saya', 'sudah', 'di', 'batasi', 'hari', 'dan', 'belum', 'ada', 'pemberitahuan', 'apapun', 'di', 'email', 'saya', 'padahal', 'saya', 'sudah', 'verifikasi', 'mohon', 'bantuannya']","['akun', 'batasi', 'pemberitahuan', 'apapun', 'email', 'verifikasi', 'mohon', 'bantuannya']",20,8,12,akun batas pemberitahuan apa email verifikasi mohon bantu,8,8
"Aplikasi bodong biaya mahal saldo didana gw raib,Kalian jgn download aplikasi dana kalian raib,kaya penipuan",negatif,2024-03-25,2024,aplikasi bodong biaya mahal saldo didana gw raib kalian jgn download aplikasi dana kalian raib kaya penipuan,15,17,aplikasi bodong biaya mahal saldo didana saya raib kalian jangan unduh aplikasi dana kalian raib kayak penipuan,17,17,"['aplikasi', 'bodong', 'biaya', 'mahal', 'saldo', 'didana', 'saya', 'raib', 'kalian', 'jangan', 'unduh', 'aplikasi', 'dana', 'kalian', 'raib', 'kayak', 'penipuan']","['aplikasi', 'bodong', 'biaya', 'mahal', 'saldo', 'didana', 'raib', 'unduh', 'aplikasi', 'dana', 'raib', 'kayak', 'penipuan']",17,13,4,aplikasi bodong biaya mahal saldo dana raib unduh aplikasi dana raib kayak tipu,13,13
Sangat membantu saya dalam menemukan pekerjaan yang sesuai dan saya bisa berinterkasi secara langsung dengan HR dari perusahaan perushaan ternama,positif,2023-07-17,2023,sangat membantu saya dalam menemukan pekerjaan yang sesuai dan saya bisa berinterkasi secara langsung dengan hr dari perusahaan perushaan ternama,20,20,sangat membantu saya dalam menemukan pekerjaan yang sesuai dan saya bisa berinterkasi secara langsung dengan hari dari perusahaan perushaan ternama,20,20,"['sangat', 'membantu', 'saya', 'dalam', 'menemukan', 'pekerjaan', 'yang', 'sesuai', 'dan', 'saya', 'bisa', 'berinterkasi', 'secara', 'langsung', 'dengan', 'hari', 'dari', 'perusahaan', 'perushaan', 'ternama']","['membantu', 'menemukan', 'pekerjaan', 'sesuai', 'berinterkasi', 'langsung', 'perusahaan', 'perushaan', 'ternama']",20,9,11,bantu temu kerja sesuai berinterkasi langsung usaha perushaan nama,9,9
biarlh saya yng ngasih nilai tnggi baru kali ini aku masuk ngk tau bagus apa tdak yng penting beri nilai tinggi,positif,2024-02-14,2024,biarlh saya yng ngasih nilai tnggi baru kali ini aku masuk ngk tau bagus apa tdak yng penting beri nilai tinggi,21,21,biarlh saya yng memberikan nilai tnggi baru kali ini aku masuk tidak tahu bagus apa tidak yng penting beri nilai tinggi,21,21,"['biarlh', 'saya', 'yng', 'memberikan', 'nilai', 'tnggi', 'baru', 'kali', 'ini', 'aku', 'masuk', 'tidak', 'tahu', 'bagus', 'apa', 'tidak', 'yng', 'penting', 'beri', 'nilai', 'tinggi']","['biarlh', 'yng', 'nilai', 'tnggi', 'kali', 'masuk', 'tidak', 'bagus', 'tidak', 'yng', 'nilai']",21,11,10,biarlh yng nilai tnggi kali masuk tidak bagus tidak yng nilai,11,11
"belum mencoba , cuma katnya bagus y udah deh sy kasih bintang dulu",positif,2020-12-06,2020,belum mencoba cuma katnya bagus y udah deh sy kasih bintang dulu,13,12,belum mencoba cuma katnya bagus ya sudah deh saya kasih bintang dahulu,12,12,"['belum', 'mencoba', 'cuma', 'katnya', 'bagus', 'ya', 'sudah', 'deh', 'saya', 'kasih', 'bintang', 'dahulu']","['mencoba', 'katnya', 'bagus', 'ya', 'deh', 'kasih', 'bintang']",12,7,5,coba katnya bagus ya deh kasih bintang,7,7
"aplikasi busuk, login aja sulit",negatif,2024-08-18,2024,aplikasi busuk login aja sulit,5,5,aplikasi busuk login saja sulit,5,5,"['aplikasi', 'busuk', 'login', 'saja', 'sulit']","['aplikasi', 'busuk', 'login', 'sulit']",5,4,1,aplikasi busuk login sulit,4,4
Gak bisa di buka.. Tolong di perbaiki..thanks,negatif,2021-08-08,2021,gak bisa di buka tolong di perbaiki thanks,7,8,tidak bisa di buka tolong di perbaikan terima kasih,8,9,"['tidak', 'bisa', 'di', 'buka', 'tolong', 'di', 'perbaikan', 'terima', 'kasih']","['tidak', 'buka', 'tolong', 'perbaikan', 'terima', 'kasih']",9,6,3,tidak buka tolong baik terima kasih,6,6
Apk bagus,positif,2020-12-16,2020,apk bagus,2,2,aplikasi bagus,2,2,"['aplikasi', 'bagus']","['aplikasi', 'bagus']",2,2,0,aplikasi bagus,2,2
sangat bermanfaat untuk cari tau lowongan kerja,positif,2021-06-22,2021,sangat bermanfaat untuk cari tau lowongan kerja,7,7,sangat bermanfaat untuk cari tahu lowongan kerja,7,7,"['sangat', 'bermanfaat', 'untuk', 'cari', 'tahu', 'lowongan', 'kerja']","['bermanfaat', 'cari', 'lowongan', 'kerja']",7,4,3,manfaat cari lowong kerja,4,4
"aplikasi sampah kaya gini didownload,bikin emosi ajah",negatif,2020-09-01,2020,aplikasi sampah kaya gini didownload bikin emosi ajah,7,8,aplikasi sampah kayak begini didownload bikin emosi ajah,8,8,"['aplikasi', 'sampah', 'kayak', 'begini', 'didownload', 'bikin', 'emosi', 'ajah']","['aplikasi', 'sampah', 'kayak', 'didownload', 'bikin', 'emosi', 'ajah']",8,7,1,aplikasi sampah kayak didownload bikin emosi ajah,7,7
Aplikasi gajelas bikin emosi doang !!,negatif,2021-12-20,2021,aplikasi gajelas bikin emosi doang,6,5,aplikasi tidak jelas bikin emosi saja,5,6,"['aplikasi', 'tidak', 'jelas', 'bikin', 'emosi', 'saja']","['aplikasi', 'tidak', 'bikin', 'emosi']",6,4,2,aplikasi tidak bikin emosi,4,4
saya sangat suka applikasi linke lin dan sangat membantu,positif,2020-04-07,2020,saya sangat suka applikasi linke lin dan sangat membantu,9,9,saya sangat suka aplikasi linke lin dan sangat membantu,9,9,"['saya', 'sangat', 'suka', 'aplikasi', 'linke', 'lin', 'dan', 'sangat', 'membantu']","['suka', 'aplikasi', 'linke', 'lin', 'membantu']",9,5,4,suka aplikasi linke lin bantu,5,5
Aplikasi tai. Mau login pake verifikasi. Itupun salah terus.,negatif,2022-11-07,2022,aplikasi tai mau login pake verifikasi itupun salah terus,9,9,aplikasi tai mau login pakai verifikasi itupun salah terus,9,9,"['aplikasi', 'tai', 'mau', 'login', 'pakai', 'verifikasi', 'itupun', 'salah', 'terus']","['aplikasi', 'tai', 'login', 'pakai', 'verifikasi', 'itupun', 'salah']",9,7,2,aplikasi tai login pakai verifikasi itu salah,7,7
"Masa di halaman saya isinya promosi yg g penting mulai dukun, pesugihan dll... mo cari pekerjaan malah jadi dukun nanti sy, wkwkwkw sry kasi bintang 1 dulu",negatif,2020-08-30,2020,masa di halaman saya isinya promosi yg g penting mulai dukun pesugihan dll mo cari pekerjaan malah jadi dukun nanti sy wkwkwkw sry kasi bintang dulu,27,26,masa di halaman saya isinya promosi yang tidak penting mulai dukun pesugihan dan lain lain mau cari pekerjaan bahkan jadi dukun nanti saya wkwkwkw sry kasih bintang dahulu,26,28,"['masa', 'di', 'halaman', 'saya', 'isinya', 'promosi', 'yang', 'tidak', 'penting', 'mulai', 'dukun', 'pesugihan', 'dan', 'lain', 'lain', 'mau', 'cari', 'pekerjaan', 'bahkan', 'jadi', 'dukun', 'nanti', 'saya', 'wkwkwkw', 'sry', 'kasih', 'bintang', 'dahulu']","['halaman', 'isinya', 'promosi', 'tidak', 'dukun', 'pesugihan', 'cari', 'pekerjaan', 'dukun', 'wkwkwkw', 'sry', 'kasih', 'bintang']",28,13,15,halaman isi promosi tidak dukun sugih cari kerja dukun wkwkwkw sry kasih bintang,13,13
Sangat mudah dan lengkap,positif,2020-06-25,2020,sangat mudah dan lengkap,4,4,sangat mudah dan lengkap,4,4,"['sangat', 'mudah', 'dan', 'lengkap']","['mudah', 'lengkap']",4,2,2,mudah lengkap,2,2
Luar biasa banget ini program searching Jobs ( most exited and valuable ). Jika butuh tenaga saya sbb: M BAMBANG ONGKOYUDO Drs. ( KTP) sebenarnya M BAMBANG OKY DrsSpdKonselor exp40Thn 18swasta & 22negeri mendapat penghargaan Gubernur DKI JAKARTA 15 THN & mendapat penghargaan 20 Thn dari Presiden NKRI Joko Widodo ( Jokowi ) saya siap brgabung dgn perusahaan yg butuh tenaga saya asal mencukupi salarynya,positif,2024-02-06,2024,luar biasa banget ini program searching jobs most exited and valuable jika butuh tenaga saya sbb m bambang ongkoyudo drs ktp sebenarnya m bambang oky drsspdkonselor exp thn swasta negeri mendapat penghargaan gubernur dki jakarta thn mendapat penghargaan thn dari presiden nkri joko widodo jokowi saya siap brgabung dgn perusahaan yg butuh tenaga saya asal mencukupi salarynya,65,57,luar biasa banget ini program mencari jobs most exited and valuable jika butuh tenaga saya sebagai berikut m bambang ongkoyudo drs ktp sebenarnya m bambang oky drsspdkonselor exp tahun swasta negeri mendapat penghargaan gubernur daerah khusus ibukota jakarta tahun mendapat penghargaan tahun dari presiden nkri joko widodo jokowi saya siap brgabung dengan perusahaan yang butuh tenaga saya asal mencukupi salarynya,57,60,"['luar', 'biasa', 'banget', 'ini', 'program', 'mencari', 'jobs', 'most', 'exited', 'and', 'valuable', 'jika', 'butuh', 'tenaga', 'saya', 'sebagai', 'berikut', 'm', 'bambang', 'ongkoyudo', 'drs', 'ktp', 'sebenarnya', 'm', 'bambang', 'oky', 'drsspdkonselor', 'exp', 'tahun', 'swasta', 'negeri', 'mendapat', 'penghargaan', 'gubernur', 'daerah', 'khusus', 'ibukota', 'jakarta', 'tahun', 'mendapat', 'penghargaan', 'tahun', 'dari', 'presiden', 'nkri', 'joko', 'widodo', 'jokowi', 'saya', 'siap', 'brgabung', 'dengan', 'perusahaan', 'yang', 'butuh', 'tenaga', 'saya', 'asal', 'mencukupi', 'salarynya']","['banget', 'program', 'mencari', 'jobs', 'most', 'exited', 'and', 'valuable', 'butuh', 'tenaga', 'm', 'bambang', 'ongkoyudo', 'drs', 'ktp', 'm', 'bambang', 'oky', 'drsspdkonselor', 'exp', 'swasta', 'negeri', 'penghargaan', 'gubernur', 'daerah', 'khusus', 'ibukota', 'jakarta', 'penghargaan', 'presiden', 'nkri', 'joko', 'widodo', 'jokowi', 'brgabung', 'perusahaan', 'butuh', 'tenaga', 'mencukupi', 'salarynya']",60,40,20,banget program cari jobs most exited and valuable butuh tenaga m bambang ongkoyudo drs ktp m bambang oky drsspdkonselor exp swasta negeri harga gubernur daerah khusus ibukota jakarta harga presiden nkri joko widodo jokowi brgabung usaha butuh tenaga cukup salarynya,40,40
Sungguh membantu dalam mencari pekerjaan,positif,2021-04-15,2021,sungguh membantu dalam mencari pekerjaan,5,5,sungguh membantu dalam mencari pekerjaan,5,5,"['sungguh', 'membantu', 'dalam', 'mencari', 'pekerjaan']","['sungguh', 'membantu', 'mencari', 'pekerjaan']",5,4,1,sungguh bantu cari kerja,4,4
Linkedln sangat membantu saya untuk dalam berusaha.tank you linkedln.,positif,2021-09-21,2021,linkedln sangat membantu saya untuk dalam berusaha tank you linkedln,9,10,linkedln sangat membantu saya untuk dalam berusaha tank you linkedln,10,10,"['linkedln', 'sangat', 'membantu', 'saya', 'untuk', 'dalam', 'berusaha', 'tank', 'you', 'linkedln']","['linkedln', 'membantu', 'berusaha', 'tank', 'you', 'linkedln']",10,6,4,linkedln bantu usaha tank you linkedln,6,6
"Tempat menggumpulkan informasi seputar dunia pekerjaan dan pendidikan, top markotop 👍👍👍👍",positif,2020-01-12,2020,tempat menggumpulkan informasi seputar dunia pekerjaan dan pendidikan top markotop,11,10,tempat menggumpulkan informasi seputar dunia pekerjaan dan pendidikan top sekali,10,10,"['tempat', 'menggumpulkan', 'informasi', 'seputar', 'dunia', 'pekerjaan', 'dan', 'pendidikan', 'top', 'sekali']","['menggumpulkan', 'informasi', 'seputar', 'dunia', 'pekerjaan', 'pendidikan', 'top']",10,7,3,menggumpulkan informasi putar dunia kerja didik top,7,7
Sumpah aku udh lebih dari 50 kali mau masuk aja susah banget hahaha fix uninstal,negatif,2021-09-18,2021,sumpah aku udh lebih dari kali mau masuk aja susah banget hahaha fix uninstal,15,14,sumpah aku sudah lebih dari kali mau masuk saja susah banget hahaha fix hapus instalan,14,15,"['sumpah', 'aku', 'sudah', 'lebih', 'dari', 'kali', 'mau', 'masuk', 'saja', 'susah', 'banget', 'hahaha', 'fix', 'hapus', 'instalan']","['sumpah', 'kali', 'masuk', 'susah', 'banget', 'hahaha', 'fix', 'hapus', 'instalan']",15,9,6,sumpah kali masuk susah banget hahaha fix hapus instalan,9,9
Wah aplikasi ini bagus kita jadi bisa menghubungi orang2 yang kita kenal,positif,2021-07-17,2021,wah aplikasi ini bagus kita jadi bisa menghubungi orang yang kita kenal,12,12,wah aplikasi ini bagus kita jadi bisa menghubungi orang yang kita kenal,12,12,"['wah', 'aplikasi', 'ini', 'bagus', 'kita', 'jadi', 'bisa', 'menghubungi', 'orang', 'yang', 'kita', 'kenal']","['aplikasi', 'bagus', 'menghubungi', 'orang', 'kenal']",12,5,7,aplikasi bagus hubung orang kenal,5,5
"Suruh nebak hewan udh bener tp kode captcha tidak valid, gak tau gmn mksudnya",negatif,2023-03-28,2023,suruh nebak hewan udh bener tp kode captcha tidak valid gak tau gmn mksudnya,14,14,suruh nebak hewan sudah benar tapi kode captcha tidak valid tidak tahu bagaimana mksudnya,14,14,"['suruh', 'nebak', 'hewan', 'sudah', 'benar', 'tapi', 'kode', 'captcha', 'tidak', 'valid', 'tidak', 'tahu', 'bagaimana', 'mksudnya']","['suruh', 'nebak', 'hewan', 'kode', 'captcha', 'tidak', 'valid', 'tidak', 'mksudnya']",14,9,5,suruh nebak hewan kode captcha tidak valid tidak mksudnya,9,9
Membantu berkomunikasi lbh baik,positif,2021-07-16,2021,membantu berkomunikasi lbh baik,4,4,membantu berkomunikasi lebih baik,4,4,"['membantu', 'berkomunikasi', 'lebih', 'baik']","['membantu', 'berkomunikasi']",4,2,2,bantu komunikasi,2,2
"Tidak bisa buat akun , apk ga berguna terimkasih",negatif,2021-09-26,2021,tidak bisa buat akun apk ga berguna terimkasih,9,8,tidak bisa buat akun aplikasi tidak berguna terimkasih,8,8,"['tidak', 'bisa', 'buat', 'akun', 'aplikasi', 'tidak', 'berguna', 'terimkasih']","['tidak', 'akun', 'aplikasi', 'tidak', 'berguna', 'terimkasih']",8,6,2,tidak akun aplikasi tidak guna terimkasih,6,6
Susah amat cocokin gambarnya 😂,negatif,2021-10-14,2021,susah amat cocokin gambarnya,5,4,susah amat cocokin gambarnya,4,4,"['susah', 'amat', 'cocokin', 'gambarnya']","['susah', 'cocokin', 'gambarnya']",4,3,1,susah cocokin gambar,3,3
Iklan lu ganggu,negatif,2024-06-24,2024,iklan lu ganggu,3,3,iklan lu ganggu,3,3,"['iklan', 'lu', 'ganggu']","['iklan', 'lu', 'ganggu']",3,3,0,iklan lu ganggu,3,3
"Bagus, ringan tapi berisi. Mantap",positif,2021-09-02,2021,bagus ringan tapi berisi mantap,5,5,bagus ringan tapi berisi mantap,5,5,"['bagus', 'ringan', 'tapi', 'berisi', 'mantap']","['bagus', 'ringan', 'berisi', 'mantap']",5,4,1,bagus ringan isi mantap,4,4
"Verifikasi security check aja susah bnr ajg pdhl udh bnr berkali2, dikira gw alien apa? ngecewain aja",negatif,2023-07-20,2023,verifikasi security check aja susah bnr ajg pdhl udh bnr berkali dikira gw alien apa ngecewain aja,17,17,verifikasi security cek saja susah benar ajg padahal sudah benar berkali dikira saya alien apa mengecewakan saja,17,17,"['verifikasi', 'security', 'cek', 'saja', 'susah', 'benar', 'ajg', 'padahal', 'sudah', 'benar', 'berkali', 'dikira', 'saya', 'alien', 'apa', 'mengecewakan', 'saja']","['verifikasi', 'security', 'cek', 'susah', 'ajg', 'berkali', 'alien', 'mengecewakan']",17,8,9,verifikasi security cek susah ajg kali alien kecewa,8,8
Puas dan banyak mendapatkan informasi,positif,2021-01-08,2021,puas dan banyak mendapatkan informasi,5,5,puas dan banyak mendapatkan informasi,5,5,"['puas', 'dan', 'banyak', 'mendapatkan', 'informasi']","['puas', 'informasi']",5,2,3,puas informasi,2,2
Social media yg bagus untuk mencari kerja,positif,2023-11-12,2023,social media yg bagus untuk mencari kerja,7,7,social media yang bagus untuk mencari kerja,7,7,"['social', 'media', 'yang', 'bagus', 'untuk', 'mencari', 'kerja']","['social', 'media', 'bagus', 'mencari', 'kerja']",7,5,2,social media bagus cari kerja,5,5
"Bintang 5, karna bisa hapus akun & caranya mudah 👍",positif,2023-06-16,2023,bintang karna bisa hapus akun caranya mudah,10,7,bintang karena bisa hapus akun caranya mudah,7,7,"['bintang', 'karena', 'bisa', 'hapus', 'akun', 'caranya', 'mudah']","['bintang', 'hapus', 'akun', 'mudah']",7,4,3,bintang hapus akun mudah,4,4
Aplikasi sangat benar 🙏🏼,positif,2024-06-29,2024,aplikasi sangat benar,4,3,aplikasi sangat benar,3,3,"['aplikasi', 'sangat', 'benar']",['aplikasi'],3,1,2,aplikasi,1,1
Sangat membantu memperluas relasi,positif,2020-05-21,2020,sangat membantu memperluas relasi,4,4,sangat membantu memperluas relasi,4,4,"['sangat', 'membantu', 'memperluas', 'relasi']","['membantu', 'memperluas', 'relasi']",4,3,1,bantu luas relasi,3,3
Bagus.. Klo lancar baru top deh..,positif,2020-06-23,2020,bagus klo lancar baru top deh,6,6,bagus kalau lancar baru top deh,6,6,"['bagus', 'kalau', 'lancar', 'baru', 'top', 'deh']","['bagus', 'lancar', 'top', 'deh']",6,4,2,bagus lancar top deh,4,4
"Verifikasinya susah, gambar hewannya posisinya abstract. Mending login pakai website saja daripada pakai APK",negatif,2023-10-12,2023,verifikasinya susah gambar hewannya posisinya abstract mending login pakai website saja daripada pakai apk,14,14,verifikasinya susah gambar hewannya posisinya abstract mending login pakai website saja daripada pakai aplikasi,14,14,"['verifikasinya', 'susah', 'gambar', 'hewannya', 'posisinya', 'abstract', 'mending', 'login', 'pakai', 'website', 'saja', 'daripada', 'pakai', 'aplikasi']","['verifikasinya', 'susah', 'gambar', 'hewannya', 'posisinya', 'abstract', 'mending', 'login', 'pakai', 'website', 'pakai', 'aplikasi']",14,12,2,verifikasi susah gambar hewan posisi abstract mending login pakai website pakai aplikasi,12,12
"verifikasi ga jelas, disuruh ulang terus",negatif,2023-09-11,2023,verifikasi ga jelas disuruh ulang terus,6,6,verifikasi tidak jelas disuruh ulang terus,6,6,"['verifikasi', 'tidak', 'jelas', 'disuruh', 'ulang', 'terus']","['verifikasi', 'tidak', 'disuruh', 'ulang']",6,4,2,verifikasi tidak suruh ulang,4,4
Cukup bagus aplikasi ini coba sendiri,positif,2021-12-02,2021,cukup bagus aplikasi ini coba sendiri,6,6,cukup bagus aplikasi ini coba sendiri,6,6,"['cukup', 'bagus', 'aplikasi', 'ini', 'coba', 'sendiri']","['bagus', 'aplikasi', 'coba']",6,3,3,bagus aplikasi coba,3,3
"aplikasinya sangat bagus, mantap sekali",positif,2021-10-21,2021,aplikasinya sangat bagus mantap sekali,5,5,aplikasi nya sangat bagus mantap sekali,5,6,"['aplikasi', 'nya', 'sangat', 'bagus', 'mantap', 'sekali']","['aplikasi', 'nya', 'bagus', 'mantap']",6,4,2,aplikasi nya bagus mantap,4,4
"Saya kok tiba tiba ada uang masuk dr odeo tekhnologi, saya tidak ada pinjam uang atw apapun itu, jd jgn macam2 kalian tiba tiba kirim uang",negatif,2022-11-03,2022,saya kok tiba tiba ada uang masuk dr odeo tekhnologi saya tidak ada pinjam uang atw apapun itu jd jgn macam kalian tiba tiba kirim uang,26,26,saya kok tiba tiba ada uang masuk dari odeo tekhnologi saya tidak ada pinjam uang atau apapun itu jadi jangan macam kalian tiba tiba kirim uang,26,26,"['saya', 'kok', 'tiba', 'tiba', 'ada', 'uang', 'masuk', 'dari', 'odeo', 'tekhnologi', 'saya', 'tidak', 'ada', 'pinjam', 'uang', 'atau', 'apapun', 'itu', 'jadi', 'jangan', 'macam', 'kalian', 'tiba', 'tiba', 'kirim', 'uang']","['uang', 'masuk', 'odeo', 'tekhnologi', 'tidak', 'pinjam', 'uang', 'apapun', 'kirim', 'uang']",26,10,16,uang masuk odeo tekhnologi tidak pinjam uang apa kirim uang,10,10
Good...semoga saja saya dapatkan pekerjaan melalui Linked in...aamiin...pandemi Corona membuat segalanya berantakan 🙏,positif,2021-01-15,2021,good semoga saja saya dapatkan pekerjaan melalui linked in aamiin pandemi corona membuat segalanya berantakan,13,15,bagus semoga saja saya dapatkan pekerjaan melalui linked in aamiin pandemik corona membuat segalanya berantakan,15,15,"['bagus', 'semoga', 'saja', 'saya', 'dapatkan', 'pekerjaan', 'melalui', 'linked', 'in', 'aamiin', 'pandemik', 'corona', 'membuat', 'segalanya', 'berantakan']","['bagus', 'semoga', 'dapatkan', 'pekerjaan', 'linked', 'in', 'aamiin', 'pandemik', 'corona', 'berantakan']",15,10,5,bagus moga dapat kerja linked in aamiin pandemik corona beranta,10,10
Aplikasi yg bagus untu sharing informasi,positif,2021-05-03,2021,aplikasi yg bagus untu sharing informasi,6,6,aplikasi yang bagus untu sharing informasi,6,6,"['aplikasi', 'yang', 'bagus', 'untu', 'sharing', 'informasi']","['aplikasi', 'bagus', 'untu', 'sharing', 'informasi']",6,5,1,aplikasi bagus untu sharing informasi,5,5
Sangat membantu dalam mencari pekerjaan,positif,2020-01-26,2020,sangat membantu dalam mencari pekerjaan,5,5,sangat membantu dalam mencari pekerjaan,5,5,"['sangat', 'membantu', 'dalam', 'mencari', 'pekerjaan']","['membantu', 'mencari', 'pekerjaan']",5,3,2,bantu cari kerja,3,3
Penting banget saat cari informasi pekerjaan.,positif,2020-09-15,2020,penting banget saat cari informasi pekerjaan,6,6,penting banget saat cari informasi pekerjaan,6,6,"['penting', 'banget', 'saat', 'cari', 'informasi', 'pekerjaan']","['banget', 'cari', 'informasi', 'pekerjaan']",6,4,2,banget cari informasi kerja,4,4
Sangat membantu komunikasi,positif,2020-12-25,2020,sangat membantu komunikasi,3,3,sangat membantu komunikasi,3,3,"['sangat', 'membantu', 'komunikasi']","['membantu', 'komunikasi']",3,2,1,bantu komunikasi,2,2
"Kenapa susah sekali verifikasinya, gambar kodok yg di pilih salah terus",negatif,2021-09-25,2021,kenapa susah sekali verifikasinya gambar kodok yg di pilih salah terus,11,11,kenapa susah sekali verifikasinya gambar kodok yang di pilih salah terus,11,11,"['kenapa', 'susah', 'sekali', 'verifikasinya', 'gambar', 'kodok', 'yang', 'di', 'pilih', 'salah', 'terus']","['susah', 'verifikasinya', 'gambar', 'kodok', 'pilih', 'salah']",11,6,5,susah verifikasi gambar kodok pilih salah,6,6
Saya tidak bisa akses aplikasi ini dari Handphone,negatif,2023-11-16,2023,saya tidak bisa akses aplikasi ini dari handphone,8,8,saya tidak bisa akses aplikasi ini dari handphone,8,8,"['saya', 'tidak', 'bisa', 'akses', 'aplikasi', 'ini', 'dari', 'handphone']","['tidak', 'akses', 'aplikasi', 'handphone']",8,4,4,tidak akses aplikasi handphone,4,4
W gk pernah pake aplikasi ini tapi sering ada notif ngeselin,negatif,2023-01-08,2023,w gk pernah pake aplikasi ini tapi sering ada notif ngeselin,11,11,w tidak pernah pakai aplikasi ini tapi sering ada notif ngeselin,11,11,"['w', 'tidak', 'pernah', 'pakai', 'aplikasi', 'ini', 'tapi', 'sering', 'ada', 'notif', 'ngeselin']","['w', 'tidak', 'pakai', 'aplikasi', 'notif', 'ngeselin']",11,6,5,w tidak pakai aplikasi notif ngeselin,6,6
"Akun saya di non aktifkan, tidak bisa login lagi",negatif,2022-01-06,2022,akun saya di non aktifkan tidak bisa login lagi,9,9,akun saya di non aktifkan tidak bisa login lagi,9,9,"['akun', 'saya', 'di', 'non', 'aktifkan', 'tidak', 'bisa', 'login', 'lagi']","['akun', 'non', 'aktifkan', 'tidak', 'login']",9,5,4,akun non aktif tidak login,5,5
Kenapa ganti foto profil lama banget ya ? Gak bisa diganti,negatif,2021-01-16,2021,kenapa ganti foto profil lama banget ya gak bisa diganti,11,10,kenapa ganti foto profil lama banget ya tidak bisa diganti,10,10,"['kenapa', 'ganti', 'foto', 'profil', 'lama', 'banget', 'ya', 'tidak', 'bisa', 'diganti']","['ganti', 'foto', 'profil', 'banget', 'ya', 'tidak', 'diganti']",10,7,3,ganti foto profil banget ya tidak ganti,7,7
Saya harap semakin baik dan bersahabat kepada pemakai aplikasi.,positif,2020-05-29,2020,saya harap semakin baik dan bersahabat kepada pemakai aplikasi,9,9,saya harap semakin baik dan bersahabat kepada pemakai aplikasi,9,9,"['saya', 'harap', 'semakin', 'baik', 'dan', 'bersahabat', 'kepada', 'pemakai', 'aplikasi']","['harap', 'bersahabat', 'pemakai', 'aplikasi']",9,4,5,harap sahabat pakai aplikasi,4,4
"Di hack tanpa pemberitahuan, udah verifikasi id tapi gaada kelanjutan",negatif,2023-09-06,2023,di hack tanpa pemberitahuan udah verifikasi id tapi gaada kelanjutan,10,10,di hack tanpa pemberitahuan sudah verifikasi id tapi tidak ada kelanjutan,10,11,"['di', 'hack', 'tanpa', 'pemberitahuan', 'sudah', 'verifikasi', 'id', 'tapi', 'tidak', 'ada', 'kelanjutan']","['hack', 'pemberitahuan', 'verifikasi', 'id', 'tidak', 'kelanjutan']",11,6,5,hack pemberitahuan verifikasi id tidak lanjut,6,6
"tidak bisa login,",negatif,2023-12-10,2023,tidak bisa login,3,3,tidak bisa login,3,3,"['tidak', 'bisa', 'login']","['tidak', 'login']",3,2,1,tidak login,2,2
Aplikasi untuk urusan pekerjaan the best,positif,2020-09-09,2020,aplikasi untuk urusan pekerjaan the best,6,6,aplikasi untuk urusan pekerjaan the terbaik,6,6,"['aplikasi', 'untuk', 'urusan', 'pekerjaan', 'the', 'terbaik']","['aplikasi', 'urusan', 'pekerjaan', 'the', 'terbaik']",6,5,1,aplikasi urus kerja the baik,5,5
Punya banyak relasi dan informasi umum,positif,2024-02-13,2024,punya banyak relasi dan informasi umum,6,6,punya banyak relasi dan informasi umum,6,6,"['punya', 'banyak', 'relasi', 'dan', 'informasi', 'umum']","['relasi', 'informasi']",6,2,4,relasi informasi,2,2
Mudah utk menghubungkan para profesional,positif,2021-11-25,2021,mudah utk menghubungkan para profesional,5,5,mudah untuk menghubungkan para profesional,5,5,"['mudah', 'untuk', 'menghubungkan', 'para', 'profesional']","['mudah', 'menghubungkan', 'profesional']",5,3,2,mudah hubung profesional,3,3
bergunaa bangett fiturnya jugaa baguss,positif,2023-02-10,2023,bergunaa bangett fiturnya jugaa baguss,5,5,bergunaa banget fitur nya juga bagus,5,6,"['bergunaa', 'banget', 'fitur', 'nya', 'juga', 'bagus']","['bergunaa', 'banget', 'fitur', 'nya', 'bagus']",6,5,1,bergunaa banget fitur nya bagus,5,5
Ada setelan yang sulit di ubah,negatif,2020-04-02,2020,ada setelan yang sulit di ubah,6,6,ada setelan yang sulit di ubah,6,6,"['ada', 'setelan', 'yang', 'sulit', 'di', 'ubah']","['setelan', 'sulit', 'ubah']",6,3,3,setel sulit ubah,3,3
Sangat bermanfaat apk ini. Terima kasih LINKEDIN,positif,2020-12-24,2020,sangat bermanfaat apk ini terima kasih linkedin,7,7,sangat bermanfaat aplikasi ini terima kasih linkedin,7,7,"['sangat', 'bermanfaat', 'aplikasi', 'ini', 'terima', 'kasih', 'linkedin']","['bermanfaat', 'aplikasi', 'terima', 'kasih', 'linkedin']",7,5,2,manfaat aplikasi terima kasih linkedin,5,5
"Setiap mau verifikasi nomer slalu gagal dan gak bis masuk, apa cuma saya aja ya?... Solusinya gimana ?",negatif,2022-07-05,2022,setiap mau verifikasi nomer slalu gagal dan gak bis masuk apa cuma saya aja ya solusinya gimana,18,17,setiap mau verifikasi nomor selalu gagal dan tidak bis masuk apa cuma saya saja ya solusinya bagaimana,17,17,"['setiap', 'mau', 'verifikasi', 'nomor', 'selalu', 'gagal', 'dan', 'tidak', 'bis', 'masuk', 'apa', 'cuma', 'saya', 'saja', 'ya', 'solusinya', 'bagaimana']","['verifikasi', 'nomor', 'gagal', 'tidak', 'bis', 'masuk', 'ya', 'solusinya']",17,8,9,verifikasi nomor gagal tidak bis masuk ya solusi,8,8
Sangat membantu para jobseker,positif,2022-06-07,2022,sangat membantu para jobseker,4,4,sangat membantu para jobseker,4,4,"['sangat', 'membantu', 'para', 'jobseker']","['membantu', 'jobseker']",4,2,2,bantu jobseker,2,2
Kenapa aplikasinya tdk bisa diuninstall?,negatif,2020-07-26,2020,kenapa aplikasinya tdk bisa diuninstall,5,5,kenapa aplikasi nya tidak bisa diuninstall,5,6,"['kenapa', 'aplikasi', 'nya', 'tidak', 'bisa', 'diuninstall']","['aplikasi', 'nya', 'tidak', 'diuninstall']",6,4,2,aplikasi nya tidak diuninstall,4,4
Kenapa ya LinkedIn sekarang kalo mau masuk verifikasi nya sulit,negatif,2022-01-12,2022,kenapa ya linkedin sekarang kalo mau masuk verifikasi nya sulit,10,10,kenapa ya linkedin sekarang kalau mau masuk verifikasi nya sulit,10,10,"['kenapa', 'ya', 'linkedin', 'sekarang', 'kalau', 'mau', 'masuk', 'verifikasi', 'nya', 'sulit']","['ya', 'linkedin', 'masuk', 'verifikasi', 'nya', 'sulit']",10,6,4,ya linkedin masuk verifikasi nya sulit,6,6
Bermanfaat bagi para pencari kerja,positif,2022-08-01,2022,bermanfaat bagi para pencari kerja,5,5,bermanfaat bagi para pencari kerja,5,5,"['bermanfaat', 'bagi', 'para', 'pencari', 'kerja']","['bermanfaat', 'pencari', 'kerja']",5,3,2,manfaat cari kerja,3,3
Banyak job tipu2 tolong lebih diseleksi,negatif,2022-04-19,2022,banyak job tipu tolong lebih diseleksi,6,6,banyak kerja tipu tolong lebih diseleksi,6,6,"['banyak', 'kerja', 'tipu', 'tolong', 'lebih', 'diseleksi']","['kerja', 'tipu', 'tolong', 'diseleksi']",6,4,2,kerja tipu tolong seleksi,4,4
Mudah mudahan saya mendapatkan banyak info lowongan pekerjaan,positif,2020-09-22,2020,mudah mudahan saya mendapatkan banyak info lowongan pekerjaan,8,8,mudah mudahan saya mendapatkan banyak informasi lowongan pekerjaan,8,8,"['mudah', 'mudahan', 'saya', 'mendapatkan', 'banyak', 'informasi', 'lowongan', 'pekerjaan']","['mudah', 'mudahan', 'informasi', 'lowongan', 'pekerjaan']",8,5,3,mudah mudah informasi lowong kerja,5,5
"Kenapa akun saya dinonaktifkan?. Kan saya nggak lakuin apa apa... Cuma agak jarang di buka, karena mau ujian... Kok malah kena nonàktif?",negatif,2020-02-24,2020,kenapa akun saya dinonaktifkan kan saya nggak lakuin apa apa cuma agak jarang di buka karena mau ujian kok malah kena nonàktif,22,22,kenapa akun saya dinonaktifkan akan saya tidak lakuin apa apa cuma agak jarang di buka karena mau ujian kok bahkan kena nonàktif,22,22,"['kenapa', 'akun', 'saya', 'dinonaktifkan', 'akan', 'saya', 'tidak', 'lakuin', 'apa', 'apa', 'cuma', 'agak', 'jarang', 'di', 'buka', 'karena', 'mau', 'ujian', 'kok', 'bahkan', 'kena', 'nonàktif']","['akun', 'dinonaktifkan', 'tidak', 'lakuin', 'jarang', 'buka', 'ujian', 'kena', 'nonàktif']",22,9,13,akun nonaktif tidak lakuin jarang buka uji kena non ktif,9,10
Tempat keren untuk para profesional,positif,2021-04-21,2021,tempat keren untuk para profesional,5,5,tempat keren untuk para profesional,5,5,"['tempat', 'keren', 'untuk', 'para', 'profesional']","['keren', 'profesional']",5,2,3,keren profesional,2,2
Kebanyakan untuk D3 dan S1. Lulusan dibawah itu susah banget cari lowker.,negatif,2022-05-13,2022,kebanyakan untuk d dan s lulusan dibawah itu susah banget cari lowker,12,12,kebanyakan untuk di dan s lulusan dibawah itu susah banget cari lowker,12,12,"['kebanyakan', 'untuk', 'di', 'dan', 's', 'lulusan', 'dibawah', 'itu', 'susah', 'banget', 'cari', 'lowker']","['kebanyakan', 's', 'lulusan', 'dibawah', 'susah', 'banget', 'cari', 'lowker']",12,8,4,banyak s lulus bawah susah banget cari lowker,8,8
Susah banget login nya gk di acc,negatif,2022-05-22,2022,susah banget login nya gk di acc,7,7,susah banget login nya tidak di acc,7,7,"['susah', 'banget', 'login', 'nya', 'tidak', 'di', 'acc']","['susah', 'banget', 'login', 'nya', 'tidak', 'acc']",7,6,1,susah banget login nya tidak acc,6,6
Apaan si mau bikin akun aja harus dibikinn ribet sama verifikasi aplikasi taai.,negatif,2021-10-27,2021,apaan si mau bikin akun aja harus dibikinn ribet sama verifikasi aplikasi taai,13,13,apa sih mau bikin akun saja harus dibikinn rumit sama verifikasi aplikasi taai,13,13,"['apa', 'sih', 'mau', 'bikin', 'akun', 'saja', 'harus', 'dibikinn', 'rumit', 'sama', 'verifikasi', 'aplikasi', 'taai']","['sih', 'bikin', 'akun', 'dibikinn', 'rumit', 'verifikasi', 'aplikasi', 'taai']",13,8,5,sih bikin akun dibikinn rumit verifikasi aplikasi taai,8,8
Aplikasi broken mau login aja susah amat,negatif,2024-05-04,2024,aplikasi broken mau login aja susah amat,7,7,aplikasi broken mau login saja susah amat,7,7,"['aplikasi', 'broken', 'mau', 'login', 'saja', 'susah', 'amat']","['aplikasi', 'broken', 'login', 'susah']",7,4,3,aplikasi broken login susah,4,4
Aplikasi pencari kerja yg bagus,positif,2022-06-28,2022,aplikasi pencari kerja yg bagus,5,5,aplikasi pencari kerja yang bagus,5,5,"['aplikasi', 'pencari', 'kerja', 'yang', 'bagus']","['aplikasi', 'pencari', 'kerja', 'bagus']",5,4,1,aplikasi cari kerja bagus,4,4
Verifikasi check gak jelas,negatif,2024-04-30,2024,verifikasi check gak jelas,4,4,verifikasi cek tidak jelas,4,4,"['verifikasi', 'cek', 'tidak', 'jelas']","['verifikasi', 'cek', 'tidak']",4,3,1,verifikasi cek tidak,3,3
Bisa membantu dalam Mencari pekerjaan,positif,2024-08-04,2024,bisa membantu dalam mencari pekerjaan,5,5,bisa membantu dalam mencari pekerjaan,5,5,"['bisa', 'membantu', 'dalam', 'mencari', 'pekerjaan']","['membantu', 'mencari', 'pekerjaan']",5,3,2,bantu cari kerja,3,3
Apk jelek bukan nya permanen malah sering download mulu.,negatif,2021-06-08,2021,apk jelek bukan nya permanen malah sering download mulu,9,9,aplikasi jelek bukan nya permanen bahkan sering unduh mulu,9,9,"['aplikasi', 'jelek', 'bukan', 'nya', 'permanen', 'bahkan', 'sering', 'unduh', 'mulu']","['aplikasi', 'jelek', 'nya', 'permanen', 'unduh', 'mulu']",9,6,3,aplikasi jelek nya permanen unduh mulu,6,6
Baru mau gabung disuruh pilih beberapa gambar kambing yang menghadap ke atas. Au ahhh gelap. Cancel aja gabungnya,negatif,2022-02-27,2022,baru mau gabung disuruh pilih beberapa gambar kambing yang menghadap ke atas au ahhh gelap cancel aja gabungnya,18,18,baru mau gabung disuruh pilih beberapa gambar kambing yang menghadap ke atas au ahhh gelap batal saja gabungnya,18,18,"['baru', 'mau', 'gabung', 'disuruh', 'pilih', 'beberapa', 'gambar', 'kambing', 'yang', 'menghadap', 'ke', 'atas', 'au', 'ahhh', 'gelap', 'batal', 'saja', 'gabungnya']","['gabung', 'disuruh', 'pilih', 'gambar', 'kambing', 'menghadap', 'au', 'ahhh', 'gelap', 'batal', 'gabungnya']",18,11,7,gabung suruh pilih gambar kambing hadap au ahhh gelap batal gabung,11,11
Daftar akun verifikasinya kek ajg !!,negatif,2022-06-25,2022,daftar akun verifikasinya kek ajg,6,5,daftar akun verifikasinya seperti ajg,5,5,"['daftar', 'akun', 'verifikasinya', 'seperti', 'ajg']","['daftar', 'akun', 'verifikasinya', 'ajg']",5,4,1,daftar akun verifikasi ajg,4,4
Sangat bermanfaat dan membantu,positif,2024-07-17,2024,sangat bermanfaat dan membantu,4,4,sangat bermanfaat dan membantu,4,4,"['sangat', 'bermanfaat', 'dan', 'membantu']","['bermanfaat', 'membantu']",4,2,2,manfaat bantu,2,2
Ada masalah apa sihhh nii aplikasi?! Susah banget mauu logiiinnn!!!,negatif,2023-12-04,2023,ada masalah apa sihhh nii aplikasi susah banget mauu logiiinnn,10,10,ada masalah apa sihhh nii aplikasi susah banget mauu logiiinnn,10,10,"['ada', 'masalah', 'apa', 'sihhh', 'nii', 'aplikasi', 'susah', 'banget', 'mauu', 'logiiinnn']","['sihhh', 'nii', 'aplikasi', 'susah', 'banget', 'mauu', 'logiiinnn']",10,7,3,sihhh nii aplikasi susah banget mauu logiiinnn,7,7
Aplikasi Tidak Dapat Akses Ke Google,negatif,2022-09-11,2022,aplikasi tidak dapat akses ke google,6,6,aplikasi tidak dapat akses ke google,6,6,"['aplikasi', 'tidak', 'dapat', 'akses', 'ke', 'google']","['aplikasi', 'tidak', 'akses', 'google']",6,4,2,aplikasi tidak akses google,4,4
Login susah benerr jadi lucu ini aplikasi,negatif,2023-05-07,2023,login susah benerr jadi lucu ini aplikasi,7,7,login susah benerr jadi lucu ini aplikasi,7,7,"['login', 'susah', 'benerr', 'jadi', 'lucu', 'ini', 'aplikasi']","['login', 'susah', 'benerr', 'lucu', 'aplikasi']",7,5,2,login susah benerr lucu aplikasi,5,5
Cari infomasi lowongan kerja jadi lebih mudah,positif,2023-10-06,2023,cari infomasi lowongan kerja jadi lebih mudah,7,7,cari infomasi lowongan kerja jadi lebih mudah,7,7,"['cari', 'infomasi', 'lowongan', 'kerja', 'jadi', 'lebih', 'mudah']","['cari', 'infomasi', 'lowongan', 'kerja', 'mudah']",7,5,2,cari infomasi lowong kerja mudah,5,5
"Ini unk pertama aku gunakan, baik dan semoga semakin membantu banyak orang untuk mendapatkan pekerjaan sehingga pengangguran di Indonesia semakin menurun. Semangat",positif,2023-10-10,2023,ini unk pertama aku gunakan baik dan semoga semakin membantu banyak orang untuk mendapatkan pekerjaan sehingga pengangguran di indonesia semakin menurun semangat,22,22,ini unk pertama aku gunakan baik dan semoga semakin membantu banyak orang untuk mendapatkan pekerjaan sehingga pengangguran di indonesia semakin menurun semangat,22,22,"['ini', 'unk', 'pertama', 'aku', 'gunakan', 'baik', 'dan', 'semoga', 'semakin', 'membantu', 'banyak', 'orang', 'untuk', 'mendapatkan', 'pekerjaan', 'sehingga', 'pengangguran', 'di', 'indonesia', 'semakin', 'menurun', 'semangat']","['unk', 'semoga', 'membantu', 'orang', 'pekerjaan', 'pengangguran', 'indonesia', 'menurun', 'semangat']",22,9,13,unk moga bantu orang kerja anggur indonesia turun semangat,9,9
sangat membantu dan menambah jaringan baru dalam ber bisnis,positif,2020-09-03,2020,sangat membantu dan menambah jaringan baru dalam ber bisnis,9,9,sangat membantu dan menambah jaringan baru dalam ber bisnis,9,9,"['sangat', 'membantu', 'dan', 'menambah', 'jaringan', 'baru', 'dalam', 'ber', 'bisnis']","['membantu', 'menambah', 'jaringan', 'ber', 'bisnis']",9,5,4,bantu tambah jaring ber bisnis,5,5
Selalu keluar mulu tiap baru buka...😌😪,negatif,2023-02-17,2023,selalu keluar mulu tiap baru buka,6,6,selalu keluar mulu tiap baru buka,6,6,"['selalu', 'keluar', 'mulu', 'tiap', 'baru', 'buka']","['mulu', 'buka']",6,2,4,mulu buka,2,2
Aplikasi bagus.. semoga Allah mudahkan saya mndpat pekerjaan dsni,positif,2020-06-12,2020,aplikasi bagus semoga allah mudahkan saya mndpat pekerjaan dsni,9,9,aplikasi bagus semoga allah mudahkan saya mndpat pekerjaan disini,9,9,"['aplikasi', 'bagus', 'semoga', 'allah', 'mudahkan', 'saya', 'mndpat', 'pekerjaan', 'disini']","['aplikasi', 'bagus', 'semoga', 'allah', 'mudahkan', 'mndpat', 'pekerjaan']",9,7,2,aplikasi bagus moga allah mudah mndpat kerja,7,7
"Aplikasi gajelas, baru buka ngeclose sendiri",negatif,2020-01-14,2020,aplikasi gajelas baru buka ngeclose sendiri,6,6,aplikasi tidak jelas baru buka ngeclose sendiri,6,7,"['aplikasi', 'tidak', 'jelas', 'baru', 'buka', 'ngeclose', 'sendiri']","['aplikasi', 'tidak', 'buka', 'ngeclose']",7,4,3,aplikasi tidak buka ngeclose,4,4
"jelek bet, udh berkali kali bikin akun g bs masuk mulu",negatif,2023-08-20,2023,jelek bet udh berkali kali bikin akun g bs masuk mulu,11,11,jelek banget sudah berkali kali bikin akun tidak bisa masuk mulu,11,11,"['jelek', 'banget', 'sudah', 'berkali', 'kali', 'bikin', 'akun', 'tidak', 'bisa', 'masuk', 'mulu']","['jelek', 'banget', 'berkali', 'kali', 'bikin', 'akun', 'tidak', 'masuk', 'mulu']",11,9,2,jelek banget kali kali bikin akun tidak masuk mulu,9,9
Aplikasi ter baik untuk cari kerja,positif,2023-08-14,2023,aplikasi ter baik untuk cari kerja,6,6,aplikasi ter baik untuk cari kerja,6,6,"['aplikasi', 'ter', 'baik', 'untuk', 'cari', 'kerja']","['aplikasi', 'ter', 'cari', 'kerja']",6,4,2,aplikasi ter cari kerja,4,4
mau login aja susah kebanyakan verifikasi 👎,negatif,2024-03-01,2024,mau login aja susah kebanyakan verifikasi,7,6,mau login saja susah kebanyakan verifikasi,6,6,"['mau', 'login', 'saja', 'susah', 'kebanyakan', 'verifikasi']","['login', 'susah', 'kebanyakan', 'verifikasi']",6,4,2,login susah banyak verifikasi,4,4
Aplikasi nya ga bisa login kenapa ya?,negatif,2024-01-26,2024,aplikasi nya ga bisa login kenapa ya,7,7,aplikasi nya tidak bisa login kenapa ya,7,7,"['aplikasi', 'nya', 'tidak', 'bisa', 'login', 'kenapa', 'ya']","['aplikasi', 'nya', 'tidak', 'login', 'ya']",7,5,2,aplikasi nya tidak login ya,5,5
Linkedin payah verifikasi udah bener tapi gagal Mulu ribet mau login aja Kode verifikasi SMs aja lemot,negatif,2022-05-10,2022,linkedin payah verifikasi udah bener tapi gagal mulu ribet mau login aja kode verifikasi sms aja lemot,17,17,linkedin payah verifikasi sudah benar tapi gagal mulu rumit mau login saja kode verifikasi sms saja lambat,17,17,"['linkedin', 'payah', 'verifikasi', 'sudah', 'benar', 'tapi', 'gagal', 'mulu', 'rumit', 'mau', 'login', 'saja', 'kode', 'verifikasi', 'sms', 'saja', 'lambat']","['linkedin', 'payah', 'verifikasi', 'gagal', 'mulu', 'rumit', 'login', 'kode', 'verifikasi', 'sms', 'lambat']",17,11,6,linkedin payah verifikasi gagal mulu rumit login kode verifikasi sms lambat,11,11
Semoga sukses selalu Aplikasi Linkedin,positif,2020-09-30,2020,semoga sukses selalu aplikasi linkedin,5,5,semoga sukses selalu aplikasi linkedin,5,5,"['semoga', 'sukses', 'selalu', 'aplikasi', 'linkedin']","['semoga', 'sukses', 'aplikasi', 'linkedin']",5,4,1,moga sukses aplikasi linkedin,4,4
Disini saya sudh brapa x menemukan loker dan semua banyak penipuan ujung2 nya dimintain uang dari mulai 1 jt sampe turun 100rb kasian klo yv bener2 butuh dibela2 in minjm sana sini untuk mengharapkan dapat pekerjaan,negatif,2023-09-16,2023,disini saya sudh brapa x menemukan loker dan semua banyak penipuan ujung nya dimintain uang dari mulai jt sampe turun rb kasian klo yv bener butuh dibela in minjm sana sini untuk mengharapkan dapat pekerjaan,36,35,disini saya sudh brapa x menemukan loker dan semua banyak penipuan ujung nya dimintain uang dari mulai jt sampai turun ribu kasian kalau ya benar butuh dibela in minjm sana sini untuk mengharapkan dapat pekerjaan,35,35,"['disini', 'saya', 'sudh', 'brapa', 'x', 'menemukan', 'loker', 'dan', 'semua', 'banyak', 'penipuan', 'ujung', 'nya', 'dimintain', 'uang', 'dari', 'mulai', 'jt', 'sampai', 'turun', 'ribu', 'kasian', 'kalau', 'ya', 'benar', 'butuh', 'dibela', 'in', 'minjm', 'sana', 'sini', 'untuk', 'mengharapkan', 'dapat', 'pekerjaan']","['sudh', 'brapa', 'x', 'menemukan', 'loker', 'penipuan', 'ujung', 'nya', 'dimintain', 'uang', 'jt', 'turun', 'ribu', 'kasian', 'ya', 'butuh', 'dibela', 'in', 'minjm', 'mengharapkan', 'pekerjaan']",35,21,14,sudh brapa x temu loker tipu ujung nya dimintain uang jt turun ribu kasi ya butuh bela in minjm harap kerja,21,21
CARA VERIFIKASI LIAT BANTENG NGADEP KE ATAS GIMANAA? SALAH MULU WOY,negatif,2024-01-27,2024,cara verifikasi liat banteng ngadep ke atas gimanaa salah mulu woy,11,11,cara verifikasi lihat banteng ngadep ke atas gimanaa salah mulu woy,11,11,"['cara', 'verifikasi', 'lihat', 'banteng', 'ngadep', 'ke', 'atas', 'gimanaa', 'salah', 'mulu', 'woy']","['verifikasi', 'lihat', 'banteng', 'ngadep', 'gimanaa', 'salah', 'mulu', 'woy']",11,8,3,verifikasi lihat banteng ngadep gimanaa salah mulu woy,8,8
"Satu aja dulu ya ,saya riet pakenya tidak mengerti terlalu rumit bagi saya",negatif,2020-12-25,2020,satu aja dulu ya saya riet pakenya tidak mengerti terlalu rumit bagi saya,13,13,satu saja dahulu ya saya riet pakenya tidak mengerti terlalu rumit bagi saya,13,13,"['satu', 'saja', 'dahulu', 'ya', 'saya', 'riet', 'pakenya', 'tidak', 'mengerti', 'terlalu', 'rumit', 'bagi', 'saya']","['ya', 'riet', 'pakenya', 'tidak', 'mengerti', 'rumit']",13,6,7,ya riet pakenya tidak erti rumit,6,6
Monyet gara gara apk ini saldo dana gua ke potong otomatis padahal ga pernah pencet atau mesen apa lumayan 1 juta 100,negatif,2024-04-04,2024,monyet gara gara apk ini saldo dana gua ke potong otomatis padahal ga pernah pencet atau mesen apa lumayan juta,22,20,monyet gara gara aplikasi ini saldo dana saya ke potong otomatis padahal tidak pernah tekan atau pesan apa lumayan juta,20,20,"['monyet', 'gara', 'gara', 'aplikasi', 'ini', 'saldo', 'dana', 'saya', 'ke', 'potong', 'otomatis', 'padahal', 'tidak', 'pernah', 'tekan', 'atau', 'pesan', 'apa', 'lumayan', 'juta']","['monyet', 'gara', 'gara', 'aplikasi', 'saldo', 'dana', 'potong', 'otomatis', 'tidak', 'tekan', 'pesan', 'lumayan', 'juta']",20,13,7,monyet gara gara aplikasi saldo dana potong otomatis tidak tekan pesan lumayan juta,13,13
Lagi butuh pekerjaan tapi profil mesti ada pekerjaan..kan tolol nmanya,negatif,2023-01-24,2023,lagi butuh pekerjaan tapi profil mesti ada pekerjaan kan tolol nmanya,10,11,lagi butuh pekerjaan tapi profil mesti ada pekerjaan akan tolol nmanya,11,11,"['lagi', 'butuh', 'pekerjaan', 'tapi', 'profil', 'mesti', 'ada', 'pekerjaan', 'akan', 'tolol', 'nmanya']","['butuh', 'pekerjaan', 'profil', 'mesti', 'pekerjaan', 'tolol', 'nmanya']",11,7,4,butuh kerja profil mesti kerja tolol nmanya,7,7
Sangat bagus dan berkualitas,positif,2020-03-20,2020,sangat bagus dan berkualitas,4,4,sangat bagus dan berkualitas,4,4,"['sangat', 'bagus', 'dan', 'berkualitas']","['bagus', 'berkualitas']",4,2,2,bagus kualitas,2,2
Bermanfaat tetapi bukan minat utama saya,positif,2024-08-22,2024,bermanfaat tetapi bukan minat utama saya,6,6,bermanfaat tetapi bukan minat utama saya,6,6,"['bermanfaat', 'tetapi', 'bukan', 'minat', 'utama', 'saya']","['bermanfaat', 'minat', 'utama']",6,3,3,manfaat minat utama,3,3
Terima kasih LinkedIn... semoga makin berkah dan sukses di hari hari selanjutnya,positif,2021-11-12,2021,terima kasih linkedin semoga makin berkah dan sukses di hari hari selanjutnya,12,12,terima kasih linkedin semoga makin berkah dan sukses di hari hari selanjutnya,12,12,"['terima', 'kasih', 'linkedin', 'semoga', 'makin', 'berkah', 'dan', 'sukses', 'di', 'hari', 'hari', 'selanjutnya']","['terima', 'kasih', 'linkedin', 'semoga', 'berkah', 'sukses']",12,6,6,terima kasih linkedin moga berkah sukses,6,6
"Mudah2an Mendapat Peluang besar Bisnis & Rejeki Manjur, God Bless",positif,2020-08-10,2020,mudah an mendapat peluang besar bisnis rejeki manjur god bless,10,10,mudah an mendapat peluang besar bisnis rejeki manjur god bless,10,10,"['mudah', 'an', 'mendapat', 'peluang', 'besar', 'bisnis', 'rejeki', 'manjur', 'god', 'bless']","['mudah', 'an', 'peluang', 'bisnis', 'rejeki', 'manjur', 'god', 'bless']",10,8,2,mudah an peluang bisnis rejeki manjur god bless,8,8
Membangun dalam memperluas jaringan,positif,2021-11-15,2021,membangun dalam memperluas jaringan,4,4,membangun dalam memperluas jaringan,4,4,"['membangun', 'dalam', 'memperluas', 'jaringan']","['membangun', 'memperluas', 'jaringan']",4,3,1,bangun luas jaring,3,3
Sangat membantu dalam memberi info lowongan pekerjaan,positif,2023-09-13,2023,sangat membantu dalam memberi info lowongan pekerjaan,7,7,sangat membantu dalam memberi informasi lowongan pekerjaan,7,7,"['sangat', 'membantu', 'dalam', 'memberi', 'informasi', 'lowongan', 'pekerjaan']","['membantu', 'informasi', 'lowongan', 'pekerjaan']",7,4,3,bantu informasi lowong kerja,4,4
"Tolol nyari kerja aja susah developer niat gk sih Bantu, verification aja susah nya Kaya ujian national, dasar badak edan tabak gambar Salah mulu",negatif,2021-03-27,2021,tolol nyari kerja aja susah developer niat gk sih bantu verification aja susah nya kaya ujian national dasar badak edan tabak gambar salah mulu,24,24,tolol mencari kerja saja susah developer niat tidak sih bantu verification saja susah nya kayak ujian national dasar badak edan tabak gambar salah mulu,24,24,"['tolol', 'mencari', 'kerja', 'saja', 'susah', 'developer', 'niat', 'tidak', 'sih', 'bantu', 'verification', 'saja', 'susah', 'nya', 'kayak', 'ujian', 'national', 'dasar', 'badak', 'edan', 'tabak', 'gambar', 'salah', 'mulu']","['tolol', 'mencari', 'kerja', 'susah', 'developer', 'niat', 'tidak', 'sih', 'bantu', 'verification', 'susah', 'nya', 'kayak', 'ujian', 'national', 'dasar', 'badak', 'edan', 'tabak', 'gambar', 'salah', 'mulu']",24,22,2,tolol cari kerja susah developer niat tidak sih bantu verification susah nya kayak uji national dasar badak edan tabak gambar salah mulu,22,22
"bnyk manfaat nya, banyak info mantap 👍👍👍",positif,2020-03-06,2020,bnyk manfaat nya banyak info mantap,7,6,banyak manfaat nya banyak informasi mantap,6,6,"['banyak', 'manfaat', 'nya', 'banyak', 'informasi', 'mantap']","['manfaat', 'nya', 'informasi', 'mantap']",6,4,2,manfaat nya informasi mantap,4,4
"Apk bagus, mantaplah pokoknya 👍 gue dapet kerjaan dari sini 🤘",positif,2021-07-13,2021,apk bagus mantaplah pokoknya gue dapet kerjaan dari sini,11,9,aplikasi bagus mantap lah pokoknya saya dapat kerjaan dari sini,9,10,"['aplikasi', 'bagus', 'mantap', 'lah', 'pokoknya', 'saya', 'dapat', 'kerjaan', 'dari', 'sini']","['aplikasi', 'bagus', 'mantap', 'pokoknya', 'kerjaan']",10,5,5,aplikasi bagus mantap pokok kerja,5,5
Makin buruk tdk dapat diintal di hp mana pun skr,negatif,2023-03-04,2023,makin buruk tdk dapat diintal di hp mana pun skr,10,10,makin buruk tidak dapat diintal di handphone mana pun sekarang,10,10,"['makin', 'buruk', 'tidak', 'dapat', 'diintal', 'di', 'handphone', 'mana', 'pun', 'sekarang']","['buruk', 'tidak', 'diintal', 'handphone']",10,4,6,buruk tidak diintal handphone,4,4
Tiba akun dibanned sudah verifikasi menggunakan KTP tidak ada kejelasan sampai sekarang,negatif,2023-09-07,2023,tiba akun dibanned sudah verifikasi menggunakan ktp tidak ada kejelasan sampai sekarang,12,12,tiba akun dibanned sudah verifikasi menggunakan ktp tidak ada kejelasan sampai sekarang,12,12,"['tiba', 'akun', 'dibanned', 'sudah', 'verifikasi', 'menggunakan', 'ktp', 'tidak', 'ada', 'kejelasan', 'sampai', 'sekarang']","['akun', 'dibanned', 'verifikasi', 'ktp', 'tidak', 'kejelasan']",12,6,6,akun dibanned verifikasi ktp tidak jelas,6,6
Terkoneksi dengan para orang pintar,positif,2022-04-10,2022,terkoneksi dengan para orang pintar,5,5,terkoneksi dengan para orang pintar,5,5,"['terkoneksi', 'dengan', 'para', 'orang', 'pintar']","['terkoneksi', 'orang', 'pintar']",5,3,2,koneksi orang pintar,3,3
Apk gak guna buat saya,negatif,2024-06-11,2024,apk gak guna buat saya,5,5,aplikasi tidak guna buat saya,5,5,"['aplikasi', 'tidak', 'guna', 'buat', 'saya']","['aplikasi', 'tidak']",5,2,3,aplikasi tidak,2,2
"sangat membantu untuk mencari kerja.. tapi saya blum dapat kerja"" darii apl ini.",positif,2020-06-22,2020,sangat membantu untuk mencari kerja tapi saya blum dapat kerja darii apl ini,13,13,sangat membantu untuk mencari kerja tapi saya belum dapat kerja darii aplikasi ini,13,13,"['sangat', 'membantu', 'untuk', 'mencari', 'kerja', 'tapi', 'saya', 'belum', 'dapat', 'kerja', 'darii', 'aplikasi', 'ini']","['membantu', 'mencari', 'kerja', 'kerja', 'darii', 'aplikasi']",13,6,7,bantu cari kerja kerja dari aplikasi,6,6
Ribet mending pake jibstreet express lebih gampang,negatif,2024-05-02,2024,ribet mending pake jibstreet express lebih gampang,7,7,rumit mending pakai jibstreet express lebih gampang,7,7,"['rumit', 'mending', 'pakai', 'jibstreet', 'express', 'lebih', 'gampang']","['rumit', 'mending', 'pakai', 'jibstreet', 'express', 'gampang']",7,6,1,rumit mending pakai jibstreet express gampang,6,6
"Viruss...aplikasi ini merusak ponsel, lihat komentar negatif dibawah.. Nyesal pokoknya",negatif,2021-01-06,2021,viruss aplikasi ini merusak ponsel lihat komentar negatif dibawah nyesal pokoknya,10,11,viruss aplikasi ini merusak ponsel lihat komentar negatif dibawah menyesal pokoknya,11,11,"['viruss', 'aplikasi', 'ini', 'merusak', 'ponsel', 'lihat', 'komentar', 'negatif', 'dibawah', 'menyesal', 'pokoknya']","['viruss', 'aplikasi', 'merusak', 'ponsel', 'lihat', 'komentar', 'negatif', 'dibawah', 'menyesal', 'pokoknya']",11,10,1,viruss aplikasi rusak ponsel lihat komentar negatif bawah sesal pokok,10,10
Sangat membantu dalam hal pekerjaan,positif,2020-07-03,2020,sangat membantu dalam hal pekerjaan,5,5,sangat membantu dalam hal pekerjaan,5,5,"['sangat', 'membantu', 'dalam', 'hal', 'pekerjaan']","['membantu', 'pekerjaan']",5,2,3,bantu kerja,2,2
Banyak penipu,negatif,2024-08-02,2024,banyak penipu,2,2,banyak penipu,2,2,"['banyak', 'penipu']",['penipu'],2,1,1,tipu,1,1
Alhamdulillah Postingan saya berhasil menemukan Mitra Bisnis yang Tepat dan 5 karyawan yang Hebat Terimakasih Langsung saya kasih bintang 5,positif,2020-06-06,2020,alhamdulillah postingan saya berhasil menemukan mitra bisnis yang tepat dan karyawan yang hebat terimakasih langsung saya kasih bintang,20,18,alhamdulillah postingan saya berhasil menemukan mitra bisnis yang tepat dan karyawan yang hebat terima kasih langsung saya kasih bintang,18,19,"['alhamdulillah', 'postingan', 'saya', 'berhasil', 'menemukan', 'mitra', 'bisnis', 'yang', 'tepat', 'dan', 'karyawan', 'yang', 'hebat', 'terima', 'kasih', 'langsung', 'saya', 'kasih', 'bintang']","['alhamdulillah', 'postingan', 'berhasil', 'menemukan', 'mitra', 'bisnis', 'karyawan', 'hebat', 'terima', 'kasih', 'langsung', 'kasih', 'bintang']",19,13,6,alhamdulillah postingan hasil temu mitra bisnis karyawan hebat terima kasih langsung kasih bintang,13,13
Susah banget loginya masak mau login aja harus nebak katak ini link loker apa mau permaiann katak aneh,negatif,2022-01-28,2022,susah banget loginya masak mau login aja harus nebak katak ini link loker apa mau permaiann katak aneh,18,18,susah banget loginya masak mau login saja harus nebak katak ini link loker apa mau permaiann katak aneh,18,18,"['susah', 'banget', 'loginya', 'masak', 'mau', 'login', 'saja', 'harus', 'nebak', 'katak', 'ini', 'link', 'loker', 'apa', 'mau', 'permaiann', 'katak', 'aneh']","['susah', 'banget', 'loginya', 'masak', 'login', 'nebak', 'katak', 'link', 'loker', 'permaiann', 'katak', 'aneh']",18,12,6,susah banget log masak login nebak katak link loker permaiann katak aneh,12,12
"Masyaallah, Niat mau download buat cari kerja malah bikin emosi ni App, Verifikasinya dari pagi sampai sore enggak masuk2",negatif,2023-04-08,2023,masyaallah niat mau download buat cari kerja malah bikin emosi ni app verifikasinya dari pagi sampai sore enggak masuk,19,19,masyaallah niat mau unduh buat cari kerja bahkan bikin emosi ini aplikasi verifikasinya dari pagi sampai sore enggak masuk,19,19,"['masyaallah', 'niat', 'mau', 'unduh', 'buat', 'cari', 'kerja', 'bahkan', 'bikin', 'emosi', 'ini', 'aplikasi', 'verifikasinya', 'dari', 'pagi', 'sampai', 'sore', 'enggak', 'masuk']","['masyaallah', 'niat', 'unduh', 'cari', 'kerja', 'bikin', 'emosi', 'aplikasi', 'verifikasinya', 'pagi', 'sore', 'masuk']",19,12,7,masyaallah niat unduh cari kerja bikin emosi aplikasi verifikasi pagi sore masuk,12,12
"Berbagi banyak pengalaman dan dapat motivasi, yukk jangan kendor semangat nya buat jadi orang kaya yang dermawan dan sukses menaklukkan dunia.🤗🤗",positif,2022-01-08,2022,berbagi banyak pengalaman dan dapat motivasi yukk jangan kendor semangat nya buat jadi orang kaya yang dermawan dan sukses menaklukkan dunia,21,21,berbagi banyak pengalaman dan dapat motivasi yukk jangan kendor semangat nya buat jadi orang kayak yang dermawan dan sukses menaklukkan dunia,21,21,"['berbagi', 'banyak', 'pengalaman', 'dan', 'dapat', 'motivasi', 'yukk', 'jangan', 'kendor', 'semangat', 'nya', 'buat', 'jadi', 'orang', 'kayak', 'yang', 'dermawan', 'dan', 'sukses', 'menaklukkan', 'dunia']","['berbagi', 'pengalaman', 'motivasi', 'yukk', 'kendor', 'semangat', 'nya', 'orang', 'kayak', 'dermawan', 'sukses', 'menaklukkan', 'dunia']",21,13,8,bagi alam motivasi yukk kendor semangat nya orang kayak dermawan sukses takluk dunia,13,13
Keren tempatnya para pekerja,positif,2021-06-12,2021,keren tempatnya para pekerja,4,4,keren tempatnya para yang kerja,4,5,"['keren', 'tempatnya', 'para', 'yang', 'kerja']","['keren', 'tempatnya', 'kerja']",5,3,2,keren tempat kerja,3,3
Sangat membantu dalam mencari pekerjaan.,positif,2022-09-16,2022,sangat membantu dalam mencari pekerjaan,5,5,sangat membantu dalam mencari pekerjaan,5,5,"['sangat', 'membantu', 'dalam', 'mencari', 'pekerjaan']","['membantu', 'mencari', 'pekerjaan']",5,3,2,bantu cari kerja,3,3
Aplikasi ini sangat bagus untuk menambah jejaring,positif,2020-10-08,2020,aplikasi ini sangat bagus untuk menambah jejaring,7,7,aplikasi ini sangat bagus untuk menambah jejaring,7,7,"['aplikasi', 'ini', 'sangat', 'bagus', 'untuk', 'menambah', 'jejaring']","['aplikasi', 'bagus', 'menambah', 'jejaring']",7,4,3,aplikasi bagus tambah jejaring,4,4
"Apaan anjir, mau masuk aja minta foto ktp, buat apaan dah?. Ya kali gw mau kirimin foto ktp gw. Baru kali ini gw nemu aplikasi yang mita foto kartu id, udah kayak pinjol aja.",negatif,2023-04-03,2023,apaan anjir mau masuk aja minta foto ktp buat apaan dah ya kali gw mau kirimin foto ktp gw baru kali ini gw nemu aplikasi yang mita foto kartu id udah kayak pinjol aja,34,34,apa anjir mau masuk saja minta foto ktp buat apa sudah ya kali saya mau kirimin foto ktp saya baru kali ini saya ketemu aplikasi yang mita foto kartu id sudah kayak pinjol saja,34,34,"['apa', 'anjir', 'mau', 'masuk', 'saja', 'minta', 'foto', 'ktp', 'buat', 'apa', 'sudah', 'ya', 'kali', 'saya', 'mau', 'kirimin', 'foto', 'ktp', 'saya', 'baru', 'kali', 'ini', 'saya', 'ketemu', 'aplikasi', 'yang', 'mita', 'foto', 'kartu', 'id', 'sudah', 'kayak', 'pinjol', 'saja']","['anjir', 'masuk', 'foto', 'ktp', 'ya', 'kali', 'kirimin', 'foto', 'ktp', 'kali', 'ketemu', 'aplikasi', 'mita', 'foto', 'kartu', 'id', 'kayak', 'pinjol']",34,18,16,anjir masuk foto ktp ya kali kirimin foto ktp kali ketemu aplikasi mita foto kartu id kayak pinjol,18,18
Aplikasi yang semakin hari semakin bijak,positif,2020-07-25,2020,aplikasi yang semakin hari semakin bijak,6,6,aplikasi yang semakin hari semakin bijak,6,6,"['aplikasi', 'yang', 'semakin', 'hari', 'semakin', 'bijak']","['aplikasi', 'bijak']",6,2,4,aplikasi bijak,2,2
"Apk anh Suruh verifikasi tapi gk bisa"" lol bgt sih",negatif,2022-09-28,2022,apk anh suruh verifikasi tapi gk bisa lol bgt sih,10,10,aplikasi anh suruh verifikasi tapi tidak bisa lol banget sih,10,10,"['aplikasi', 'anh', 'suruh', 'verifikasi', 'tapi', 'tidak', 'bisa', 'lol', 'banget', 'sih']","['aplikasi', 'anh', 'suruh', 'verifikasi', 'tidak', 'lol', 'banget', 'sih']",10,8,2,aplikasi anh suruh verifikasi tidak lol banget sih,8,8
Sangat bermanfaat untuk dunia kerja 👍🏻,positif,2022-03-21,2022,sangat bermanfaat untuk dunia kerja,6,5,sangat bermanfaat untuk dunia kerja,5,5,"['sangat', 'bermanfaat', 'untuk', 'dunia', 'kerja']","['bermanfaat', 'dunia', 'kerja']",5,3,2,manfaat dunia kerja,3,3
"Ko aplikasi ini nambah gax Jlassnya aja, sdh Jlass² kata sandy nya bnr, malah trusss Ferivikasi brulang². Ydh jgn di Download",negatif,2022-06-02,2022,ko aplikasi ini nambah gax jlassnya aja sdh jlass² kata sandy nya bnr malah trusss ferivikasi brulang² ydh jgn di download,21,21,kok aplikasi ini nambah gax jlassnya saja sudah jlass² kata sandy nya benar bahkan trusss ferivikasi brulang² ydh jangan di unduh,21,21,"['kok', 'aplikasi', 'ini', 'nambah', 'gax', 'jlassnya', 'saja', 'sudah', 'jlass²', 'kata', 'sandy', 'nya', 'benar', 'bahkan', 'trusss', 'ferivikasi', 'brulang²', 'ydh', 'jangan', 'di', 'unduh']","['aplikasi', 'nambah', 'gax', 'jlassnya', 'jlass²', 'sandy', 'nya', 'trusss', 'ferivikasi', 'brulang²', 'ydh', 'unduh']",21,12,9,aplikasi nambah gax jlassnya jlass sandy nya trusss ferivikasi brulang ydh unduh,12,12
Mudah untuk mencari pekerjaan,negatif,2022-05-20,2022,mudah untuk mencari pekerjaan,4,4,mudah untuk mencari pekerjaan,4,4,"['mudah', 'untuk', 'mencari', 'pekerjaan']","['mudah', 'mencari', 'pekerjaan']",4,3,1,mudah cari kerja,3,3
LU IKLAN SEKALI LAGI AWAS 🤬,negatif,2024-06-23,2024,lu iklan sekali lagi awas,6,5,lu iklan sekali lagi awas,5,5,"['lu', 'iklan', 'sekali', 'lagi', 'awas']","['lu', 'iklan', 'awas']",5,3,2,lu iklan awas,3,3
Sangat bagus untuk mencari pekerjaan,positif,2021-02-22,2021,sangat bagus untuk mencari pekerjaan,5,5,sangat bagus untuk mencari pekerjaan,5,5,"['sangat', 'bagus', 'untuk', 'mencari', 'pekerjaan']","['bagus', 'mencari', 'pekerjaan']",5,3,2,bagus cari kerja,3,3
Sangat membantu bagi kalian pencari kerja,positif,2023-07-18,2023,sangat membantu bagi kalian pencari kerja,6,6,sangat membantu bagi kalian pencari kerja,6,6,"['sangat', 'membantu', 'bagi', 'kalian', 'pencari', 'kerja']","['membantu', 'pencari', 'kerja']",6,3,3,bantu cari kerja,3,3
Mudah mudah an sangat membantu,positif,2020-12-20,2020,mudah mudah an sangat membantu,5,5,mudah mudah an sangat membantu,5,5,"['mudah', 'mudah', 'an', 'sangat', 'membantu']","['mudah', 'mudah', 'an', 'membantu']",5,4,1,mudah mudah an bantu,4,4
Kenapa di bikin ribet sih mau bergabung pake verivikasi gambar bekali kali gada bisa masuk masuk .KALO KAYA GINI MAH MALES ORG JUGA LOGIN BANGRUT AJA UDAH DR PADA BIKIN RIBET,negatif,2022-03-28,2022,kenapa di bikin ribet sih mau bergabung pake verivikasi gambar bekali kali gada bisa masuk masuk kalo kaya gini mah males org juga login bangrut aja udah dr pada bikin ribet,31,31,kenapa di bikin rumit sih mau bergabung pakai verivikasi gambar bekali kali tidak ada bisa masuk masuk kalau kayak begini mah malas orang juga login bangrut saja sudah dari pada bikin rumit,31,32,"['kenapa', 'di', 'bikin', 'rumit', 'sih', 'mau', 'bergabung', 'pakai', 'verivikasi', 'gambar', 'bekali', 'kali', 'tidak', 'ada', 'bisa', 'masuk', 'masuk', 'kalau', 'kayak', 'begini', 'mah', 'malas', 'orang', 'juga', 'login', 'bangrut', 'saja', 'sudah', 'dari', 'pada', 'bikin', 'rumit']","['bikin', 'rumit', 'sih', 'bergabung', 'pakai', 'verivikasi', 'gambar', 'bekali', 'kali', 'tidak', 'masuk', 'masuk', 'kayak', 'mah', 'malas', 'orang', 'login', 'bangrut', 'bikin', 'rumit']",32,20,12,bikin rumit sih gabung pakai verivikasi gambar bekal kali tidak masuk masuk kayak mah malas orang login bangrut bikin rumit,20,20
Mempunyai potensial bagi individu dalam memperluas network dan ilmu,positif,2022-01-07,2022,mempunyai potensial bagi individu dalam memperluas network dan ilmu,9,9,mempunyai potensial bagi individu dalam memperluas network dan ilmu,9,9,"['mempunyai', 'potensial', 'bagi', 'individu', 'dalam', 'memperluas', 'network', 'dan', 'ilmu']","['potensial', 'individu', 'memperluas', 'network', 'ilmu']",9,5,4,potensial individu luas network ilmu,5,5
Link lebih luas dan wawasan terbuka lebar,positif,2021-09-11,2021,link lebih luas dan wawasan terbuka lebar,7,7,link lebih luas dan wawasan terbuka lebar,7,7,"['link', 'lebih', 'luas', 'dan', 'wawasan', 'terbuka', 'lebar']","['link', 'luas', 'wawasan', 'terbuka', 'lebar']",7,5,2,link luas wawas buka lebar,5,5
"NIH APLIKASI APAANSIH? PILIH GAMBAR YANG MENGHADAP KEATAS, KAGA BISA BIDA AJGG, SAMPAH BANGET",negatif,2022-06-21,2022,nih aplikasi apaansih pilih gambar yang menghadap keatas kaga bisa bida ajgg sampah banget,14,14,nih aplikasi apaansih pilih gambar yang menghadap keatas tidak bisa bida ajgg sampah banget,14,14,"['nih', 'aplikasi', 'apaansih', 'pilih', 'gambar', 'yang', 'menghadap', 'keatas', 'tidak', 'bisa', 'bida', 'ajgg', 'sampah', 'banget']","['nih', 'aplikasi', 'apaansih', 'pilih', 'gambar', 'menghadap', 'keatas', 'tidak', 'bida', 'ajgg', 'sampah', 'banget']",14,12,2,nih aplikasi apaansih pilih gambar hadap atas tidak bida ajgg sampah banget,12,12
Nih aplikasi ngeselin banget verifikasi aja susah banget.,negatif,2024-03-06,2024,nih aplikasi ngeselin banget verifikasi aja susah banget,8,8,nih aplikasi ngeselin banget verifikasi saja susah banget,8,8,"['nih', 'aplikasi', 'ngeselin', 'banget', 'verifikasi', 'saja', 'susah', 'banget']","['nih', 'aplikasi', 'ngeselin', 'banget', 'verifikasi', 'susah', 'banget']",8,7,1,nih aplikasi ngeselin banget verifikasi susah banget,7,7
Aplikasi gak guna masak nunggu acc dulu. Edah,negatif,2024-05-30,2024,aplikasi gak guna masak nunggu acc dulu edah,8,8,aplikasi tidak guna masak tunggu acc dahulu edah,8,8,"['aplikasi', 'tidak', 'guna', 'masak', 'tunggu', 'acc', 'dahulu', 'edah']","['aplikasi', 'tidak', 'masak', 'tunggu', 'acc', 'edah']",8,6,2,aplikasi tidak masak tunggu acc edah,6,6
"Good aplikasi, buat dunia kerja",positif,2020-04-23,2020,good aplikasi buat dunia kerja,5,5,bagus aplikasi buat dunia kerja,5,5,"['bagus', 'aplikasi', 'buat', 'dunia', 'kerja']","['bagus', 'aplikasi', 'dunia', 'kerja']",5,4,1,bagus aplikasi dunia kerja,4,4
Sangat buruk..verifikasinya gagal terus sama saja mempersulit orang..tolong diperbaiki min🤬,negatif,2022-05-26,2022,sangat buruk verifikasinya gagal terus sama saja mempersulit orang tolong diperbaiki min,10,12,sangat buruk verifikasinya gagal terus sama saja mempersulit orang tolong di perbaiki minimal,12,13,"['sangat', 'buruk', 'verifikasinya', 'gagal', 'terus', 'sama', 'saja', 'mempersulit', 'orang', 'tolong', 'di', 'perbaiki', 'minimal']","['buruk', 'verifikasinya', 'gagal', 'mempersulit', 'orang', 'tolong', 'perbaiki', 'minimal']",13,8,5,buruk verifikasi gagal sulit orang tolong baik minimal,8,8
Suka tiba-tiba gak bisa di akses,negatif,2022-05-02,2022,suka tiba tiba gak bisa di akses,6,7,suka tiba tiba tidak bisa di akses,7,7,"['suka', 'tiba', 'tiba', 'tidak', 'bisa', 'di', 'akses']","['suka', 'tidak', 'akses']",7,3,4,suka tidak akses,3,3
Walaupun belom dapat job dari sini. Tapi info masih ok,positif,2020-02-18,2020,walaupun belom dapat job dari sini tapi info masih ok,10,10,walaupun belum dapat kerja dari sini tapi informasi masih oke,10,10,"['walaupun', 'belum', 'dapat', 'kerja', 'dari', 'sini', 'tapi', 'informasi', 'masih', 'oke']","['kerja', 'informasi', 'oke']",10,3,7,kerja informasi oke,3,3
Bagus apk nya sangat membantu,positif,2024-05-21,2024,bagus apk nya sangat membantu,5,5,bagus aplikasi nya sangat membantu,5,5,"['bagus', 'aplikasi', 'nya', 'sangat', 'membantu']","['bagus', 'aplikasi', 'nya', 'membantu']",5,4,1,bagus aplikasi nya bantu,4,4
Cukup baik sampai saat 26-03-2020 .,positif,2020-03-26,2020,cukup baik sampai saat,6,4,cukup baik sampai saat,4,4,"['cukup', 'baik', 'sampai', 'saat']",[],4,1,3,,1,0
Sangat membantu untuk mendapatkan peluang pekerjaan impian,positif,2022-05-23,2022,sangat membantu untuk mendapatkan peluang pekerjaan impian,7,7,sangat membantu untuk mendapatkan peluang pekerjaan impian,7,7,"['sangat', 'membantu', 'untuk', 'mendapatkan', 'peluang', 'pekerjaan', 'impian']","['membantu', 'peluang', 'pekerjaan', 'impian']",7,4,3,bantu peluang kerja impi,4,4
Lamar pekerjaan jadi mudah hanya di LinkedIn,positif,2022-06-01,2022,lamar pekerjaan jadi mudah hanya di linkedin,7,7,lamar pekerjaan jadi mudah hanya di linkedin,7,7,"['lamar', 'pekerjaan', 'jadi', 'mudah', 'hanya', 'di', 'linkedin']","['lamar', 'pekerjaan', 'mudah', 'linkedin']",7,4,3,lamar kerja mudah linkedin,4,4
"Verfiikasinya susah pdhal bener, udh bolak balik nggk bisa login² maaf kau uninstal aja 😌",negatif,2023-05-03,2023,verfiikasinya susah pdhal bener udh bolak balik nggk bisa login² maaf kau uninstal aja,15,14,verfiikasinya susah pdhal benar sudah bolak balik tidak bisa login² maaf kau hapus instalan saja,14,15,"['verfiikasinya', 'susah', 'pdhal', 'benar', 'sudah', 'bolak', 'balik', 'tidak', 'bisa', 'login²', 'maaf', 'kau', 'hapus', 'instalan', 'saja']","['verfiikasinya', 'susah', 'pdhal', 'bolak', 'tidak', 'login²', 'maaf', 'kau', 'hapus', 'instalan']",15,10,5,verfiikasinya susah pdhal bolak tidak login maaf kau hapus instalan,10,10
bgus untuk mencari pekerjaan,positif,2021-03-03,2021,bgus untuk mencari pekerjaan,4,4,bagus untuk mencari pekerjaan,4,4,"['bagus', 'untuk', 'mencari', 'pekerjaan']","['bagus', 'mencari', 'pekerjaan']",4,3,1,bagus cari kerja,3,3
"Ngapa susah bgt si daftar doang et, verivikasi bukan robot lah, gila apa ya pantes aja bnyk yg rate bintang 1, eleuh",negatif,2023-04-14,2023,ngapa susah bgt si daftar doang et verivikasi bukan robot lah gila apa ya pantes aja bnyk yg rate bintang eleuh,22,21,ngapa susah banget sih daftar saja et verivikasi bukan robot lah gila apa ya pantes saja banyak yang rate bintang eleuh,21,21,"['ngapa', 'susah', 'banget', 'sih', 'daftar', 'saja', 'et', 'verivikasi', 'bukan', 'robot', 'lah', 'gila', 'apa', 'ya', 'pantes', 'saja', 'banyak', 'yang', 'rate', 'bintang', 'eleuh']","['ngapa', 'susah', 'banget', 'sih', 'daftar', 'et', 'verivikasi', 'robot', 'gila', 'ya', 'pantes', 'rate', 'bintang', 'eleuh']",21,14,7,ngapa susah banget sih daftar et verivikasi robot gila ya pantes rate bintang eleuh,14,14
Tau2 narik uang di dana saya 650rb.. Aplikasi apa ini...,negatif,2024-03-14,2024,tau narik uang di dana saya rb aplikasi apa ini,10,10,tahu narik uang di dana saya ribu aplikasi apa ini,10,10,"['tahu', 'narik', 'uang', 'di', 'dana', 'saya', 'ribu', 'aplikasi', 'apa', 'ini']","['narik', 'uang', 'dana', 'ribu', 'aplikasi']",10,5,5,narik uang dana ribu aplikasi,5,5
"Ini mah buat sarjana doang, smk mana bisa",negatif,2020-11-05,2020,ini mah buat sarjana doang smk mana bisa,8,8,ini mah buat sarjana saja smk mana bisa,8,8,"['ini', 'mah', 'buat', 'sarjana', 'saja', 'smk', 'mana', 'bisa']","['mah', 'sarjana', 'smk']",8,3,5,mah sarjana smk,3,3
Sangat membantu untuk mendapatkan informasi penting,positif,2022-05-26,2022,sangat membantu untuk mendapatkan informasi penting,6,6,sangat membantu untuk mendapatkan informasi penting,6,6,"['sangat', 'membantu', 'untuk', 'mendapatkan', 'informasi', 'penting']","['membantu', 'informasi']",6,2,4,bantu informasi,2,2
"Mau tutup akun, disuruh masukan kata sandi, tapi kotak kata sandi ga bisa dipencet buat di isi. EMOSI",negatif,2023-06-29,2023,mau tutup akun disuruh masukan kata sandi tapi kotak kata sandi ga bisa dipencet buat di isi emosi,18,18,mau tutup akun disuruh masukan kata sandi tapi kotak kata sandi tidak bisa dipencet buat di isi emosi,18,18,"['mau', 'tutup', 'akun', 'disuruh', 'masukan', 'kata', 'sandi', 'tapi', 'kotak', 'kata', 'sandi', 'tidak', 'bisa', 'dipencet', 'buat', 'di', 'isi', 'emosi']","['tutup', 'akun', 'disuruh', 'masukan', 'sandi', 'kotak', 'sandi', 'tidak', 'dipencet', 'isi', 'emosi']",18,11,7,tutup akun suruh masuk sandi kotak sandi tidak pencet isi emosi,11,11
Aplikasi babi. Pemeriksaan cepat apa babi. Semua salah.,negatif,2023-03-19,2023,aplikasi babi pemeriksaan cepat apa babi semua salah,8,8,aplikasi babi pemeriksaan cepat apa babi semua salah,8,8,"['aplikasi', 'babi', 'pemeriksaan', 'cepat', 'apa', 'babi', 'semua', 'salah']","['aplikasi', 'babi', 'pemeriksaan', 'cepat', 'babi', 'salah']",8,6,2,aplikasi babi periksa cepat babi salah,6,6
Susah bgt utk verifikasinya.tilong dipermudah.tq,negatif,2022-06-02,2022,susah bgt utk verifikasinya tilong dipermudah tq,5,7,susah banget untuk verifikasinya tilong dipermudah terima kasih,7,8,"['susah', 'banget', 'untuk', 'verifikasinya', 'tilong', 'dipermudah', 'terima', 'kasih']","['susah', 'banget', 'verifikasinya', 'tilong', 'dipermudah', 'terima', 'kasih']",8,7,1,susah banget verifikasi tilong mudah terima kasih,7,7
"Maaf, verikasinya jgn gambar kodok, geli liatnya, apalagi susah milih gambarnya",negatif,2021-12-15,2021,maaf verikasinya jgn gambar kodok geli liatnya apalagi susah milih gambarnya,11,11,maaf verikasinya jangan gambar kodok geli liatnya apalagi susah memilih gambarnya,11,11,"['maaf', 'verikasinya', 'jangan', 'gambar', 'kodok', 'geli', 'liatnya', 'apalagi', 'susah', 'memilih', 'gambarnya']","['maaf', 'verikasinya', 'gambar', 'kodok', 'geli', 'liatnya', 'susah', 'memilih', 'gambarnya']",11,9,2,maaf verikasinya gambar kodok geli liat susah pilih gambar,9,9
Aplikasi ini sangat bermanfaat dan sangat membantu saya👍,positif,2020-06-18,2020,aplikasi ini sangat bermanfaat dan sangat membantu saya,8,8,aplikasi ini sangat bermanfaat dan sangat membantu saya,8,8,"['aplikasi', 'ini', 'sangat', 'bermanfaat', 'dan', 'sangat', 'membantu', 'saya']","['aplikasi', 'bermanfaat', 'membantu']",8,3,5,aplikasi manfaat bantu,3,3
"Aplikasi sampah, kaga bisa login",negatif,2023-06-24,2023,aplikasi sampah kaga bisa login,5,5,aplikasi sampah tidak bisa login,5,5,"['aplikasi', 'sampah', 'tidak', 'bisa', 'login']","['aplikasi', 'sampah', 'tidak', 'login']",5,4,1,aplikasi sampah tidak login,4,4
"Aplikasi bagus, semoga bisa membantu",positif,2020-04-14,2020,aplikasi bagus semoga bisa membantu,5,5,aplikasi bagus semoga bisa membantu,5,5,"['aplikasi', 'bagus', 'semoga', 'bisa', 'membantu']","['aplikasi', 'bagus', 'semoga', 'membantu']",5,4,1,aplikasi bagus moga bantu,4,4
Terbantu dengan informasi yang terhubung dunia kerja,positif,2020-11-26,2020,terbantu dengan informasi yang terhubung dunia kerja,7,7,membantu dengan informasi yang terhubung dunia kerja,7,7,"['membantu', 'dengan', 'informasi', 'yang', 'terhubung', 'dunia', 'kerja']","['membantu', 'informasi', 'terhubung', 'dunia', 'kerja']",7,5,2,bantu informasi hubung dunia kerja,5,5
Sangat bagus untuk mencari kerja,positif,2022-08-16,2022,sangat bagus untuk mencari kerja,5,5,sangat bagus untuk mencari kerja,5,5,"['sangat', 'bagus', 'untuk', 'mencari', 'kerja']","['bagus', 'mencari', 'kerja']",5,3,2,bagus cari kerja,3,3
Bagus unutuk mencari kerja,positif,2021-12-15,2021,bagus unutuk mencari kerja,4,4,bagus unutuk mencari kerja,4,4,"['bagus', 'unutuk', 'mencari', 'kerja']","['bagus', 'unutuk', 'mencari', 'kerja']",4,4,0,bagus unutuk cari kerja,4,4
Apk gk jelas di bolak balik mlu gak msuk msuk.. Gak rido di download gak usah bkin apk,negatif,2022-10-20,2022,apk gk jelas di bolak balik mlu gak msuk msuk gak rido di download gak usah bkin apk,18,18,aplikasi tidak jelas di bolak balik mlu tidak msuk msuk tidak rido di unduh tidak usah bkin aplikasi,18,18,"['aplikasi', 'tidak', 'jelas', 'di', 'bolak', 'balik', 'mlu', 'tidak', 'msuk', 'msuk', 'tidak', 'rido', 'di', 'unduh', 'tidak', 'usah', 'bkin', 'aplikasi']","['aplikasi', 'tidak', 'bolak', 'mlu', 'tidak', 'msuk', 'msuk', 'tidak', 'rido', 'unduh', 'tidak', 'bkin', 'aplikasi']",18,13,5,aplikasi tidak bolak mlu tidak msuk msuk tidak rido unduh tidak bkin aplikasi,13,13
Aplikasi yang paling mengesalkan yg pernah ada.,negatif,2022-05-31,2022,aplikasi yang paling mengesalkan yg pernah ada,7,7,aplikasi yang paling mengesalkan yang pernah ada,7,7,"['aplikasi', 'yang', 'paling', 'mengesalkan', 'yang', 'pernah', 'ada']","['aplikasi', 'mengesalkan']",7,2,5,aplikasi kesal,2,2
Keren.. banyak dpt relasi dan pengetahuan bisnis.. 👍👍👍,positif,2023-12-29,2023,keren banyak dpt relasi dan pengetahuan bisnis,8,7,keren banyak dapat relasi dan pengetahuan bisnis,7,7,"['keren', 'banyak', 'dapat', 'relasi', 'dan', 'pengetahuan', 'bisnis']","['keren', 'relasi', 'pengetahuan', 'bisnis']",7,4,3,keren relasi tahu bisnis,4,4
APLIKASI AUTENTIFIKASI APA?? NOMOR VERIFIKASINYA MANA?? APAA SIHH. GA JELAS BANGET,negatif,2023-05-30,2023,aplikasi autentifikasi apa nomor verifikasinya mana apaa sihh ga jelas banget,11,11,aplikasi autentifikasi apa nomor verifikasinya mana apaa sih tidak jelas banget,11,11,"['aplikasi', 'autentifikasi', 'apa', 'nomor', 'verifikasinya', 'mana', 'apaa', 'sih', 'tidak', 'jelas', 'banget']","['aplikasi', 'autentifikasi', 'nomor', 'verifikasinya', 'apaa', 'sih', 'tidak', 'banget']",11,8,3,aplikasi autentifikasi nomor verifikasi apaa sih tidak banget,8,8
Cukup bagus dan efektif,positif,2021-08-07,2021,cukup bagus dan efektif,4,4,cukup bagus dan efektif,4,4,"['cukup', 'bagus', 'dan', 'efektif']","['bagus', 'efektif']",4,2,2,bagus efektif,2,2
saya menyampaikan terima kasih bayak buat linkedln yang teleh memberikan ke aman nah sempurna,positif,2020-04-18,2020,saya menyampaikan terima kasih bayak buat linkedln yang teleh memberikan ke aman nah sempurna,14,14,saya menyampaikan terima kasih banyak buat linkedln yang teleh memberikan ke aman nah sempurna,14,14,"['saya', 'menyampaikan', 'terima', 'kasih', 'banyak', 'buat', 'linkedln', 'yang', 'teleh', 'memberikan', 'ke', 'aman', 'nah', 'sempurna']","['terima', 'kasih', 'linkedln', 'teleh', 'aman', 'sempurna']",14,6,8,terima kasih linkedln teh aman sempurna,6,6
Aplikasi gak bergunaaa. Gak bisa daftar selalu gagal terus,negatif,2024-01-01,2024,aplikasi gak bergunaaa gak bisa daftar selalu gagal terus,9,9,aplikasi tidak bergunaaa tidak bisa daftar selalu gagal terus,9,9,"['aplikasi', 'tidak', 'bergunaaa', 'tidak', 'bisa', 'daftar', 'selalu', 'gagal', 'terus']","['aplikasi', 'tidak', 'bergunaaa', 'tidak', 'daftar', 'gagal']",9,6,3,aplikasi tidak bergunaaa tidak daftar gagal,6,6
Tahik EMG. Verifikasinya gak jelas,negatif,2024-06-07,2024,tahik emg verifikasinya gak jelas,5,5,tahik memang verifikasinya tidak jelas,5,5,"['tahik', 'memang', 'verifikasinya', 'tidak', 'jelas']","['tahik', 'verifikasinya', 'tidak']",5,3,2,tahik verifikasi tidak,3,3
coba buktikan yang baik aplikasi ini bisa semua rakyat indonesia bekerja..tidak hidup untuk nganggur..😏,positif,2020-09-22,2020,coba buktikan yang baik aplikasi ini bisa semua rakyat indonesia bekerja tidak hidup untuk nganggur,14,15,coba buktikan yang baik aplikasi ini bisa semua rakyat indonesia bekerja tidak hidup untuk nganggur,15,15,"['coba', 'buktikan', 'yang', 'baik', 'aplikasi', 'ini', 'bisa', 'semua', 'rakyat', 'indonesia', 'bekerja', 'tidak', 'hidup', 'untuk', 'nganggur']","['coba', 'buktikan', 'aplikasi', 'rakyat', 'indonesia', 'tidak', 'hidup', 'nganggur']",15,8,7,coba bukti aplikasi rakyat indonesia tidak hidup nganggur,8,8
iklan kamu di apk lain ganggu bgt. LAGIAN APLIKASI JELEK MASIH AJA ADA YG INSTAL. ISINYA CUMA ORANG2 SOMBONG PAMER KERJaan doang,negatif,2024-06-16,2024,iklan kamu di apk lain ganggu bgt lagian aplikasi jelek masih aja ada yg instal isinya cuma orang sombong pamer kerjaan doang,22,22,iklan kamu di aplikasi lain ganggu banget lagian aplikasi jelek masih saja ada yang memasang isinya cuma orang sombong pamer kerjaan saja,22,22,"['iklan', 'kamu', 'di', 'aplikasi', 'lain', 'ganggu', 'banget', 'lagian', 'aplikasi', 'jelek', 'masih', 'saja', 'ada', 'yang', 'memasang', 'isinya', 'cuma', 'orang', 'sombong', 'pamer', 'kerjaan', 'saja']","['iklan', 'aplikasi', 'ganggu', 'banget', 'aplikasi', 'jelek', 'memasang', 'isinya', 'orang', 'sombong', 'pamer', 'kerjaan']",22,12,10,iklan aplikasi ganggu banget aplikasi jelek pasang isi orang sombong pamer kerja,12,12
Informasi terkait dunia industri atau dunia usaha lebih mudah didapatkan !!!,positif,2020-04-16,2020,informasi terkait dunia industri atau dunia usaha lebih mudah didapatkan,11,10,informasi terkait dunia industri atau dunia usaha lebih mudah didapatkan,10,10,"['informasi', 'terkait', 'dunia', 'industri', 'atau', 'dunia', 'usaha', 'lebih', 'mudah', 'didapatkan']","['informasi', 'terkait', 'dunia', 'industri', 'dunia', 'usaha', 'mudah', 'didapatkan']",10,8,2,informasi kait dunia industri dunia usaha mudah dapat,8,8
Trimks telah memberikan banyak impormasi tentang pekerjaan,positif,2021-08-06,2021,trimks telah memberikan banyak impormasi tentang pekerjaan,7,7,trimks telah memberikan banyak impormasi tentang pekerjaan,7,7,"['trimks', 'telah', 'memberikan', 'banyak', 'impormasi', 'tentang', 'pekerjaan']","['trimks', 'impormasi', 'pekerjaan']",7,3,4,trimks impormasi kerja,3,3
Abal Abal... Verifikasi pilih gambar ga pernah betul. Cumi kuras kuota saja,negatif,2023-01-30,2023,abal abal verifikasi pilih gambar ga pernah betul cumi kuras kuota saja,12,12,abal abal verifikasi pilih gambar tidak pernah betul cumi kuras kuota saja,12,12,"['abal', 'abal', 'verifikasi', 'pilih', 'gambar', 'tidak', 'pernah', 'betul', 'cumi', 'kuras', 'kuota', 'saja']","['abal', 'abal', 'verifikasi', 'pilih', 'gambar', 'tidak', 'cumi', 'kuras', 'kuota']",12,9,3,abal abal verifikasi pilih gambar tidak cumi kuras kuota,9,9
Kenapa gak bis adi uninstal ya,negatif,2020-02-29,2020,kenapa gak bis adi uninstal ya,6,6,kenapa tidak bis adi hapus instalan ya,6,7,"['kenapa', 'tidak', 'bis', 'adi', 'hapus', 'instalan', 'ya']","['tidak', 'bis', 'adi', 'hapus', 'instalan', 'ya']",7,6,1,tidak bis adi hapus instalan ya,6,6
Sangat mmuaskan. Saya menjalankan pekerjaan skrg. Krna aplikasi ini. Saya menemukan pkerjaan saya disini. Terima kasih Linkedin,positif,2021-11-24,2021,sangat mmuaskan saya menjalankan pekerjaan skrg krna aplikasi ini saya menemukan pkerjaan saya disini terima kasih linkedin,17,17,sangat mmuaskan saya menjalankan pekerjaan sekarang karena aplikasi ini saya menemukan pkerjaan saya disini terima kasih linkedin,17,17,"['sangat', 'mmuaskan', 'saya', 'menjalankan', 'pekerjaan', 'sekarang', 'karena', 'aplikasi', 'ini', 'saya', 'menemukan', 'pkerjaan', 'saya', 'disini', 'terima', 'kasih', 'linkedin']","['mmuaskan', 'menjalankan', 'pekerjaan', 'aplikasi', 'menemukan', 'pkerjaan', 'terima', 'kasih', 'linkedin']",17,9,8,mmuaskan jalan kerja aplikasi temu pkerjaan terima kasih linkedin,9,9
Sangat membantu sekali untuk mencari teman lama,positif,2021-11-23,2021,sangat membantu sekali untuk mencari teman lama,7,7,sangat membantu sekali untuk mencari teman lama,7,7,"['sangat', 'membantu', 'sekali', 'untuk', 'mencari', 'teman', 'lama']","['membantu', 'mencari', 'teman']",7,3,4,bantu cari teman,3,3
Mempunyai banyak manfaat dalam mencari pekerjaan,positif,2022-06-11,2022,mempunyai banyak manfaat dalam mencari pekerjaan,6,6,mempunyai banyak manfaat dalam mencari pekerjaan,6,6,"['mempunyai', 'banyak', 'manfaat', 'dalam', 'mencari', 'pekerjaan']","['manfaat', 'mencari', 'pekerjaan']",6,3,3,manfaat cari kerja,3,3
Sangat berguna untuk profesional seperti saya,positif,2021-09-10,2021,sangat berguna untuk profesional seperti saya,6,6,sangat berguna untuk profesional seperti saya,6,6,"['sangat', 'berguna', 'untuk', 'profesional', 'seperti', 'saya']","['berguna', 'profesional']",6,2,4,guna profesional,2,2
Aplikasi BUSUK........login ga bisa kebuka2.......jgn donlod nyesel,negatif,2023-11-25,2023,aplikasi busuk login ga bisa kebuka jgn donlod nyesel,7,9,aplikasi busuk login tidak bisa kebuka jangan download menyesal,9,9,"['aplikasi', 'busuk', 'login', 'tidak', 'bisa', 'kebuka', 'jangan', 'download', 'menyesal']","['aplikasi', 'busuk', 'login', 'tidak', 'kebuka', 'download', 'menyesal']",9,7,2,aplikasi busuk login tidak buka download sesal,7,7
Bagus utk cari pekerjaan dan bekerja dimana,positif,2021-07-10,2021,bagus utk cari pekerjaan dan bekerja dimana,7,7,bagus untuk cari pekerjaan dan bekerja dimana,7,7,"['bagus', 'untuk', 'cari', 'pekerjaan', 'dan', 'bekerja', 'dimana']","['bagus', 'cari', 'pekerjaan', 'dimana']",7,4,3,bagus cari kerja mana,4,4
aplikasi gajelas daftar aja susah,negatif,2023-12-10,2023,aplikasi gajelas daftar aja susah,5,5,aplikasi tidak jelas daftar saja susah,5,6,"['aplikasi', 'tidak', 'jelas', 'daftar', 'saja', 'susah']","['aplikasi', 'tidak', 'daftar', 'susah']",6,4,2,aplikasi tidak daftar susah,4,4
Ribet mau daftar kode udah bener malah ga masuk masuk,negatif,2020-12-14,2020,ribet mau daftar kode udah bener malah ga masuk masuk,10,10,rumit mau daftar kode sudah benar bahkan tidak masuk masuk,10,10,"['rumit', 'mau', 'daftar', 'kode', 'sudah', 'benar', 'bahkan', 'tidak', 'masuk', 'masuk']","['rumit', 'daftar', 'kode', 'tidak', 'masuk', 'masuk']",10,6,4,rumit daftar kode tidak masuk masuk,6,6
"Sangat membantu dalam mencari informasi lowongan pekerjaan,dan pihak perusahaan sendiri terkadang langsung menghubungi kita tanpa harus melamar pekerjaan",positif,2024-01-16,2024,sangat membantu dalam mencari informasi lowongan pekerjaan dan pihak perusahaan sendiri terkadang langsung menghubungi kita tanpa harus melamar pekerjaan,18,19,sangat membantu dalam mencari informasi lowongan pekerjaan dan pihak perusahaan sendiri terkadang langsung menghubungi kita tanpa harus melamar pekerjaan,19,19,"['sangat', 'membantu', 'dalam', 'mencari', 'informasi', 'lowongan', 'pekerjaan', 'dan', 'pihak', 'perusahaan', 'sendiri', 'terkadang', 'langsung', 'menghubungi', 'kita', 'tanpa', 'harus', 'melamar', 'pekerjaan']","['membantu', 'mencari', 'informasi', 'lowongan', 'pekerjaan', 'perusahaan', 'terkadang', 'langsung', 'menghubungi', 'melamar', 'pekerjaan']",19,11,8,bantu cari informasi lowong kerja usaha terkadang langsung hubung lamar kerja,11,11
Mantap melancarkan bisnis kami bisa lengan cepat terhubung dengan tim kami inviter kami.,positif,2024-02-02,2024,mantap melancarkan bisnis kami bisa lengan cepat terhubung dengan tim kami inviter kami,13,13,mantap melancarkan bisnis kami bisa lengan cepat terhubung dengan tim kami inviter kami,13,13,"['mantap', 'melancarkan', 'bisnis', 'kami', 'bisa', 'lengan', 'cepat', 'terhubung', 'dengan', 'tim', 'kami', 'inviter', 'kami']","['mantap', 'melancarkan', 'bisnis', 'lengan', 'cepat', 'terhubung', 'tim', 'inviter']",13,8,5,mantap lancar bisnis lengan cepat hubung tim inviter,8,8
"Assalamualaikum perkenalkan saya fajar kakak mau' tnyk nih kenapa LinkedIn saya harus kakak' blokir ya. Saya tidak pernah buat yang aneh"" kok di LinkedIn nya.🥹",negatif,2024-03-03,2024,assalamualaikum perkenalkan saya fajar kakak mau tnyk nih kenapa linkedin saya harus kakak blokir ya saya tidak pernah buat yang aneh kok di linkedin nya,25,25,assalamualaikum perkenalkan saya fajar kakak mau tnyk nih kenapa linkedin saya harus kakak blokir ya saya tidak pernah buat yang aneh kok di linkedin nya,25,25,"['assalamualaikum', 'perkenalkan', 'saya', 'fajar', 'kakak', 'mau', 'tnyk', 'nih', 'kenapa', 'linkedin', 'saya', 'harus', 'kakak', 'blokir', 'ya', 'saya', 'tidak', 'pernah', 'buat', 'yang', 'aneh', 'kok', 'di', 'linkedin', 'nya']","['assalamualaikum', 'perkenalkan', 'fajar', 'kakak', 'tnyk', 'nih', 'linkedin', 'kakak', 'blokir', 'ya', 'tidak', 'aneh', 'linkedin', 'nya']",25,14,11,assalamualaikum kenal fajar kakak tnyk nih linkedin kakak blokir ya tidak aneh linkedin nya,14,14
Kenapa nih tiba gak bisa di login _-,negatif,2023-07-13,2023,kenapa nih tiba gak bisa di login,8,7,kenapa nih tiba tidak bisa di login,7,7,"['kenapa', 'nih', 'tiba', 'tidak', 'bisa', 'di', 'login']","['nih', 'tidak', 'login']",7,3,4,nih tidak login,3,3
Alhamdulillah. suami dapat kerja dari aplikasi LinkedIn ini.,positif,2022-06-08,2022,alhamdulillah suami dapat kerja dari aplikasi linkedin ini,8,8,alhamdulillah suami dapat kerja dari aplikasi linkedin ini,8,8,"['alhamdulillah', 'suami', 'dapat', 'kerja', 'dari', 'aplikasi', 'linkedin', 'ini']","['alhamdulillah', 'suami', 'kerja', 'aplikasi', 'linkedin']",8,5,3,alhamdulillah suami kerja aplikasi linkedin,5,5
Amin 🙏Semoga GG tetap melayani publik secara ikhlas d bermutu.,positif,2024-06-13,2024,amin semoga gg tetap melayani publik secara ikhlas d bermutu,10,10,aamiin semoga gg tetap melayani publik secara ikhlas di bermutu,10,10,"['aamiin', 'semoga', 'gg', 'tetap', 'melayani', 'publik', 'secara', 'ikhlas', 'di', 'bermutu']","['aamiin', 'semoga', 'gg', 'melayani', 'publik', 'ikhlas', 'bermutu']",10,7,3,aamiin moga gg layan publik ikhlas mutu,7,7
Sosmed yang diperuntukkan untuk profesional dalam dunia kerja,positif,2023-09-05,2023,sosmed yang diperuntukkan untuk profesional dalam dunia kerja,8,8,sosmed yang diperuntukkan untuk profesional dalam dunia kerja,8,8,"['sosmed', 'yang', 'diperuntukkan', 'untuk', 'profesional', 'dalam', 'dunia', 'kerja']","['sosmed', 'diperuntukkan', 'profesional', 'dunia', 'kerja']",8,5,3,sosmed untuk profesional dunia kerja,5,5
"Punya app ini,banyak pengalaman penting yg saya dapatkan.",positif,2020-11-05,2020,punya app ini banyak pengalaman penting yg saya dapatkan,8,9,punya aplikasi ini banyak pengalaman penting yang saya dapatkan,9,9,"['punya', 'aplikasi', 'ini', 'banyak', 'pengalaman', 'penting', 'yang', 'saya', 'dapatkan']","['aplikasi', 'pengalaman', 'dapatkan']",9,3,6,aplikasi alam dapat,3,3
Bantu saya dalam segalahal menMbah ilmu...pengetahun serta kreatifitas,positif,2021-08-28,2021,bantu saya dalam segalahal menmbah ilmu pengetahun serta kreatifitas,8,9,bantu saya dalam segalahal menmbah ilmu pengetahun serta kreatifitas,9,9,"['bantu', 'saya', 'dalam', 'segalahal', 'menmbah', 'ilmu', 'pengetahun', 'serta', 'kreatifitas']","['bantu', 'segalahal', 'menmbah', 'ilmu', 'pengetahun', 'kreatifitas']",9,6,3,bantu segalahal menmbah ilmu tahun kreatifitas,6,6
Membuat mudah komunikasi,positif,2022-07-22,2022,membuat mudah komunikasi,3,3,membuat mudah komunikasi,3,3,"['membuat', 'mudah', 'komunikasi']","['mudah', 'komunikasi']",3,2,1,mudah komunikasi,2,2
"Saldo saya dipotong sama link id tanpa persetujuan,jngn instal ini",negatif,2021-11-25,2021,saldo saya dipotong sama link id tanpa persetujuan jngn instal ini,10,11,saldo saya dipotong sama link id tanpa persetujuan jangan memasang ini,11,11,"['saldo', 'saya', 'dipotong', 'sama', 'link', 'id', 'tanpa', 'persetujuan', 'jangan', 'memasang', 'ini']","['saldo', 'dipotong', 'link', 'id', 'persetujuan', 'memasang']",11,6,5,saldo potong link id tuju pasang,6,6
"Gak sengaja kepencet reject, tapi ribet gabisa ngirim balik",negatif,2023-10-15,2023,gak sengaja kepencet reject tapi ribet gabisa ngirim balik,9,9,tidak sengaja kepencet reject tapi rumit tidak bisa mengirim balik,9,10,"['tidak', 'sengaja', 'kepencet', 'reject', 'tapi', 'rumit', 'tidak', 'bisa', 'mengirim', 'balik']","['tidak', 'sengaja', 'kepencet', 'reject', 'rumit', 'tidak', 'mengirim']",10,7,3,tidak sengaja pencet reject rumit tidak kirim,7,7
Membantu dalam informasi pekerjaan,positif,2022-01-03,2022,membantu dalam informasi pekerjaan,4,4,membantu dalam informasi pekerjaan,4,4,"['membantu', 'dalam', 'informasi', 'pekerjaan']","['membantu', 'informasi', 'pekerjaan']",4,3,1,bantu informasi kerja,3,3
Aplikasi goblokkk verifikasi bener malah salah terus,negatif,2023-01-10,2023,aplikasi goblokkk verifikasi bener malah salah terus,7,7,aplikasi goblokkk verifikasi benar bahkan salah terus,7,7,"['aplikasi', 'goblokkk', 'verifikasi', 'benar', 'bahkan', 'salah', 'terus']","['aplikasi', 'goblokkk', 'verifikasi', 'salah']",7,4,3,aplikasi goblokkk verifikasi salah,4,4
Semoga bermanfaat,positif,2024-07-26,2024,semoga bermanfaat,2,2,semoga bermanfaat,2,2,"['semoga', 'bermanfaat']","['semoga', 'bermanfaat']",2,2,0,moga manfaat,2,2
Lebih tertolong,positif,2024-06-22,2024,lebih tertolong,2,2,lebih tertolong,2,2,"['lebih', 'tertolong']",['tertolong'],2,1,1,tolong,1,1
Bagus sekali,positif,2024-06-25,2024,bagus sekali,2,2,bagus sekali,2,2,"['bagus', 'sekali']",['bagus'],2,1,1,bagus,1,1
"Asyuu, verifikasi lama bgt. Malah balik lagi yg udah",negatif,2023-08-23,2023,asyuu verifikasi lama bgt malah balik lagi yg udah,9,9,asyuu verifikasi lama banget bahkan balik lagi yang sudah,9,9,"['asyuu', 'verifikasi', 'lama', 'banget', 'bahkan', 'balik', 'lagi', 'yang', 'sudah']","['asyuu', 'verifikasi', 'banget']",9,3,6,asyuu verifikasi banget,3,3
"TOLONG SAYA TIDAK BISA DAFTAR AKUN, PLEASE🙏",negatif,2022-05-13,2022,tolong saya tidak bisa daftar akun please,7,7,tolong saya tidak bisa daftar akun please,7,7,"['tolong', 'saya', 'tidak', 'bisa', 'daftar', 'akun', 'please']","['tolong', 'tidak', 'daftar', 'akun', 'please']",7,5,2,tolong tidak daftar akun please,5,5
Sangat bermanfaat bagi pencari kerja.,positif,2022-05-19,2022,sangat bermanfaat bagi pencari kerja,5,5,sangat bermanfaat bagi pencari kerja,5,5,"['sangat', 'bermanfaat', 'bagi', 'pencari', 'kerja']","['bermanfaat', 'pencari', 'kerja']",5,3,2,manfaat cari kerja,3,3
Sangat mudah dan membantu,positif,2020-06-25,2020,sangat mudah dan membantu,4,4,sangat mudah dan membantu,4,4,"['sangat', 'mudah', 'dan', 'membantu']","['mudah', 'membantu']",4,2,2,mudah bantu,2,2
sulit banget masuknya,negatif,2024-08-18,2024,sulit banget masuknya,3,3,sulit banget masuknya,3,3,"['sulit', 'banget', 'masuknya']","['sulit', 'banget', 'masuknya']",3,3,0,sulit banget masuk,3,3
Aplikasi Linkedin membantu saya mendapatkan kandidat2 untuk Team saya.,positif,2023-11-21,2023,aplikasi linkedin membantu saya mendapatkan kandidat untuk team saya,9,9,aplikasi linkedin membantu saya mendapatkan kandidat untuk team saya,9,9,"['aplikasi', 'linkedin', 'membantu', 'saya', 'mendapatkan', 'kandidat', 'untuk', 'team', 'saya']","['aplikasi', 'linkedin', 'membantu', 'kandidat', 'team']",9,5,4,aplikasi linkedin bantu kandidat team,5,5
Sangat membantu untuk memperbanyak silaturahmi,positif,2020-09-02,2020,sangat membantu untuk memperbanyak silaturahmi,5,5,sangat membantu untuk memperbanyak silaturahmi,5,5,"['sangat', 'membantu', 'untuk', 'memperbanyak', 'silaturahmi']","['membantu', 'memperbanyak', 'silaturahmi']",5,3,2,bantu banyak silaturahmi,3,3
ini gak bisaa di unistall dn tiba² ke download sendriii😑,negatif,2020-05-19,2020,ini gak bisaa di unistall dn tiba² ke download sendriii,10,10,ini tidak bisaa di hapus instalan dan tiba² ke unduh sendriii,10,11,"['ini', 'tidak', 'bisaa', 'di', 'hapus', 'instalan', 'dan', 'tiba²', 'ke', 'unduh', 'sendriii']","['tidak', 'bisaa', 'hapus', 'instalan', 'tiba²', 'unduh', 'sendriii']",11,7,4,tidak bisaa hapus instalan tiba unduh sendriii,7,7
Lumayan bagus untuk para pekerja,positif,2024-02-04,2024,lumayan bagus untuk para pekerja,5,5,lumayan bagus untuk para yang kerja,5,6,"['lumayan', 'bagus', 'untuk', 'para', 'yang', 'kerja']","['lumayan', 'bagus', 'kerja']",6,3,3,lumayan bagus kerja,3,3
"LinkedIn. Sangat Bagus, Kembangkan Lagi Ya 😊.",positif,2021-05-25,2021,linkedin sangat bagus kembangkan lagi ya,7,6,linkedin sangat bagus kembangkan lagi ya,6,6,"['linkedin', 'sangat', 'bagus', 'kembangkan', 'lagi', 'ya']","['linkedin', 'bagus', 'kembangkan', 'ya']",6,4,2,linkedin bagus kembang ya,4,4
katanya trial gratis masa suruh bayar.....tai,negatif,2021-05-11,2021,katanya trial gratis masa suruh bayar tai,6,7,katanya trial gratis masa suruh bayar tai,7,7,"['katanya', 'trial', 'gratis', 'masa', 'suruh', 'bayar', 'tai']","['trial', 'gratis', 'suruh', 'bayar', 'tai']",7,5,2,trial gratis suruh bayar tai,5,5
Agar dipermudah untuk accesnya,positif,2020-01-16,2020,agar dipermudah untuk accesnya,4,4,agar dipermudah untuk accesnya,4,4,"['agar', 'dipermudah', 'untuk', 'accesnya']","['dipermudah', 'accesnya']",4,2,2,mudah accesnya,2,2
"Sangat membantu, nambah relasi",positif,2022-07-25,2022,sangat membantu nambah relasi,4,4,sangat membantu nambah relasi,4,4,"['sangat', 'membantu', 'nambah', 'relasi']","['membantu', 'nambah', 'relasi']",4,3,1,bantu nambah relasi,3,3
Selamat semoga semakin banyak orang di indonesia menjadi lebih mudah untuk mendapatkan hasil maksimal dari berbagai sumber.😎😃😃😄🌹🌹🍇🍈🍎🥂☕,positif,2021-01-10,2021,selamat semoga semakin banyak orang di indonesia menjadi lebih mudah untuk mendapatkan hasil maksimal dari berbagai sumber,17,17,selamat semoga semakin banyak orang di indonesia menjadi lebih mudah untuk mendapatkan hasil maksimal dari berbagai sumber,17,17,"['selamat', 'semoga', 'semakin', 'banyak', 'orang', 'di', 'indonesia', 'menjadi', 'lebih', 'mudah', 'untuk', 'mendapatkan', 'hasil', 'maksimal', 'dari', 'berbagai', 'sumber']","['selamat', 'semoga', 'orang', 'indonesia', 'mudah', 'hasil', 'maksimal', 'sumber']",17,8,9,selamat moga orang indonesia mudah hasil maksimal sumber,8,8
"Mantap..... selamat Pagi rekan-rekan perkenalkan saya HANAN DARMAWAN Barangkali rekan-rekan Membutuhkan Jasa Penerbit jaminan BANK GARANSI (BG) & SURETY BOND(Asuransi) proyek bos, procedur Tanpa cash Collateral. adapun jenis BG & SB : ✓Jaminan Penawaran / Bid ( Tender) Bond. ✓ Jaminan Pelaksanaan / Performance Bond. ✓ Jaminan Uang Muka/Advance Payment ✓ Jaminan Pemeliharaan / Maintenance Bond. ✓ Jaminan Pembayaran / Paymen Bond ✓ **SP2D jaminan Pembayaran Akhir Tahun.* ✓ Asuransi/Surety",positif,2020-10-27,2020,mantap selamat pagi rekan rekan perkenalkan saya hanan darmawan barangkali rekan rekan membutuhkan jasa penerbit jaminan bank garansi bg surety bond asuransi proyek bos procedur tanpa cash collateral adapun jenis bg sb jaminan penawaran bid tender bond jaminan pelaksanaan performance bond jaminan uang muka advance payment jaminan pemeliharaan maintenance bond jaminan pembayaran paymen bond sp d jaminan pembayaran akhir tahun asuransi surety,70,62,mantap selamat pagi rekan rekan perkenalkan saya hanan darmawan barangkali rekan rekan membutuhkan jasa penerbit jaminan bank garansi bg surety bond asuransi proyek box procedur tanpa tunai collateral adapun jenis bg sayurbox jaminan penawaran bid tender bond jaminan pelaksanaan performance bond jaminan uang muka advance payment jaminan pemeliharaan maintenance bond jaminan pembayaran paymen bond sp di jaminan pembayaran akhir tahun asuransi surety,62,62,"['mantap', 'selamat', 'pagi', 'rekan', 'rekan', 'perkenalkan', 'saya', 'hanan', 'darmawan', 'barangkali', 'rekan', 'rekan', 'membutuhkan', 'jasa', 'penerbit', 'jaminan', 'bank', 'garansi', 'bg', 'surety', 'bond', 'asuransi', 'proyek', 'box', 'procedur', 'tanpa', 'tunai', 'collateral', 'adapun', 'jenis', 'bg', 'sayurbox', 'jaminan', 'penawaran', 'bid', 'tender', 'bond', 'jaminan', 'pelaksanaan', 'performance', 'bond', 'jaminan', 'uang', 'muka', 'advance', 'payment', 'jaminan', 'pemeliharaan', 'maintenance', 'bond', 'jaminan', 'pembayaran', 'paymen', 'bond', 'sp', 'di', 'jaminan', 'pembayaran', 'akhir', 'tahun', 'asuransi', 'surety']","['mantap', 'selamat', 'pagi', 'rekan', 'rekan', 'perkenalkan', 'hanan', 'darmawan', 'barangkali', 'rekan', 'rekan', 'membutuhkan', 'jasa', 'penerbit', 'jaminan', 'bank', 'garansi', 'bg', 'surety', 'bond', 'asuransi', 'proyek', 'box', 'procedur', 'tunai', 'collateral', 'jenis', 'bg', 'sayurbox', 'jaminan', 'penawaran', 'bid', 'tender', 'bond', 'jaminan', 'pelaksanaan', 'performance', 'bond', 'jaminan', 'uang', 'muka', 'advance', 'payment', 'jaminan', 'pemeliharaan', 'maintenance', 'bond', 'jaminan', 'pembayaran', 'paymen', 'bond', 'sp', 'jaminan', 'pembayaran', 'asuransi', 'surety']",62,56,6,mantap selamat pagi rekan rekan kenal hanan darmawan barangkali rekan rekan butuh jasa terbit jamin bank garansi bg surety bond asuransi proyek box procedur tunai collateral jenis bg sayurbox jamin tawar bid tender bond jamin laksana performance bond jamin uang muka advance payment jamin pelihara maintenance bond jamin bayar paymen bond sp jamin bayar asuransi surety,56,56
Sangat membantu sekali... 10 bintang untuk linkedin,positif,2021-08-20,2021,sangat membantu sekali bintang untuk linkedin,7,6,sangat membantu sekali bintang untuk linkedin,6,6,"['sangat', 'membantu', 'sekali', 'bintang', 'untuk', 'linkedin']","['membantu', 'bintang', 'linkedin']",6,3,3,bantu bintang linkedin,3,3
Baik untuk aplikasi internal,positif,2021-12-08,2021,baik untuk aplikasi internal,4,4,baik untuk aplikasi internal,4,4,"['baik', 'untuk', 'aplikasi', 'internal']","['aplikasi', 'internal']",4,2,2,aplikasi internal,2,2
"Keren, akun profesionalitas.",positif,2022-10-17,2022,keren akun profesionalitas,3,3,keren akun profesionalitas,3,3,"['keren', 'akun', 'profesionalitas']","['keren', 'akun', 'profesionalitas']",3,3,0,keren akun profesionalitas,3,3
Gabisa ganti foto sama sekali!,negatif,2021-01-20,2021,gabisa ganti foto sama sekali,5,5,tidak bisa ganti foto sama sekali,5,6,"['tidak', 'bisa', 'ganti', 'foto', 'sama', 'sekali']","['tidak', 'ganti', 'foto']",6,3,3,tidak ganti foto,3,3
"Aplikasi luar biasa, terima kasih LinkedIn",positif,2021-12-21,2021,aplikasi luar biasa terima kasih linkedin,6,6,aplikasi luar biasa terima kasih linkedin,6,6,"['aplikasi', 'luar', 'biasa', 'terima', 'kasih', 'linkedin']","['aplikasi', 'terima', 'kasih', 'linkedin']",6,4,2,aplikasi terima kasih linkedin,4,4
Mudahan mudahan BS bermanfaat buat kita semua,positif,2021-07-08,2021,mudahan mudahan bs bermanfaat buat kita semua,7,7,mudahan mudahan bisa bermanfaat buat kita semua,7,7,"['mudahan', 'mudahan', 'bisa', 'bermanfaat', 'buat', 'kita', 'semua']","['mudahan', 'mudahan', 'bermanfaat']",7,3,4,mudah mudah manfaat,3,3
Sangat membantu. Terima kasih banyak linked in,positif,2022-08-31,2022,sangat membantu terima kasih banyak linked in,7,7,sangat membantu terima kasih banyak linked in,7,7,"['sangat', 'membantu', 'terima', 'kasih', 'banyak', 'linked', 'in']","['membantu', 'terima', 'kasih', 'linked', 'in']",7,5,2,bantu terima kasih linked in,5,5
Cukup membantu infonya...,positif,2024-08-24,2024,cukup membantu infonya,3,3,cukup membantu informasinya,3,3,"['cukup', 'membantu', 'informasinya']","['membantu', 'informasinya']",3,2,1,bantu informasi,2,2
Login gagal verifikasi gagal terus,negatif,2024-02-07,2024,login gagal verifikasi gagal terus,5,5,login gagal verifikasi gagal terus,5,5,"['login', 'gagal', 'verifikasi', 'gagal', 'terus']","['login', 'gagal', 'verifikasi', 'gagal']",5,4,1,login gagal verifikasi gagal,4,4
Mau masuk aja susah kaya akun bank aja terpaksa uninstall lagi,negatif,2023-09-27,2023,mau masuk aja susah kaya akun bank aja terpaksa uninstall lagi,11,11,mau masuk saja susah kayak akun bank saja terpaksa uninstall lagi,11,11,"['mau', 'masuk', 'saja', 'susah', 'kayak', 'akun', 'bank', 'saja', 'terpaksa', 'uninstall', 'lagi']","['masuk', 'susah', 'kayak', 'akun', 'bank', 'terpaksa', 'uninstall']",11,7,4,masuk susah kayak akun bank paksa uninstall,7,7
Mantap terus maju dan berkembang,positif,2020-06-29,2020,mantap terus maju dan berkembang,5,5,mantap terus maju dan berkembang,5,5,"['mantap', 'terus', 'maju', 'dan', 'berkembang']","['mantap', 'maju', 'berkembang']",5,3,2,mantap maju kembang,3,3
"CONTOH² APLIKASI RUSAK!JANGN DI INSTAL YH TEMAN², DIA HANYA MENCARI UNTUNG DARI KALIAN.",negatif,2024-06-23,2024,contoh² aplikasi rusak jangn di instal yh teman² dia hanya mencari untung dari kalian,13,14,contoh² aplikasi rusak jangn di memasang ya teman² dia hanya mencari untung dari kalian,14,14,"['contoh²', 'aplikasi', 'rusak', 'jangn', 'di', 'memasang', 'ya', 'teman²', 'dia', 'hanya', 'mencari', 'untung', 'dari', 'kalian']","['contoh²', 'aplikasi', 'rusak', 'jangn', 'memasang', 'ya', 'teman²', 'mencari', 'untung']",14,9,5,contoh aplikasi rusak jangn pasang ya teman cari untung,9,9
"Alhamdulilah, sangat bermanfaat jika digunakan dengan bijak",positif,2023-11-28,2023,alhamdulilah sangat bermanfaat jika digunakan dengan bijak,7,7,alhamdulillah sangat bermanfaat jika digunakan dengan bijak,7,7,"['alhamdulillah', 'sangat', 'bermanfaat', 'jika', 'digunakan', 'dengan', 'bijak']","['alhamdulillah', 'bermanfaat', 'bijak']",7,3,4,alhamdulillah manfaat bijak,3,3
Aplikasi kocak akun gue di hack orang vietnam. Ganti nama sendiri sudah upload ktp akses ditolak bukan pemilik asli kocak,negatif,2023-07-30,2023,aplikasi kocak akun gue di hack orang vietnam ganti nama sendiri sudah upload ktp akses ditolak bukan pemilik asli kocak,20,20,aplikasi kocak akun saya di hack orang vietnam ganti nama sendiri sudah unggah ktp akses ditolak bukan pemilik asli kocak,20,20,"['aplikasi', 'kocak', 'akun', 'saya', 'di', 'hack', 'orang', 'vietnam', 'ganti', 'nama', 'sendiri', 'sudah', 'unggah', 'ktp', 'akses', 'ditolak', 'bukan', 'pemilik', 'asli', 'kocak']","['aplikasi', 'kocak', 'akun', 'hack', 'orang', 'vietnam', 'ganti', 'nama', 'unggah', 'ktp', 'akses', 'ditolak', 'pemilik', 'asli', 'kocak']",20,15,5,aplikasi kocak akun hack orang vietnam ganti nama unggah ktp akses tolak milik asli kocak,15,15
Membantu buat informasi kerja di perusahaan dan membantu oramg berkomunikasi di tempat kerja,positif,2021-07-31,2021,membantu buat informasi kerja di perusahaan dan membantu oramg berkomunikasi di tempat kerja,13,13,membantu buat informasi kerja di perusahaan dan membantu oramg berkomunikasi di tempat kerja,13,13,"['membantu', 'buat', 'informasi', 'kerja', 'di', 'perusahaan', 'dan', 'membantu', 'oramg', 'berkomunikasi', 'di', 'tempat', 'kerja']","['membantu', 'informasi', 'kerja', 'perusahaan', 'membantu', 'oramg', 'berkomunikasi', 'kerja']",13,8,5,bantu informasi kerja usaha bantu oramg komunikasi kerja,8,8
Sangat membantu buat cari relasi,positif,2021-12-28,2021,sangat membantu buat cari relasi,5,5,sangat membantu buat cari relasi,5,5,"['sangat', 'membantu', 'buat', 'cari', 'relasi']","['membantu', 'cari', 'relasi']",5,3,2,bantu cari relasi,3,3
Semoga bisa membantu orang2 untuk dapat pekerjaan sesuai passion dan wallet 🤑😎,positif,2020-07-27,2020,semoga bisa membantu orang untuk dapat pekerjaan sesuai passion dan wallet,12,11,semoga bisa membantu orang untuk dapat pekerjaan sesuai passion dan wallet,11,11,"['semoga', 'bisa', 'membantu', 'orang', 'untuk', 'dapat', 'pekerjaan', 'sesuai', 'passion', 'dan', 'wallet']","['semoga', 'membantu', 'orang', 'pekerjaan', 'sesuai', 'passion', 'wallet']",11,7,4,moga bantu orang kerja sesuai passion wallet,7,7
"Unistal aja, krna susah di verifikasinya",negatif,2024-07-17,2024,unistal aja krna susah di verifikasinya,6,6,unistal saja karena susah di verifikasinya,6,6,"['unistal', 'saja', 'karena', 'susah', 'di', 'verifikasinya']","['unistal', 'susah', 'verifikasinya']",6,3,3,unistal susah verifikasi,3,3
Mempermudah mencari kerja,positif,2022-06-04,2022,mempermudah mencari kerja,3,3,mempermudah mencari kerja,3,3,"['mempermudah', 'mencari', 'kerja']","['mempermudah', 'mencari', 'kerja']",3,3,0,mudah cari kerja,3,3
Akun saya tiba tiba hilang dan tidak bisa dibuka lagi,negatif,2023-02-14,2023,akun saya tiba tiba hilang dan tidak bisa dibuka lagi,10,10,akun saya tiba tiba hilang dan tidak bisa dibuka lagi,10,10,"['akun', 'saya', 'tiba', 'tiba', 'hilang', 'dan', 'tidak', 'bisa', 'dibuka', 'lagi']","['akun', 'hilang', 'tidak', 'dibuka']",10,4,6,akun hilang tidak buka,4,4
"Tebak gambarnya jangan susah""lah anjeng konnn",negatif,2023-07-14,2023,tebak gambarnya jangan susah lah anjeng konnn,6,7,tebak gambarnya jangan susah lah anjeng konnn,7,7,"['tebak', 'gambarnya', 'jangan', 'susah', 'lah', 'anjeng', 'konnn']","['tebak', 'gambarnya', 'susah', 'anjeng', 'konnn']",7,5,2,tebak gambar susah anjeng konnn,5,5
aplikasi yg sangat membantu buat semuah orang,positif,2021-05-10,2021,aplikasi yg sangat membantu buat semuah orang,7,7,aplikasi yang sangat membantu buat semuah orang,7,7,"['aplikasi', 'yang', 'sangat', 'membantu', 'buat', 'semuah', 'orang']","['aplikasi', 'membantu', 'semuah', 'orang']",7,4,3,aplikasi bantu semuah orang,4,4
"Apk aneh daftar aja susah amat ,,",negatif,2023-10-13,2023,apk aneh daftar aja susah amat,7,6,aplikasi aneh daftar saja susah amat,6,6,"['aplikasi', 'aneh', 'daftar', 'saja', 'susah', 'amat']","['aplikasi', 'aneh', 'daftar', 'susah']",6,4,2,aplikasi aneh daftar susah,4,4
"Gagal verifikasi, padahal sudah benar",negatif,2023-07-07,2023,gagal verifikasi padahal sudah benar,5,5,gagal verifikasi padahal sudah benar,5,5,"['gagal', 'verifikasi', 'padahal', 'sudah', 'benar']","['gagal', 'verifikasi']",5,2,3,gagal verifikasi,2,2
Susah kalau.minta update...non aktifkan aja dulu..,negatif,2021-08-04,2021,susah kalau minta update non aktifkan aja dulu,6,8,susah kalau minta diperbarui non aktifkan saja dahulu,8,8,"['susah', 'kalau', 'minta', 'diperbarui', 'non', 'aktifkan', 'saja', 'dahulu']","['susah', 'diperbarui', 'non', 'aktifkan']",8,4,4,susah baru non aktif,4,4
Sangat membantu para pengangguran untuk mendapatkan pekerjaan,positif,2020-11-17,2020,sangat membantu para pengangguran untuk mendapatkan pekerjaan,7,7,sangat membantu para pengangguran untuk mendapatkan pekerjaan,7,7,"['sangat', 'membantu', 'para', 'pengangguran', 'untuk', 'mendapatkan', 'pekerjaan']","['membantu', 'pengangguran', 'pekerjaan']",7,3,4,bantu anggur kerja,3,3
Bagus admin koq setiap sy posting sesuatu punya sy ga muncul di beranda,positif,2020-10-21,2020,bagus admin koq setiap sy posting sesuatu punya sy ga muncul di beranda,13,13,bagus admin kok setiap saya posting sesuatu punya saya tidak muncul di beranda,13,13,"['bagus', 'admin', 'kok', 'setiap', 'saya', 'posting', 'sesuatu', 'punya', 'saya', 'tidak', 'muncul', 'di', 'beranda']","['bagus', 'admin', 'posting', 'tidak', 'muncul', 'beranda']",13,6,7,bagus admin posting tidak muncul beranda,6,6
Mohon maaf tapi aplikasi ini kurang membantu. Saya berharap ada perbaikan kedepan. Terimakasih 🙏,negatif,2020-06-03,2020,mohon maaf tapi aplikasi ini kurang membantu saya berharap ada perbaikan kedepan terimakasih,14,13,mohon maaf tapi aplikasi ini kurang membantu saya berharap ada perbaikan kedepan terima kasih,13,14,"['mohon', 'maaf', 'tapi', 'aplikasi', 'ini', 'kurang', 'membantu', 'saya', 'berharap', 'ada', 'perbaikan', 'kedepan', 'terima', 'kasih']","['mohon', 'maaf', 'aplikasi', 'membantu', 'berharap', 'perbaikan', 'kedepan', 'terima', 'kasih']",14,9,5,mohon maaf aplikasi bantu harap baik depan terima kasih,9,9
Sangatt membantu saya supaya bisa dapat pekerjaan,positif,2020-10-07,2020,sangatt membantu saya supaya bisa dapat pekerjaan,7,7,sangat membantu saya supaya bisa dapat pekerjaan,7,7,"['sangat', 'membantu', 'saya', 'supaya', 'bisa', 'dapat', 'pekerjaan']","['membantu', 'pekerjaan']",7,2,5,bantu kerja,2,2
Aplikasi bagus sekali dan sangat membantu,positif,2023-04-21,2023,aplikasi bagus sekali dan sangat membantu,6,6,aplikasi bagus sekali dan sangat membantu,6,6,"['aplikasi', 'bagus', 'sekali', 'dan', 'sangat', 'membantu']","['aplikasi', 'bagus', 'membantu']",6,3,3,aplikasi bagus bantu,3,3
Informasi yang sangat bermanfaat trimakasih link,positif,2021-12-09,2021,informasi yang sangat bermanfaat trimakasih link,6,6,informasi yang sangat bermanfaat terima kasih link,6,7,"['informasi', 'yang', 'sangat', 'bermanfaat', 'terima', 'kasih', 'link']","['informasi', 'bermanfaat', 'terima', 'kasih', 'link']",7,5,2,informasi manfaat terima kasih link,5,5
"Ga bisa log in,suruh ngisi teka teki mulu",negatif,2023-09-26,2023,ga bisa log in suruh ngisi teka teki mulu,8,9,tidak bisa log in suruh mengisi teka teki mulu,9,9,"['tidak', 'bisa', 'log', 'in', 'suruh', 'mengisi', 'teka', 'teki', 'mulu']","['tidak', 'log', 'in', 'suruh', 'mengisi', 'teka', 'teki', 'mulu']",9,8,1,tidak log in suruh isi teka teki mulu,8,8
Sangat membantu mendapatkan pekerjaan,positif,2020-12-08,2020,sangat membantu mendapatkan pekerjaan,4,4,sangat membantu mendapatkan pekerjaan,4,4,"['sangat', 'membantu', 'mendapatkan', 'pekerjaan']","['membantu', 'pekerjaan']",4,2,2,bantu kerja,2,2
"Ini sangat membatu saya dalam mencari pekerjaan,",positif,2020-07-28,2020,ini sangat membatu saya dalam mencari pekerjaan,7,7,ini sangat membantu saya dalam mencari pekerjaan,7,7,"['ini', 'sangat', 'membantu', 'saya', 'dalam', 'mencari', 'pekerjaan']","['membantu', 'mencari', 'pekerjaan']",7,3,4,bantu cari kerja,3,3
Akses terbaik,positif,2024-05-18,2024,akses terbaik,2,2,akses terbaik,2,2,"['akses', 'terbaik']","['akses', 'terbaik']",2,2,0,akses baik,2,2
Pemeriksaan yang sangat ribet,negatif,2021-06-12,2021,pemeriksaan yang sangat ribet,4,4,pemeriksaan yang sangat rumit,4,4,"['pemeriksaan', 'yang', 'sangat', 'rumit']","['pemeriksaan', 'rumit']",4,2,2,periksa rumit,2,2
Sangat bermanfaat untuk menunjang karier. 😊,positif,2021-11-17,2021,sangat bermanfaat untuk menunjang karier,6,5,sangat bermanfaat untuk menunjang karier,5,5,"['sangat', 'bermanfaat', 'untuk', 'menunjang', 'karier']","['bermanfaat', 'menunjang', 'karier']",5,3,2,manfaat tunjang karier,3,3
"Login susah... Pake peringatan bahwa anda manusia,, ente binatang... Harus pake Teka teki cari binatang madep ke atas... Koplok",negatif,2022-11-23,2022,login susah pake peringatan bahwa anda manusia ente binatang harus pake teka teki cari binatang madep ke atas koplok,19,19,login susah pakai peringatan bahwa anda manusia ente binatang harus pakai teka teki cari binatang madep ke atas koplok,19,19,"['login', 'susah', 'pakai', 'peringatan', 'bahwa', 'anda', 'manusia', 'ente', 'binatang', 'harus', 'pakai', 'teka', 'teki', 'cari', 'binatang', 'madep', 'ke', 'atas', 'koplok']","['login', 'susah', 'pakai', 'peringatan', 'manusia', 'ente', 'binatang', 'pakai', 'teka', 'teki', 'cari', 'binatang', 'madep', 'koplok']",19,14,5,login susah pakai ingat manusia ente binatang pakai teka teki cari binatang madep koplok,14,14
Sangat membantu bagi para pencaker,positif,2021-11-21,2021,sangat membantu bagi para pencaker,5,5,sangat membantu bagi para pencaker,5,5,"['sangat', 'membantu', 'bagi', 'para', 'pencaker']","['membantu', 'pencaker']",5,2,3,bantu pencaker,2,2
Aplikasi yg sangat baik dan membantu sekali,positif,2021-09-30,2021,aplikasi yg sangat baik dan membantu sekali,7,7,aplikasi yang sangat baik dan membantu sekali,7,7,"['aplikasi', 'yang', 'sangat', 'baik', 'dan', 'membantu', 'sekali']","['aplikasi', 'membantu']",7,2,5,aplikasi bantu,2,2
Sulit banget daftar akun Coba dipermudah,negatif,2024-01-03,2024,sulit banget daftar akun coba dipermudah,6,6,sulit banget daftar akun coba dipermudah,6,6,"['sulit', 'banget', 'daftar', 'akun', 'coba', 'dipermudah']","['sulit', 'banget', 'daftar', 'akun', 'coba', 'dipermudah']",6,6,0,sulit banget daftar akun coba mudah,6,6
Tempat bertemunya para profesional di segala bidang...,positif,2020-12-23,2020,tempat bertemunya para profesional di segala bidang,7,7,tempat bertemunya para profesional di segala bidang,7,7,"['tempat', 'bertemunya', 'para', 'profesional', 'di', 'segala', 'bidang']","['bertemunya', 'profesional', 'bidang']",7,3,4,temu profesional bidang,3,3
Tidak bagus aplikasi cari kerja,negatif,2020-11-01,2020,tidak bagus aplikasi cari kerja,5,5,tidak bagus aplikasi cari kerja,5,5,"['tidak', 'bagus', 'aplikasi', 'cari', 'kerja']","['tidak', 'bagus', 'aplikasi', 'cari', 'kerja']",5,5,0,tidak bagus aplikasi cari kerja,5,5
linkendln sangat membantu informasi untuk info pekerjaan.👍,positif,2023-10-10,2023,linkendln sangat membantu informasi untuk info pekerjaan,7,7,linkendln sangat membantu informasi untuk informasi pekerjaan,7,7,"['linkendln', 'sangat', 'membantu', 'informasi', 'untuk', 'informasi', 'pekerjaan']","['linkendln', 'membantu', 'informasi', 'informasi', 'pekerjaan']",7,5,2,linkendln bantu informasi informasi kerja,5,5
"sangat membantu,meski belum terantu",positif,2023-02-18,2023,sangat membantu meski belum terantu,4,5,sangat membantu meski belum terantu,5,5,"['sangat', 'membantu', 'meski', 'belum', 'terantu']","['membantu', 'terantu']",5,2,3,bantu terantu,2,2
Bagus ukt melihat info pekerjaan,positif,2022-08-03,2022,bagus ukt melihat info pekerjaan,5,5,bagus ukt melihat informasi pekerjaan,5,5,"['bagus', 'ukt', 'melihat', 'informasi', 'pekerjaan']","['bagus', 'ukt', 'informasi', 'pekerjaan']",5,4,1,bagus ukt informasi kerja,4,4
Sangat membantu saya sebagai pencari kerja 👍,positif,2022-03-29,2022,sangat membantu saya sebagai pencari kerja,7,6,sangat membantu saya sebagai pencari kerja,6,6,"['sangat', 'membantu', 'saya', 'sebagai', 'pencari', 'kerja']","['membantu', 'pencari', 'kerja']",6,3,3,bantu cari kerja,3,3
Sejauh ini platform yang bagus,positif,2020-08-21,2020,sejauh ini platform yang bagus,5,5,sejauh ini platform yang bagus,5,5,"['sejauh', 'ini', 'platform', 'yang', 'bagus']","['platform', 'bagus']",5,2,3,platform bagus,2,2
kenapa tiba tiba akun saya di batasi ? padahal gk ngapain2...,negatif,2022-12-12,2022,kenapa tiba tiba akun saya di batasi padahal gk ngapain,11,10,kenapa tiba tiba akun saya di batasi padahal tidak buat apa,10,11,"['kenapa', 'tiba', 'tiba', 'akun', 'saya', 'di', 'batasi', 'padahal', 'tidak', 'buat', 'apa']","['akun', 'batasi', 'tidak']",11,3,8,akun batas tidak,3,3
Verifikasi nya susah banget salah mulu 👎,negatif,2023-12-18,2023,verifikasi nya susah banget salah mulu,7,6,verifikasi nya susah banget salah mulu,6,6,"['verifikasi', 'nya', 'susah', 'banget', 'salah', 'mulu']","['verifikasi', 'nya', 'susah', 'banget', 'salah', 'mulu']",6,6,0,verifikasi nya susah banget salah mulu,6,6
Mantap namun kita harus selektif dalam memilih dan memilah pertemanan,positif,2020-01-04,2020,mantap namun kita harus selektif dalam memilih dan memilah pertemanan,10,10,mantap namun kita harus selektif dalam memilih dan memilah pertemanan,10,10,"['mantap', 'namun', 'kita', 'harus', 'selektif', 'dalam', 'memilih', 'dan', 'memilah', 'pertemanan']","['mantap', 'selektif', 'memilih', 'memilah', 'pertemanan']",10,5,5,mantap selektif pilih mem teman,5,5
"Ok, Terimakasih bergabung..Koneksi jaringan",positif,2022-05-29,2022,ok terimakasih bergabung koneksi jaringan,4,5,oke terima kasih bergabung koneksi jaringan,5,6,"['oke', 'terima', 'kasih', 'bergabung', 'koneksi', 'jaringan']","['oke', 'terima', 'kasih', 'bergabung', 'koneksi', 'jaringan']",6,6,0,oke terima kasih gabung koneksi jaring,6,6
Auto uninstal... App Ga guna.,negatif,2022-03-30,2022,auto uninstal app ga guna,5,5,otomatis hapus instalan aplikasi tidak guna,5,6,"['otomatis', 'hapus', 'instalan', 'aplikasi', 'tidak', 'guna']","['otomatis', 'hapus', 'instalan', 'aplikasi', 'tidak']",6,5,1,otomatis hapus instalan aplikasi tidak,5,5
Lebih cepat dapet kerjaan.....mantaabb...👍👍👍👍👍,positif,2022-04-03,2022,lebih cepat dapet kerjaan mantaabb,4,5,lebih cepat dapat kerjaan mantap,5,5,"['lebih', 'cepat', 'dapat', 'kerjaan', 'mantap']","['cepat', 'kerjaan', 'mantap']",5,3,2,cepat kerja mantap,3,3
Verif lama.. Login gagal terus..,negatif,2023-02-26,2023,verif lama login gagal terus,5,5,verif lama login gagal terus,5,5,"['verif', 'lama', 'login', 'gagal', 'terus']","['verif', 'login', 'gagal']",5,3,2,verif login gagal,3,3
"Aplikasinya bikin ribet, udah tahu manusia dikira robot tolol",negatif,2023-11-04,2023,aplikasinya bikin ribet udah tahu manusia dikira robot tolol,9,9,aplikasi nya bikin rumit sudah tahu manusia dikira robot tolol,9,10,"['aplikasi', 'nya', 'bikin', 'rumit', 'sudah', 'tahu', 'manusia', 'dikira', 'robot', 'tolol']","['aplikasi', 'nya', 'bikin', 'rumit', 'manusia', 'robot', 'tolol']",10,7,3,aplikasi nya bikin rumit manusia robot tolol,7,7
Kemarin ada yg bobol akun ku linkedln.untung sdh aku privat.skrng aku akan lihat siapa yg pakai akunku disini.mangkanya aku download linkedln.tolong JK atas nama yg bobol pakai akun ku ini.saya tdk bertanggung jawab.karena saya merasa tdk menggunakan linkedln.skrng saya baru dowload ingin tahu siapa yg memakainya,negatif,2021-09-21,2021,kemarin ada yg bobol akun ku linkedln untung sdh aku privat skrng aku akan lihat siapa yg pakai akunku disini mangkanya aku download linkedln tolong jk atas nama yg bobol pakai akun ku ini saya tdk bertanggung jawab karena saya merasa tdk menggunakan linkedln skrng saya baru dowload ingin tahu siapa yg memakainya,46,53,kemarin ada yang bobol akun saya linkedln untung sudah aku privat sekarang aku akan lihat siapa yang pakai akunku disini mangkanya aku unduh linkedln tolong jika atas nama yang bobol pakai akun saya ini saya tidak bertanggung jawab karena saya merasa tidak menggunakan linkedln sekarang saya baru dowload ingin tahu siapa yang memakainya,53,53,"['kemarin', 'ada', 'yang', 'bobol', 'akun', 'saya', 'linkedln', 'untung', 'sudah', 'aku', 'privat', 'sekarang', 'aku', 'akan', 'lihat', 'siapa', 'yang', 'pakai', 'akunku', 'disini', 'mangkanya', 'aku', 'unduh', 'linkedln', 'tolong', 'jika', 'atas', 'nama', 'yang', 'bobol', 'pakai', 'akun', 'saya', 'ini', 'saya', 'tidak', 'bertanggung', 'jawab', 'karena', 'saya', 'merasa', 'tidak', 'menggunakan', 'linkedln', 'sekarang', 'saya', 'baru', 'dowload', 'ingin', 'tahu', 'siapa', 'yang', 'memakainya']","['kemarin', 'bobol', 'akun', 'linkedln', 'untung', 'privat', 'lihat', 'pakai', 'akunku', 'mangkanya', 'unduh', 'linkedln', 'tolong', 'nama', 'bobol', 'pakai', 'akun', 'tidak', 'bertanggung', 'tidak', 'linkedln', 'dowload', 'memakainya']",53,23,30,kemarin bobol akun linkedln untung privat lihat pakai akun mangkanya unduh linkedln tolong nama bobol pakai akun tidak tanggung tidak linkedln dowload maka,23,23
Bagus banget bisa bantu orang yg lagi cari kerjaan,positif,2022-07-15,2022,bagus banget bisa bantu orang yg lagi cari kerjaan,9,9,bagus banget bisa bantu orang yang lagi cari kerjaan,9,9,"['bagus', 'banget', 'bisa', 'bantu', 'orang', 'yang', 'lagi', 'cari', 'kerjaan']","['bagus', 'banget', 'bantu', 'orang', 'cari', 'kerjaan']",9,6,3,bagus banget bantu orang cari kerja,6,6
"Aplikasi bodo , verifikasi lambat",positif,2023-03-01,2023,aplikasi bodo verifikasi lambat,5,4,aplikasi bodo verifikasi lambat,4,4,"['aplikasi', 'bodo', 'verifikasi', 'lambat']","['aplikasi', 'bodo', 'verifikasi', 'lambat']",4,4,0,aplikasi bodo verifikasi lambat,4,4
Gimana sih invalid mulu re chaptsanya gabisa buat masuk,negatif,2024-01-24,2024,gimana sih invalid mulu re chaptsanya gabisa buat masuk,9,9,bagaimana sih invalid mulu re chaptsanya tidak bisa buat masuk,9,10,"['bagaimana', 'sih', 'invalid', 'mulu', 're', 'chaptsanya', 'tidak', 'bisa', 'buat', 'masuk']","['sih', 'invalid', 'mulu', 're', 'chaptsanya', 'tidak', 'masuk']",10,7,3,sih invalid mulu re chaptsanya tidak masuk,7,7
Keren parah sih aplikasi yang sangat membantu bagi saya,positif,2021-05-19,2021,keren parah sih aplikasi yang sangat membantu bagi saya,9,9,keren parah sih aplikasi yang sangat membantu bagi saya,9,9,"['keren', 'parah', 'sih', 'aplikasi', 'yang', 'sangat', 'membantu', 'bagi', 'saya']","['keren', 'parah', 'sih', 'aplikasi', 'membantu']",9,5,4,keren parah sih aplikasi bantu,5,5
Kerennn. Sangat bermanfaat dlm menemukam relasi,positif,2023-07-19,2023,kerennn sangat bermanfaat dlm menemukam relasi,6,6,kerennn sangat bermanfaat dalam menemukam relasi,6,6,"['kerennn', 'sangat', 'bermanfaat', 'dalam', 'menemukam', 'relasi']","['kerennn', 'bermanfaat', 'menemukam', 'relasi']",6,4,2,kerennn manfaat tukam relasi,4,4
TOLONG GAK BISA LOGIN! BIKIN AKUN BARU JUGA GAK BISA!,negatif,2021-09-08,2021,tolong gak bisa login bikin akun baru juga gak bisa,10,10,tolong tidak bisa login bikin akun baru juga tidak bisa,10,10,"['tolong', 'tidak', 'bisa', 'login', 'bikin', 'akun', 'baru', 'juga', 'tidak', 'bisa']","['tolong', 'tidak', 'login', 'bikin', 'akun', 'tidak']",10,6,4,tolong tidak login bikin akun tidak,6,6
"Sampah,,mau daftar malah bikin kesel tolong perbaiki chapta nya dong",negatif,2022-05-23,2022,sampah mau daftar malah bikin kesel tolong perbaiki chapta nya dong,10,11,sampah mau daftar bahkan bikin kesel tolong perbaikan chapta nya dong,11,11,"['sampah', 'mau', 'daftar', 'bahkan', 'bikin', 'kesel', 'tolong', 'perbaikan', 'chapta', 'nya', 'dong']","['sampah', 'daftar', 'bikin', 'kesel', 'tolong', 'perbaikan', 'chapta', 'nya']",11,8,3,sampah daftar bikin kesel tolong baik chapta nya,8,8
"upload foto gagal mulu, apaan sih",negatif,2022-07-07,2022,upload foto gagal mulu apaan sih,6,6,unggah foto gagal mulu apa sih,6,6,"['unggah', 'foto', 'gagal', 'mulu', 'apa', 'sih']","['unggah', 'foto', 'gagal', 'mulu', 'sih']",6,5,1,unggah foto gagal mulu sih,5,5
Membantu dalam mencari pekerjaan,positif,2023-07-21,2023,membantu dalam mencari pekerjaan,4,4,membantu dalam mencari pekerjaan,4,4,"['membantu', 'dalam', 'mencari', 'pekerjaan']","['membantu', 'mencari', 'pekerjaan']",4,3,1,bantu cari kerja,3,3
Sangat bersyukur bisa masuk ke dalam LinkedIn dan bermedia sosial yang baik,positif,2021-09-28,2021,sangat bersyukur bisa masuk ke dalam linkedin dan bermedia sosial yang baik,12,12,sangat bersyukur bisa masuk ke dalam linkedin dan bermedia sosial yang baik,12,12,"['sangat', 'bersyukur', 'bisa', 'masuk', 'ke', 'dalam', 'linkedin', 'dan', 'bermedia', 'sosial', 'yang', 'baik']","['bersyukur', 'masuk', 'linkedin', 'bermedia', 'sosial']",12,5,7,syukur masuk linkedin media sosial,5,5
Jaringan LinkedIn sangat membantu dalam membangun jaringan bisnis saya,positif,2020-11-22,2020,jaringan linkedin sangat membantu dalam membangun jaringan bisnis saya,9,9,jaringan linkedin sangat membantu dalam membangun jaringan bisnis saya,9,9,"['jaringan', 'linkedin', 'sangat', 'membantu', 'dalam', 'membangun', 'jaringan', 'bisnis', 'saya']","['jaringan', 'linkedin', 'membantu', 'membangun', 'jaringan', 'bisnis']",9,6,3,jaring linkedin bantu bangun jaring bisnis,6,6
Tingkatkan lagi qualitas aplikasi nya,positif,2021-06-20,2021,tingkatkan lagi qualitas aplikasi nya,5,5,tingkatkan lagi kualitas aplikasi nya,5,5,"['tingkatkan', 'lagi', 'kualitas', 'aplikasi', 'nya']","['tingkatkan', 'kualitas', 'aplikasi', 'nya']",5,4,1,tingkat kualitas aplikasi nya,4,4
Menambah wawasan relasi dan jaringan,positif,2020-11-12,2020,menambah wawasan relasi dan jaringan,5,5,menambah wawasan relasi dan jaringan,5,5,"['menambah', 'wawasan', 'relasi', 'dan', 'jaringan']","['menambah', 'wawasan', 'relasi', 'jaringan']",5,4,1,tambah wawas relasi jaring,4,4
foto profil tidak bisa diunggah,negatif,2022-09-02,2022,foto profil tidak bisa diunggah,5,5,foto profil tidak bisa diunggah,5,5,"['foto', 'profil', 'tidak', 'bisa', 'diunggah']","['foto', 'profil', 'tidak', 'diunggah']",5,4,1,foto profil tidak unggah,4,4
Aplikasi nya sangat membantu.. mksh linkedln,positif,2020-03-29,2020,aplikasi nya sangat membantu mksh linkedln,6,6,aplikasi nya sangat membantu terima kasih linkedln,6,7,"['aplikasi', 'nya', 'sangat', 'membantu', 'terima', 'kasih', 'linkedln']","['aplikasi', 'nya', 'membantu', 'terima', 'kasih', 'linkedln']",7,6,1,aplikasi nya bantu terima kasih linkedln,6,6
Aplikasi tepat untuk para jobseeker,positif,2020-02-11,2020,aplikasi tepat untuk para jobseeker,5,5,aplikasi tepat untuk para jobseeker,5,5,"['aplikasi', 'tepat', 'untuk', 'para', 'jobseeker']","['aplikasi', 'jobseeker']",5,2,3,aplikasi jobseeker,2,2
Pengalaman baik selama bisa mengabdi,positif,2024-07-21,2024,pengalaman baik selama bisa mengabdi,5,5,pengalaman baik selama bisa mengabdi,5,5,"['pengalaman', 'baik', 'selama', 'bisa', 'mengabdi']","['pengalaman', 'mengabdi']",5,2,3,alam abdi,2,2
Iklan gak bermutu,negatif,2024-06-21,2024,iklan gak bermutu,3,3,iklan tidak bermutu,3,3,"['iklan', 'tidak', 'bermutu']","['iklan', 'tidak', 'bermutu']",3,3,0,iklan tidak mutu,3,3
Mantap keren abis,positif,2024-06-21,2024,mantap keren abis,3,3,mantap keren habis,3,3,"['mantap', 'keren', 'habis']","['mantap', 'keren', 'habis']",3,3,0,mantap keren habis,3,3
"Ribet, iklan nya dimana mana",negatif,2024-06-09,2024,ribet iklan nya dimana mana,5,5,rumit iklan nya dimana mana,5,5,"['rumit', 'iklan', 'nya', 'dimana', 'mana']","['rumit', 'iklan', 'nya', 'dimana']",5,4,1,rumit iklan nya mana,4,4
Iklannya nyepam!!!!!!!!!!!,negatif,2024-06-12,2024,iklannya nyepam,2,2,iklannya nyepam,2,2,"['iklannya', 'nyepam']","['iklannya', 'nyepam']",2,2,0,iklan nyepam,2,2
"Untuk cara melamarnya susah, lebih ke gak ngertinya hadeehhh hadeehhh hadeehh 🤦‍♂️",negatif,2021-12-28,2021,untuk cara melamarnya susah lebih ke gak ngertinya hadeehhh hadeehhh hadeehh ‍,12,12,untuk cara melamarnya susah lebih ke tidak ngertinya hadeehhh hadeehhh aduh ‍,12,12,"['untuk', 'cara', 'melamarnya', 'susah', 'lebih', 'ke', 'tidak', 'ngertinya', 'hadeehhh', 'hadeehhh', 'aduh', '\u200d']","['melamarnya', 'susah', 'tidak', 'ngertinya', 'hadeehhh', 'hadeehhh', 'aduh', '\u200d']",12,8,4,lamar susah tidak ngertinya hadeehhh hadeehhh aduh,8,7
Unintal aja lah verifikasi nya susah,negatif,2024-07-08,2024,unintal aja lah verifikasi nya susah,6,6,unintal saja lah verifikasi nya susah,6,6,"['unintal', 'saja', 'lah', 'verifikasi', 'nya', 'susah']","['unintal', 'verifikasi', 'nya', 'susah']",6,4,2,unintal verifikasi nya susah,4,4
masuk saja harus ke email parah,negatif,2024-06-22,2024,masuk saja harus ke email parah,6,6,masuk saja harus ke email parah,6,6,"['masuk', 'saja', 'harus', 'ke', 'email', 'parah']","['masuk', 'email', 'parah']",6,3,3,masuk email parah,3,3
Manfaat app ini untuk apa ya bos.. Tlg jelaskan..,positif,2024-07-06,2024,manfaat app ini untuk apa ya bos tlg jelaskan,9,9,manfaat aplikasi ini untuk apa ya box tlg jelaskan,9,9,"['manfaat', 'aplikasi', 'ini', 'untuk', 'apa', 'ya', 'box', 'tlg', 'jelaskan']","['manfaat', 'aplikasi', 'ya', 'box', 'tlg']",9,5,4,manfaat aplikasi ya box tlg,5,5
Konten iklan menganggu,negatif,2024-06-26,2024,konten iklan menganggu,3,3,konten iklan menganggu,3,3,"['konten', 'iklan', 'menganggu']","['konten', 'iklan', 'menganggu']",3,3,0,konten iklan menganggu,3,3
Bagaimana saya menghapus akun saya yang tidak bisa login?,negatif,2024-06-10,2024,bagaimana saya menghapus akun saya yang tidak bisa login,9,9,bagaimana saya menghapus akun saya yang tidak bisa login,9,9,"['bagaimana', 'saya', 'menghapus', 'akun', 'saya', 'yang', 'tidak', 'bisa', 'login']","['menghapus', 'akun', 'tidak', 'login']",9,4,5,hapus akun tidak login,4,4
Apk tau kucing mo login aja susah amat bedul,negatif,2024-06-11,2024,apk tau kucing mo login aja susah amat bedul,9,9,aplikasi tahu kucing mau login saja susah amat bedul,9,9,"['aplikasi', 'tahu', 'kucing', 'mau', 'login', 'saja', 'susah', 'amat', 'bedul']","['aplikasi', 'kucing', 'login', 'susah', 'bedul']",9,5,4,aplikasi kucing login susah bedul,5,5
Sangat membantu untuk berbisnis,positif,2021-05-08,2021,sangat membantu untuk berbisnis,4,4,sangat membantu untuk berbisnis,4,4,"['sangat', 'membantu', 'untuk', 'berbisnis']","['membantu', 'berbisnis']",4,2,2,bantu bisnis,2,2
Kalo di apk lain iklan apk ini susah bg di skip mwemweg bgt,negatif,2024-06-06,2024,kalo di apk lain iklan apk ini susah bg di skip mwemweg bgt,13,13,kalau di aplikasi lain iklan aplikasi ini susah bg di skip mwemweg banget,13,13,"['kalau', 'di', 'aplikasi', 'lain', 'iklan', 'aplikasi', 'ini', 'susah', 'bg', 'di', 'skip', 'mwemweg', 'banget']","['aplikasi', 'iklan', 'aplikasi', 'susah', 'bg', 'skip', 'mwemweg', 'banget']",13,8,5,aplikasi iklan aplikasi susah bg skip mwemweg banget,8,8
Lama banget installnya,negatif,2024-07-14,2024,lama banget installnya,3,3,lama banget installnya,3,3,"['lama', 'banget', 'installnya']","['banget', 'installnya']",3,2,1,banget installnya,2,2
Terimakasih untuk developer,positif,2024-06-29,2024,terimakasih untuk developer,3,3,terima kasih untuk developer,3,4,"['terima', 'kasih', 'untuk', 'developer']","['terima', 'kasih', 'developer']",4,3,1,terima kasih developer,3,3
Notif gajelas gausah dikirim lah anehh,negatif,2024-07-18,2024,notif gajelas gausah dikirim lah anehh,6,6,notif tidak jelas tidak perlu dikirim lah anehh,6,8,"['notif', 'tidak', 'jelas', 'tidak', 'perlu', 'dikirim', 'lah', 'anehh']","['notif', 'tidak', 'tidak', 'dikirim', 'anehh']",8,5,3,notif tidak tidak kirim anehh,5,5
sangat sempurna sekali,positif,2024-06-16,2024,sangat sempurna sekali,3,3,sangat sempurna sekali,3,3,"['sangat', 'sempurna', 'sekali']",['sempurna'],3,1,2,sempurna,1,1
bagus sekali sila di coba9,positif,2024-06-17,2024,bagus sekali sila di coba,5,5,bagus sekali sila di coba,5,5,"['bagus', 'sekali', 'sila', 'di', 'coba']","['bagus', 'sila', 'coba']",5,3,2,bagus sila coba,3,3
apk stresss mau login aja di suruh captcha trss,negatif,2024-06-07,2024,apk stresss mau login aja di suruh captcha trss,9,9,aplikasi stresss mau login saja di suruh captcha trss,9,9,"['aplikasi', 'stresss', 'mau', 'login', 'saja', 'di', 'suruh', 'captcha', 'trss']","['aplikasi', 'stresss', 'login', 'suruh', 'captcha', 'trss']",9,6,3,aplikasi stresss login suruh captcha trss,6,6
Apk rusak gak bisa buat login bodo gak guna,negatif,2020-12-29,2020,apk rusak gak bisa buat login bodo gak guna,9,9,aplikasi rusak tidak bisa buat login bodo tidak guna,9,9,"['aplikasi', 'rusak', 'tidak', 'bisa', 'buat', 'login', 'bodo', 'tidak', 'guna']","['aplikasi', 'rusak', 'tidak', 'login', 'bodo', 'tidak']",9,6,3,aplikasi rusak tidak login bodo tidak,6,6
Aplikasi yg bagus banget,positif,2024-06-30,2024,aplikasi yg bagus banget,4,4,aplikasi yang bagus banget,4,4,"['aplikasi', 'yang', 'bagus', 'banget']","['aplikasi', 'bagus', 'banget']",4,3,1,aplikasi bagus banget,3,3
Dgn aplikasi ini saya sangat mudah mendapatkan pekerjaan.,positif,2020-09-16,2020,dgn aplikasi ini saya sangat mudah mendapatkan pekerjaan,8,8,dengan aplikasi ini saya sangat mudah mendapatkan pekerjaan,8,8,"['dengan', 'aplikasi', 'ini', 'saya', 'sangat', 'mudah', 'mendapatkan', 'pekerjaan']","['aplikasi', 'mudah', 'pekerjaan']",8,3,5,aplikasi mudah kerja,3,3
dijaman moderen ini sosial media tanggo sangat membantu seki tuk menemukan teman yg jauh tinggal nya,positif,2020-03-19,2020,dijaman moderen ini sosial media tanggo sangat membantu seki tuk menemukan teman yg jauh tinggal nya,16,16,dijaman moderen ini sosial media tanggo sangat membantu seki untuk menemukan teman yang jauh tinggal nya,16,16,"['dijaman', 'moderen', 'ini', 'sosial', 'media', 'tanggo', 'sangat', 'membantu', 'seki', 'untuk', 'menemukan', 'teman', 'yang', 'jauh', 'tinggal', 'nya']","['dijaman', 'moderen', 'sosial', 'media', 'tanggo', 'membantu', 'seki', 'menemukan', 'teman', 'tinggal', 'nya']",16,11,5,jam moderen sosial media tanggo bantu sek temu teman tinggal nya,11,11
Bagus. Sangat informatif.,positif,2022-03-17,2022,bagus sangat informatif,3,3,bagus sangat informatif,3,3,"['bagus', 'sangat', 'informatif']","['bagus', 'informatif']",3,2,1,bagus informatif,2,2
aplikasih yang hebat...,positif,2024-07-31,2024,aplikasih yang hebat,3,3,aplikasih yang hebat,3,3,"['aplikasih', 'yang', 'hebat']","['aplikasih', 'hebat']",3,2,1,aplikasih hebat,2,2
"Dapat menerima informasi lamar kerja, koresponden dll",positif,2020-06-17,2020,dapat menerima informasi lamar kerja koresponden dll,7,7,dapat menerima informasi lamar kerja koresponden dan lain lain,7,9,"['dapat', 'menerima', 'informasi', 'lamar', 'kerja', 'koresponden', 'dan', 'lain', 'lain']","['menerima', 'informasi', 'lamar', 'kerja', 'koresponden']",9,5,4,terima informasi lamar kerja koresponden,5,5
Sangat berguna bagi calon pra kerja,positif,2020-09-29,2020,sangat berguna bagi calon pra kerja,6,6,sangat berguna bagi calon pra kerja,6,6,"['sangat', 'berguna', 'bagi', 'calon', 'pra', 'kerja']","['berguna', 'calon', 'pra', 'kerja']",6,4,2,guna calon pra kerja,4,4
berbagai info lowongan pekerjaan,positif,2020-11-10,2020,berbagai info lowongan pekerjaan,4,4,berbagai informasi lowongan pekerjaan,4,4,"['berbagai', 'informasi', 'lowongan', 'pekerjaan']","['informasi', 'lowongan', 'pekerjaan']",4,3,1,informasi lowong kerja,3,3
"Bermanfaat,dan bisa jadi motivasi",positif,2020-11-10,2020,bermanfaat dan bisa jadi motivasi,4,5,bermanfaat dan bisa jadi motivasi,5,5,"['bermanfaat', 'dan', 'bisa', 'jadi', 'motivasi']","['bermanfaat', 'motivasi']",5,2,3,manfaat motivasi,2,2
Bagus untuk semua kalangan,positif,2020-02-02,2020,bagus untuk semua kalangan,4,4,bagus untuk semua kalangan,4,4,"['bagus', 'untuk', 'semua', 'kalangan']","['bagus', 'kalangan']",4,2,2,bagus kalang,2,2
"Sangat membantu sekali, aplikasi good nih..",positif,2020-07-07,2020,sangat membantu sekali aplikasi good nih,6,6,sangat membantu sekali aplikasi bagus nih,6,6,"['sangat', 'membantu', 'sekali', 'aplikasi', 'bagus', 'nih']","['membantu', 'aplikasi', 'bagus', 'nih']",6,4,2,bantu aplikasi bagus nih,4,4
Saya mengikutin linkedn untuk mencari pekerjaan smoga saja sy bisa mendapatkn pekerjaan disini nantinya,positif,2020-07-04,2020,saya mengikutin linkedn untuk mencari pekerjaan smoga saja sy bisa mendapatkn pekerjaan disini nantinya,14,14,saya mengikutin linkedn untuk mencari pekerjaan semoga saja saya bisa mendapatkn pekerjaan disini nantinya,14,14,"['saya', 'mengikutin', 'linkedn', 'untuk', 'mencari', 'pekerjaan', 'semoga', 'saja', 'saya', 'bisa', 'mendapatkn', 'pekerjaan', 'disini', 'nantinya']","['mengikutin', 'linkedn', 'mencari', 'pekerjaan', 'semoga', 'mendapatkn', 'pekerjaan']",14,7,7,mengikutin linkedn cari kerja moga mendapatkn kerja,7,7
"Aplikasi tidak jelas, bloking akun sembarangan ?????!!!!!",negatif,2023-09-23,2023,aplikasi tidak jelas bloking akun sembarangan,7,6,aplikasi tidak jelas bloking akun sembarangan,6,6,"['aplikasi', 'tidak', 'jelas', 'bloking', 'akun', 'sembarangan']","['aplikasi', 'tidak', 'bloking', 'akun', 'sembarangan']",6,5,1,aplikasi tidak bloking akun sembarang,5,5
Sangat membantu mencari info,positif,2020-09-26,2020,sangat membantu mencari info,4,4,sangat membantu mencari informasi,4,4,"['sangat', 'membantu', 'mencari', 'informasi']","['membantu', 'mencari', 'informasi']",4,3,1,bantu cari informasi,3,3
Mau masuk aja susahnya minta ampun.. kode keamanan masa nebak gambar madep ke atas gak jelas,negatif,2021-07-13,2021,mau masuk aja susahnya minta ampun kode keamanan masa nebak gambar madep ke atas gak jelas,16,16,mau masuk saja susahnya minta ampun kode keamanan masa nebak gambar madep ke atas tidak jelas,16,16,"['mau', 'masuk', 'saja', 'susahnya', 'minta', 'ampun', 'kode', 'keamanan', 'masa', 'nebak', 'gambar', 'madep', 'ke', 'atas', 'tidak', 'jelas']","['masuk', 'susahnya', 'ampun', 'kode', 'keamanan', 'nebak', 'gambar', 'madep', 'tidak']",16,9,7,masuk susah ampun kode aman nebak gambar madep tidak,9,9
"Aplikasi ini sangat membantu saya terhubung dengan kolega kolega dan sahabat sahabat saya kembali,",positif,2021-08-25,2021,aplikasi ini sangat membantu saya terhubung dengan kolega kolega dan sahabat sahabat saya kembali,14,14,aplikasi ini sangat membantu saya terhubung dengan kolega kolega dan sahabat sahabat saya kembali,14,14,"['aplikasi', 'ini', 'sangat', 'membantu', 'saya', 'terhubung', 'dengan', 'kolega', 'kolega', 'dan', 'sahabat', 'sahabat', 'saya', 'kembali']","['aplikasi', 'membantu', 'terhubung', 'kolega', 'kolega', 'sahabat', 'sahabat']",14,7,7,aplikasi bantu hubung kolega kolega sahabat sahabat,7,7
Tempat cari kerjaan favorit,positif,2022-07-20,2022,tempat cari kerjaan favorit,4,4,tempat cari kerjaan favorit,4,4,"['tempat', 'cari', 'kerjaan', 'favorit']","['cari', 'kerjaan', 'favorit']",4,3,1,cari kerja favorit,3,3
informatif dan komunikatif,positif,2022-05-13,2022,informatif dan komunikatif,3,3,informatif dan komunikatif,3,3,"['informatif', 'dan', 'komunikatif']","['informatif', 'komunikatif']",3,2,1,informatif komunikatif,2,2
Alhamdulillah syukur bisa mengikuti kegiatan ini,positif,2024-08-22,2024,alhamdulillah syukur bisa mengikuti kegiatan ini,6,6,alhamdulillah syukur bisa mengikuti kegiatan ini,6,6,"['alhamdulillah', 'syukur', 'bisa', 'mengikuti', 'kegiatan', 'ini']","['alhamdulillah', 'syukur', 'mengikuti', 'kegiatan']",6,4,2,alhamdulillah syukur ikut giat,4,4
"Aplikasi paling gak jelas yg prnh gw download,mau login aja dipersulit sama chatcha",negatif,2022-05-28,2022,aplikasi paling gak jelas yg prnh gw download mau login aja dipersulit sama chatcha,13,14,aplikasi paling tidak jelas yang pernah saya unduh mau login saja dipersulit sama chatcha,14,14,"['aplikasi', 'paling', 'tidak', 'jelas', 'yang', 'pernah', 'saya', 'unduh', 'mau', 'login', 'saja', 'dipersulit', 'sama', 'chatcha']","['aplikasi', 'tidak', 'unduh', 'login', 'dipersulit', 'chatcha']",14,6,8,aplikasi tidak unduh login sulit chatcha,6,6
"Nyesel banget dowload App ini, Susah verivikasi nya Slalu salah trus, Jangan sampai kalian Juga Ketipu",negatif,2022-07-26,2022,nyesel banget dowload app ini susah verivikasi nya slalu salah trus jangan sampai kalian juga ketipu,16,16,menyesal banget dowload aplikasi ini susah verivikasi nya selalu salah terus jangan sampai kalian juga ketipu,16,16,"['menyesal', 'banget', 'dowload', 'aplikasi', 'ini', 'susah', 'verivikasi', 'nya', 'selalu', 'salah', 'terus', 'jangan', 'sampai', 'kalian', 'juga', 'ketipu']","['menyesal', 'banget', 'dowload', 'aplikasi', 'susah', 'verivikasi', 'nya', 'salah', 'ketipu']",16,9,7,sesal banget dowload aplikasi susah verivikasi nya salah tipu,9,9
Apasih Kok gak jelas verivikasi nya salah mulu Cape gw anjir tebak gambar ga udah udah Gajadi dah make linkedin ribet,negatif,2022-06-06,2022,apasih kok gak jelas verivikasi nya salah mulu cape gw anjir tebak gambar ga udah udah gajadi dah make linkedin ribet,21,21,apa sih kok tidak jelas verivikasi nya salah mulu capek saya anjir tebak gambar tidak sudah sudah tidak jadi sudah make linkedin rumit,21,23,"['apa', 'sih', 'kok', 'tidak', 'jelas', 'verivikasi', 'nya', 'salah', 'mulu', 'capek', 'saya', 'anjir', 'tebak', 'gambar', 'tidak', 'sudah', 'sudah', 'tidak', 'jadi', 'sudah', 'make', 'linkedin', 'rumit']","['sih', 'tidak', 'verivikasi', 'nya', 'salah', 'mulu', 'capek', 'anjir', 'tebak', 'gambar', 'tidak', 'tidak', 'make', 'linkedin', 'rumit']",23,15,8,sih tidak verivikasi nya salah mulu capek anjir tebak gambar tidak tidak make linkedin rumit,15,15
Ribet banget tapi demi keamanan pemilik akun baguslah,negatif,2020-04-28,2020,ribet banget tapi demi keamanan pemilik akun baguslah,8,8,rumit banget tapi demi keamanan pemilik akun baguslah,8,8,"['rumit', 'banget', 'tapi', 'demi', 'keamanan', 'pemilik', 'akun', 'baguslah']","['rumit', 'banget', 'keamanan', 'pemilik', 'akun', 'baguslah']",8,6,2,rumit banget aman milik akun bagus,6,6
Saya membutuhkan apl ini...ntuk mempermudah download dari fb ke WhatsApp 👍,positif,2020-04-14,2020,saya membutuhkan apl ini ntuk mempermudah download dari fb ke whatsapp,11,11,saya membutuhkan aplikasi ini ntuk mempermudah unduh dari fb ke whatsapp,11,11,"['saya', 'membutuhkan', 'aplikasi', 'ini', 'ntuk', 'mempermudah', 'unduh', 'dari', 'fb', 'ke', 'whatsapp']","['membutuhkan', 'aplikasi', 'ntuk', 'mempermudah', 'unduh', 'fb', 'whatsapp']",11,7,4,butuh aplikasi ntuk mudah unduh fb whatsapp,7,7
Sangat membantu saya dalam mencari pekerjaan,positif,2020-09-05,2020,sangat membantu saya dalam mencari pekerjaan,6,6,sangat membantu saya dalam mencari pekerjaan,6,6,"['sangat', 'membantu', 'saya', 'dalam', 'mencari', 'pekerjaan']","['membantu', 'mencari', 'pekerjaan']",6,3,3,bantu cari kerja,3,3
Apk paling gak jelas,negatif,2024-05-16,2024,apk paling gak jelas,4,4,aplikasi paling tidak jelas,4,4,"['aplikasi', 'paling', 'tidak', 'jelas']","['aplikasi', 'tidak']",4,2,2,aplikasi tidak,2,2
Jelek permainan apa jelek amat yg setuju ini selalu diejek dan akan di keluarkan like my komenku dulu ya,negatif,2020-05-14,2020,jelek permainan apa jelek amat yg setuju ini selalu diejek dan akan di keluarkan like my komenku dulu ya,19,19,jelek permainan apa jelek amat yang setuju ini selalu diejek dan akan di keluarkan like my komenku dahulu ya,19,19,"['jelek', 'permainan', 'apa', 'jelek', 'amat', 'yang', 'setuju', 'ini', 'selalu', 'diejek', 'dan', 'akan', 'di', 'keluarkan', 'like', 'my', 'komenku', 'dahulu', 'ya']","['jelek', 'permainan', 'jelek', 'setuju', 'diejek', 'keluarkan', 'like', 'my', 'komenku', 'ya']",19,10,9,jelek main jelek tuju ejek keluar like my komenku ya,10,10
"via web nya ribet, padahal cuma mau lihat info PT yang saya lagi cari",negatif,2023-08-11,2023,via web nya ribet padahal cuma mau lihat info pt yang saya lagi cari,14,14,melalui web nya rumit padahal cuma mau lihat informasi perseroan terbatas yang saya lagi cari,14,15,"['melalui', 'web', 'nya', 'rumit', 'padahal', 'cuma', 'mau', 'lihat', 'informasi', 'perseroan', 'terbatas', 'yang', 'saya', 'lagi', 'cari']","['web', 'nya', 'rumit', 'lihat', 'informasi', 'perseroan', 'terbatas', 'cari']",15,8,7,web nya rumit lihat informasi persero batas cari,8,8
"Keburu kesel SMA katak nya milih hampir dua jam ga pernh benr taik,,aplikasi ga jels",negatif,2021-07-16,2021,keburu kesel sma katak nya milih hampir dua jam ga pernh benr taik aplikasi ga jels,15,16,terlanjur kesel sama katak nya memilih hampir dua jam tidak pernah benr taik aplikasi tidak jels,16,16,"['terlanjur', 'kesel', 'sama', 'katak', 'nya', 'memilih', 'hampir', 'dua', 'jam', 'tidak', 'pernah', 'benr', 'taik', 'aplikasi', 'tidak', 'jels']","['terlanjur', 'kesel', 'katak', 'nya', 'memilih', 'jam', 'tidak', 'benr', 'taik', 'aplikasi', 'tidak', 'jels']",16,12,4,lanjur kesel katak nya pilih jam tidak benr taik aplikasi tidak jels,12,12
"Login aja dipersulit, aplikasi toloI",negatif,2022-03-04,2022,login aja dipersulit aplikasi toloi,5,5,login saja dipersulit aplikasi toloi,5,5,"['login', 'saja', 'dipersulit', 'aplikasi', 'toloi']","['login', 'dipersulit', 'aplikasi', 'toloi']",5,4,1,login sulit aplikasi toloi,4,4
Sangat bermanfaat sebagai Sarana Informasi di Sektor Pertambangan Batubara,positif,2020-03-26,2020,sangat bermanfaat sebagai sarana informasi di sektor pertambangan batubara,9,9,sangat bermanfaat sebagai sarana informasi di sektor pertambangan batubara,9,9,"['sangat', 'bermanfaat', 'sebagai', 'sarana', 'informasi', 'di', 'sektor', 'pertambangan', 'batubara']","['bermanfaat', 'sarana', 'informasi', 'sektor', 'pertambangan', 'batubara']",9,6,3,manfaat sarana informasi sektor tambang batubara,6,6
Koneksi keilmuan jadi lebih terbuka.,positif,2023-03-23,2023,koneksi keilmuan jadi lebih terbuka,5,5,koneksi keilmuan jadi lebih terbuka,5,5,"['koneksi', 'keilmuan', 'jadi', 'lebih', 'terbuka']","['koneksi', 'keilmuan', 'terbuka']",5,3,2,koneksi ilmu buka,3,3
"Maaf mohon di perbaiki lagi,mau login aja susah duh",negatif,2023-10-18,2023,maaf mohon di perbaiki lagi mau login aja susah duh,9,10,maaf mohon di perbaikan lagi mau login saja susah aduh,10,10,"['maaf', 'mohon', 'di', 'perbaikan', 'lagi', 'mau', 'login', 'saja', 'susah', 'aduh']","['maaf', 'mohon', 'perbaikan', 'login', 'susah', 'aduh']",10,6,4,maaf mohon baik login susah aduh,6,6
LinkedIn sangat membantu saya dalam mendapatkan pekerjaan impian saya. Cari kerja? LinkedIn aja!,positif,2022-05-27,2022,linkedin sangat membantu saya dalam mendapatkan pekerjaan impian saya cari kerja linkedin aja,13,13,linkedin sangat membantu saya dalam mendapatkan pekerjaan impian saya cari kerja linkedin saja,13,13,"['linkedin', 'sangat', 'membantu', 'saya', 'dalam', 'mendapatkan', 'pekerjaan', 'impian', 'saya', 'cari', 'kerja', 'linkedin', 'saja']","['linkedin', 'membantu', 'pekerjaan', 'impian', 'cari', 'kerja', 'linkedin']",13,7,6,linkedin bantu kerja impi cari kerja linkedin,7,7
Bagus sekali tuk cari kerja,positif,2020-04-21,2020,bagus sekali tuk cari kerja,5,5,bagus sekali untuk cari kerja,5,5,"['bagus', 'sekali', 'untuk', 'cari', 'kerja']","['bagus', 'cari', 'kerja']",5,3,2,bagus cari kerja,3,3
Ya ampun login tidak bisa,negatif,2023-12-08,2023,ya ampun login tidak bisa,5,5,ya ampun login tidak bisa,5,5,"['ya', 'ampun', 'login', 'tidak', 'bisa']","['ya', 'ampun', 'login', 'tidak']",5,4,1,ya ampun login tidak,4,4
"Akun gue dinonaktifkan, gimana cara ngebalikinnya?? Sungguh terrrweeluuu😢😢",negatif,2020-02-04,2020,akun gue dinonaktifkan gimana cara ngebalikinnya sungguh terrrweeluuu,8,8,akun saya dinonaktifkan bagaimana cara ngebalikinnya sungguh terrrweeluuu,8,8,"['akun', 'saya', 'dinonaktifkan', 'bagaimana', 'cara', 'ngebalikinnya', 'sungguh', 'terrrweeluuu']","['akun', 'dinonaktifkan', 'ngebalikinnya', 'sungguh', 'terrrweeluuu']",8,5,3,akun nonaktif ngebalikinnya sungguh terrrweeluuu,5,5
Bermanfaat sekali untuk mengetahui nama2 & alamat perusahaan baru2 / start up 👍🙏. Terimakasih,positif,2022-07-28,2022,bermanfaat sekali untuk mengetahui nama alamat perusahaan baru start up terimakasih,14,11,bermanfaat sekali untuk mengetahui nama alamat perusahaan baru memulai up terima kasih,11,12,"['bermanfaat', 'sekali', 'untuk', 'mengetahui', 'nama', 'alamat', 'perusahaan', 'baru', 'memulai', 'up', 'terima', 'kasih']","['bermanfaat', 'nama', 'alamat', 'perusahaan', 'up', 'terima', 'kasih']",12,7,5,manfaat nama alamat usaha up terima kasih,7,7
Sangat berguna dan praktis,positif,2023-12-03,2023,sangat berguna dan praktis,4,4,sangat berguna dan praktis,4,4,"['sangat', 'berguna', 'dan', 'praktis']","['berguna', 'praktis']",4,2,2,guna praktis,2,2
kok tidak bisa upload video,negatif,2020-10-01,2020,kok tidak bisa upload video,5,5,kok tidak bisa unggah video,5,5,"['kok', 'tidak', 'bisa', 'unggah', 'video']","['tidak', 'unggah', 'video']",5,3,2,tidak unggah video,3,3
"Beda dgn yg lain ,Jd bnyk kenal Teman baru dari berbagai bidang pekerjaan,trmksh LinkedIn",positif,2020-09-29,2020,beda dgn yg lain jd bnyk kenal teman baru dari berbagai bidang pekerjaan trmksh linkedin,14,15,beda dengan yang lain jadi banyak kenal teman baru dari berbagai bidang pekerjaan terima kasih linkedin,15,16,"['beda', 'dengan', 'yang', 'lain', 'jadi', 'banyak', 'kenal', 'teman', 'baru', 'dari', 'berbagai', 'bidang', 'pekerjaan', 'terima', 'kasih', 'linkedin']","['beda', 'kenal', 'teman', 'bidang', 'pekerjaan', 'terima', 'kasih', 'linkedin']",16,8,8,beda kenal teman bidang kerja terima kasih linkedin,8,8
Ganti foto gagal terus,negatif,2020-03-08,2020,ganti foto gagal terus,4,4,ganti foto gagal terus,4,4,"['ganti', 'foto', 'gagal', 'terus']","['ganti', 'foto', 'gagal']",4,3,1,ganti foto gagal,3,3
Semoga karya karya lebi berkembang lagi,positif,2020-03-15,2020,semoga karya karya lebi berkembang lagi,6,6,semoga karya karya lebih berkembang lagi,6,6,"['semoga', 'karya', 'karya', 'lebih', 'berkembang', 'lagi']","['semoga', 'karya', 'karya', 'berkembang']",6,4,2,moga karya karya kembang,4,4
Alhamdulillah di mudahken jalannya selanjutnya terserah Alloh SWT deh...?,positif,2022-10-09,2022,alhamdulillah di mudahken jalannya selanjutnya terserah alloh swt deh,9,9,alhamdulillah di mudahken jalannya selanjutnya terserah alloh swt deh,9,9,"['alhamdulillah', 'di', 'mudahken', 'jalannya', 'selanjutnya', 'terserah', 'alloh', 'swt', 'deh']","['alhamdulillah', 'mudahken', 'jalannya', 'terserah', 'alloh', 'swt', 'deh']",9,7,2,alhamdulillah mudahken jalan serah alloh swt deh,7,7
Profesional dan helpfullness,positif,2020-10-18,2020,profesional dan helpfullness,3,3,profesional dan helpfullness,3,3,"['profesional', 'dan', 'helpfullness']","['profesional', 'helpfullness']",3,2,1,profesional helpfullness,2,2
"Aplikasi tak bisa di download, buruk amat ini",negatif,2022-11-10,2022,aplikasi tak bisa di download buruk amat ini,8,8,aplikasi tidak bisa di unduh buruk amat ini,8,8,"['aplikasi', 'tidak', 'bisa', 'di', 'unduh', 'buruk', 'amat', 'ini']","['aplikasi', 'tidak', 'unduh', 'buruk']",8,4,4,aplikasi tidak unduh buruk,4,4
Ada yg gak beres ini dgn kode verifikasi nya,negatif,2023-03-12,2023,ada yg gak beres ini dgn kode verifikasi nya,9,9,ada yang tidak beres ini dengan kode verifikasi nya,9,9,"['ada', 'yang', 'tidak', 'beres', 'ini', 'dengan', 'kode', 'verifikasi', 'nya']","['tidak', 'beres', 'kode', 'verifikasi', 'nya']",9,5,4,tidak beres kode verifikasi nya,5,5
Sangat beguna dan membantu,positif,2021-01-10,2021,sangat beguna dan membantu,4,4,sangat beguna dan membantu,4,4,"['sangat', 'beguna', 'dan', 'membantu']","['beguna', 'membantu']",4,2,2,beguna bantu,2,2
"Gk bsa kebuka , verifikasiggl trus , ribet",negatif,2021-08-10,2021,gk bsa kebuka verifikasiggl trus ribet,8,6,tidak bisa kebuka verifikasiggl terus rumit,6,6,"['tidak', 'bisa', 'kebuka', 'verifikasiggl', 'terus', 'rumit']","['tidak', 'kebuka', 'verifikasiggl', 'rumit']",6,4,2,tidak buka verifikasiggl rumit,4,4
Mencari pekerjaan dan pertemanan,positif,2020-02-02,2020,mencari pekerjaan dan pertemanan,4,4,mencari pekerjaan dan pertemanan,4,4,"['mencari', 'pekerjaan', 'dan', 'pertemanan']","['mencari', 'pekerjaan', 'pertemanan']",4,3,1,cari kerja teman,3,3
Sangat membantu mencari info kerja,positif,2021-12-02,2021,sangat membantu mencari info kerja,5,5,sangat membantu mencari informasi kerja,5,5,"['sangat', 'membantu', 'mencari', 'informasi', 'kerja']","['membantu', 'mencari', 'informasi', 'kerja']",5,4,1,bantu cari informasi kerja,4,4
"Luar biasa, Sangat Membantu",positif,2022-01-30,2022,luar biasa sangat membantu,4,4,luar biasa sangat membantu,4,4,"['luar', 'biasa', 'sangat', 'membantu']",['membantu'],4,1,3,bantu,1,1
"Tiba tiba tidak bisa akses akun, gk tau kenapa",negatif,2020-06-25,2020,tiba tiba tidak bisa akses akun gk tau kenapa,9,9,tiba tiba tidak bisa akses akun tidak tahu kenapa,9,9,"['tiba', 'tiba', 'tidak', 'bisa', 'akses', 'akun', 'tidak', 'tahu', 'kenapa']","['tidak', 'akses', 'akun', 'tidak']",9,4,5,tidak akses akun tidak,4,4
Top aplikasi LinkedIn semoga sukses selalu,positif,2020-06-25,2020,top aplikasi linkedin semoga sukses selalu,6,6,top aplikasi linkedin semoga sukses selalu,6,6,"['top', 'aplikasi', 'linkedin', 'semoga', 'sukses', 'selalu']","['top', 'aplikasi', 'linkedin', 'semoga', 'sukses']",6,5,1,top aplikasi linkedin moga sukses,5,5
Aplikasi yang sangat baik dan bermanfaat untuk saya,positif,2020-06-08,2020,aplikasi yang sangat baik dan bermanfaat untuk saya,8,8,aplikasi yang sangat baik dan bermanfaat untuk saya,8,8,"['aplikasi', 'yang', 'sangat', 'baik', 'dan', 'bermanfaat', 'untuk', 'saya']","['aplikasi', 'bermanfaat']",8,2,6,aplikasi manfaat,2,2
"Apk ga bermutu,login trs ga kelar²",negatif,2023-08-15,2023,apk ga bermutu login trs ga kelar²,6,7,aplikasi tidak bermutu login terus tidak kelar²,7,7,"['aplikasi', 'tidak', 'bermutu', 'login', 'terus', 'tidak', 'kelar²']","['aplikasi', 'tidak', 'bermutu', 'login', 'tidak', 'kelar²']",7,6,1,aplikasi tidak mutu login tidak kelar,6,6
Simple dan akurat,positif,2020-06-08,2020,simple dan akurat,3,3,simpel dan akurat,3,3,"['simpel', 'dan', 'akurat']","['simpel', 'akurat']",3,2,1,simpel akurat,2,2
"TOLONG KEPADA PIHAK LINKEDIN, AKUN SAYA DI HACK/DI BAJAK , SAYA TIDAK BISA LOGIN,",negatif,2023-10-21,2023,tolong kepada pihak linkedin akun saya di hack di bajak saya tidak bisa login,14,14,tolong kepada pihak linkedin akun saya di hack di bajak saya tidak bisa login,14,14,"['tolong', 'kepada', 'pihak', 'linkedin', 'akun', 'saya', 'di', 'hack', 'di', 'bajak', 'saya', 'tidak', 'bisa', 'login']","['tolong', 'linkedin', 'akun', 'hack', 'bajak', 'tidak', 'login']",14,7,7,tolong linkedin akun hack bajak tidak login,7,7
Aplikasi bagus tapi penuh rasa deg2an👍👍👍,positif,2021-10-27,2021,aplikasi bagus tapi penuh rasa deg an,6,7,aplikasi bagus tapi penuh rasa deg an,7,7,"['aplikasi', 'bagus', 'tapi', 'penuh', 'rasa', 'deg', 'an']","['aplikasi', 'bagus', 'penuh', 'deg', 'an']",7,5,2,aplikasi bagus penuh deg an,5,5
Semoga bisa mudah dan lancar dapat pekerjaan yg sesuai kemampuan saya. 🙏Amin🤲.,positif,2020-11-04,2020,semoga bisa mudah dan lancar dapat pekerjaan yg sesuai kemampuan saya amin,12,12,semoga bisa mudah dan lancar dapat pekerjaan yang sesuai kemampuan saya aamiin,12,12,"['semoga', 'bisa', 'mudah', 'dan', 'lancar', 'dapat', 'pekerjaan', 'yang', 'sesuai', 'kemampuan', 'saya', 'aamiin']","['semoga', 'mudah', 'lancar', 'pekerjaan', 'sesuai', 'kemampuan', 'aamiin']",12,7,5,moga mudah lancar kerja sesuai mampu aamiin,7,7
"Luar biasa aplikasi ini, sangat puas menggunakan",positif,2023-05-08,2023,luar biasa aplikasi ini sangat puas menggunakan,7,7,luar biasa aplikasi ini sangat puas menggunakan,7,7,"['luar', 'biasa', 'aplikasi', 'ini', 'sangat', 'puas', 'menggunakan']","['aplikasi', 'puas']",7,2,5,aplikasi puas,2,2
Sangat membantu,positif,2024-05-27,2024,sangat membantu,2,2,sangat membantu,2,2,"['sangat', 'membantu']",['membantu'],2,1,1,bantu,1,1
Fotonya kok disebarluaskan tanpa hak izin ya ???,negatif,2022-08-29,2022,fotonya kok disebarluaskan tanpa hak izin ya,8,7,fotonya kok disebarluaskan tanpa hak izin ya,7,7,"['fotonya', 'kok', 'disebarluaskan', 'tanpa', 'hak', 'izin', 'ya']","['fotonya', 'disebarluaskan', 'hak', 'izin', 'ya']",7,5,2,foto disebarluaskan hak izin ya,5,5
Aplikasi ini sangat bagus sekali saya kasi bintang 5 jooooozzzz,positif,2022-01-14,2022,aplikasi ini sangat bagus sekali saya kasi bintang jooooozzzz,10,9,aplikasi ini sangat bagus sekali saya kasih bintang jooooozzzz,9,9,"['aplikasi', 'ini', 'sangat', 'bagus', 'sekali', 'saya', 'kasih', 'bintang', 'jooooozzzz']","['aplikasi', 'bagus', 'kasih', 'bintang', 'jooooozzzz']",9,5,4,aplikasi bagus kasih bintang jooooozzzz,5,5
Aplikasi ngga jelas,negatif,2024-05-29,2024,aplikasi ngga jelas,3,3,aplikasi tidak jelas,3,3,"['aplikasi', 'tidak', 'jelas']","['aplikasi', 'tidak']",3,2,1,aplikasi tidak,2,2
Banyak hal hal menarik yang bisa didapatkan,positif,2020-06-24,2020,banyak hal hal menarik yang bisa didapatkan,7,7,banyak hal hal menarik yang bisa didapatkan,7,7,"['banyak', 'hal', 'hal', 'menarik', 'yang', 'bisa', 'didapatkan']","['menarik', 'didapatkan']",7,2,5,tarik dapat,2,2
App ne sangat bagus dan penting bgi kita,positif,2021-08-21,2021,app ne sangat bagus dan penting bgi kita,8,8,aplikasi ne sangat bagus dan penting bgi kita,8,8,"['aplikasi', 'ne', 'sangat', 'bagus', 'dan', 'penting', 'bgi', 'kita']","['aplikasi', 'ne', 'bagus', 'bgi']",8,4,4,aplikasi ne bagus bgi,4,4
Godt luck Dengan aplikasi ini .kita bisa mudah mengetahui informasi seputar lo2ker. Kereeen bngt aplikasi ini,positif,2020-04-17,2020,godt luck dengan aplikasi ini kita bisa mudah mengetahui informasi seputar lo ker kereeen bngt aplikasi ini,16,17,godt luck dengan aplikasi ini kita bisa mudah mengetahui informasi seputar lo ker kereeen banget aplikasi ini,17,17,"['godt', 'luck', 'dengan', 'aplikasi', 'ini', 'kita', 'bisa', 'mudah', 'mengetahui', 'informasi', 'seputar', 'lo', 'ker', 'kereeen', 'banget', 'aplikasi', 'ini']","['godt', 'luck', 'aplikasi', 'mudah', 'informasi', 'seputar', 'lo', 'ker', 'kereeen', 'banget', 'aplikasi']",17,11,6,godt luck aplikasi mudah informasi putar lo ker kereeen banget aplikasi,11,11
Menjadikan mudah dalam hal,positif,2021-06-20,2021,menjadikan mudah dalam hal,4,4,menjadikan mudah dalam hal,4,4,"['menjadikan', 'mudah', 'dalam', 'hal']","['menjadikan', 'mudah']",4,2,2,jadi mudah,2,2
Cara verifikasi yg sangat ribet menyebabkan susah log in,negatif,2023-05-30,2023,cara verifikasi yg sangat ribet menyebabkan susah log in,9,9,cara verifikasi yang sangat rumit menyebabkan susah log in,9,9,"['cara', 'verifikasi', 'yang', 'sangat', 'rumit', 'menyebabkan', 'susah', 'log', 'in']","['verifikasi', 'rumit', 'menyebabkan', 'susah', 'log', 'in']",9,6,3,verifikasi rumit sebab susah log in,6,6
Aplikasi apaan ini mau daftar aj ga bisa²,negatif,2022-04-18,2022,aplikasi apaan ini mau daftar aj ga bisa²,8,8,aplikasi apa ini mau daftar saja tidak bisa²,8,8,"['aplikasi', 'apa', 'ini', 'mau', 'daftar', 'saja', 'tidak', 'bisa²']","['aplikasi', 'daftar', 'tidak', 'bisa²']",8,4,4,aplikasi daftar tidak bisa,4,4
aplikasi nya bagus jadi banyak teman......,positif,2022-04-12,2022,aplikasi nya bagus jadi banyak teman,6,6,aplikasi nya bagus jadi banyak teman,6,6,"['aplikasi', 'nya', 'bagus', 'jadi', 'banyak', 'teman']","['aplikasi', 'nya', 'bagus', 'teman']",6,4,2,aplikasi nya bagus teman,4,4
Sangat inspiratif dan informatif,positif,2024-02-01,2024,sangat inspiratif dan informatif,4,4,sangat inspiratif dan informatif,4,4,"['sangat', 'inspiratif', 'dan', 'informatif']","['inspiratif', 'informatif']",4,2,2,inspiratif informatif,2,2
Bagus dan menguntungkan,positif,2022-04-15,2022,bagus dan menguntungkan,3,3,bagus dan menguntungkan,3,3,"['bagus', 'dan', 'menguntungkan']","['bagus', 'menguntungkan']",3,2,1,bagus untung,2,2
Banyak iklannya,negatif,2023-11-26,2023,banyak iklannya,2,2,banyak iklannya,2,2,"['banyak', 'iklannya']",['iklannya'],2,1,1,iklan,1,1
Mantap dan penuh info akurat,positif,2022-01-02,2022,mantap dan penuh info akurat,5,5,mantap dan penuh informasi akurat,5,5,"['mantap', 'dan', 'penuh', 'informasi', 'akurat']","['mantap', 'penuh', 'informasi', 'akurat']",5,4,1,mantap penuh informasi akurat,4,4
Sangat berguna dan begitu banyak peluang,positif,2021-02-14,2021,sangat berguna dan begitu banyak peluang,6,6,sangat berguna dan begitu banyak peluang,6,6,"['sangat', 'berguna', 'dan', 'begitu', 'banyak', 'peluang']","['berguna', 'peluang']",6,2,4,guna peluang,2,2
Mantap untuk info pekerjaan semoga bisa rezeki,positif,2022-05-12,2022,mantap untuk info pekerjaan semoga bisa rezeki,7,7,mantap untuk informasi pekerjaan semoga bisa rezeki,7,7,"['mantap', 'untuk', 'informasi', 'pekerjaan', 'semoga', 'bisa', 'rezeki']","['mantap', 'informasi', 'pekerjaan', 'semoga', 'rezeki']",7,5,2,mantap informasi kerja moga rezeki,5,5
Aplikasi linkedin bersifat publik,positif,2022-12-30,2022,aplikasi linkedin bersifat publik,4,4,aplikasi linkedin bersifat publik,4,4,"['aplikasi', 'linkedin', 'bersifat', 'publik']","['aplikasi', 'linkedin', 'bersifat', 'publik']",4,4,0,aplikasi linkedin sifat publik,4,4
Saya bingung kenapa akun saya tiba tiba non aktif setelah up date..,negatif,2020-02-21,2020,saya bingung kenapa akun saya tiba tiba non aktif setelah up date,12,12,saya bingung kenapa akun saya tiba tiba non aktif setelah up date,12,12,"['saya', 'bingung', 'kenapa', 'akun', 'saya', 'tiba', 'tiba', 'non', 'aktif', 'setelah', 'up', 'date']","['bingung', 'akun', 'non', 'aktif', 'up', 'date']",12,6,6,bingung akun non aktif up date,6,6
Mantap luar biasa,positif,2024-07-09,2024,mantap luar biasa,3,3,mantap luar biasa,3,3,"['mantap', 'luar', 'biasa']",['mantap'],3,1,2,mantap,1,1
Buat akun aja dbikin ribet gk bisa Apk gk jls!,negatif,2021-10-03,2021,buat akun aja dbikin ribet gk bisa apk gk jls,10,10,buat akun saja dbikin rumit tidak bisa aplikasi tidak jls,10,10,"['buat', 'akun', 'saja', 'dbikin', 'rumit', 'tidak', 'bisa', 'aplikasi', 'tidak', 'jls']","['akun', 'dbikin', 'rumit', 'tidak', 'aplikasi', 'tidak', 'jls']",10,7,3,akun dbikin rumit tidak aplikasi tidak jls,7,7
"Belom dapat kerja, kalo udah dapat, nanti saya kasih bintang 5",negatif,2020-03-21,2020,belom dapat kerja kalo udah dapat nanti saya kasih bintang,11,10,belum dapat kerja kalau sudah dapat nanti saya kasih bintang,10,10,"['belum', 'dapat', 'kerja', 'kalau', 'sudah', 'dapat', 'nanti', 'saya', 'kasih', 'bintang']","['kerja', 'kasih', 'bintang']",10,3,7,kerja kasih bintang,3,3
"Kenapa ribet banget ya ,giliran mau pencet lamaran perusahaan nya malah menuju ke yang lain",negatif,2022-10-21,2022,kenapa ribet banget ya giliran mau pencet lamaran perusahaan nya malah menuju ke yang lain,15,15,kenapa rumit banget ya giliran mau tekan lamaran perusahaan nya bahkan menuju ke yang lain,15,15,"['kenapa', 'rumit', 'banget', 'ya', 'giliran', 'mau', 'tekan', 'lamaran', 'perusahaan', 'nya', 'bahkan', 'menuju', 'ke', 'yang', 'lain']","['rumit', 'banget', 'ya', 'giliran', 'tekan', 'lamaran', 'perusahaan', 'nya']",15,8,7,rumit banget ya gilir tekan lamar usaha nya,8,8
"Kenapa saat akan melamar pekerjaan dialihkan ke aplikasi atau website lain,dan harus buat akun?",negatif,2020-11-27,2020,kenapa saat akan melamar pekerjaan dialihkan ke aplikasi atau website lain dan harus buat akun,14,15,kenapa saat akan melamar pekerjaan dialihkan ke aplikasi atau website lain dan harus buat akun,15,15,"['kenapa', 'saat', 'akan', 'melamar', 'pekerjaan', 'dialihkan', 'ke', 'aplikasi', 'atau', 'website', 'lain', 'dan', 'harus', 'buat', 'akun']","['melamar', 'pekerjaan', 'dialihkan', 'aplikasi', 'website', 'akun']",15,6,9,lamar kerja alih aplikasi website akun,6,6
Aplikasi yang cocok untuk jobseeker,positif,2021-06-06,2021,aplikasi yang cocok untuk jobseeker,5,5,aplikasi yang cocok untuk jobseeker,5,5,"['aplikasi', 'yang', 'cocok', 'untuk', 'jobseeker']","['aplikasi', 'cocok', 'jobseeker']",5,3,2,aplikasi cocok jobseeker,3,3
LinkedIn saya error tidak bisa membuat status,negatif,2021-12-28,2021,linkedin saya error tidak bisa membuat status,7,7,linkedin saya error tidak bisa membuat status,7,7,"['linkedin', 'saya', 'error', 'tidak', 'bisa', 'membuat', 'status']","['linkedin', 'error', 'tidak', 'status']",7,4,3,linkedin error tidak status,4,4
Verifikasinya terlalu sulit.,negatif,2022-02-14,2022,verifikasinya terlalu sulit,3,3,verifikasinya terlalu sulit,3,3,"['verifikasinya', 'terlalu', 'sulit']","['verifikasinya', 'sulit']",3,2,1,verifikasi sulit,2,2
Terimakasih kepada tweter kami telah bisa masuk kembali,positif,2022-11-08,2022,terimakasih kepada tweter kami telah bisa masuk kembali,8,8,terima kasih kepada tweter kami telah bisa masuk kembali,8,9,"['terima', 'kasih', 'kepada', 'tweter', 'kami', 'telah', 'bisa', 'masuk', 'kembali']","['terima', 'kasih', 'tweter', 'masuk']",9,4,5,terima kasih tweter masuk,4,4
Kenapa akun saya sering dibatasi dan gk slalu gk bisa login,negatif,2023-12-01,2023,kenapa akun saya sering dibatasi dan gk slalu gk bisa login,11,11,kenapa akun saya sering dibatasi dan tidak selalu tidak bisa login,11,11,"['kenapa', 'akun', 'saya', 'sering', 'dibatasi', 'dan', 'tidak', 'selalu', 'tidak', 'bisa', 'login']","['akun', 'dibatasi', 'tidak', 'tidak', 'login']",11,5,6,akun batas tidak tidak login,5,5
susah banget loginnya,negatif,2023-11-15,2023,susah banget loginnya,3,3,susah banget loginnya,3,3,"['susah', 'banget', 'loginnya']","['susah', 'banget', 'loginnya']",3,3,0,susah banget loginnya,3,3
Kenapa gak bisa buka LinkedIn padahal malam bisa..,negatif,2024-05-30,2024,kenapa gak bisa buka linkedin padahal malam bisa,8,8,kenapa tidak bisa buka linkedin padahal malam bisa,8,8,"['kenapa', 'tidak', 'bisa', 'buka', 'linkedin', 'padahal', 'malam', 'bisa']","['tidak', 'buka', 'linkedin', 'malam']",8,4,4,tidak buka linkedin malam,4,4
Gajelas websitenya udah ngisi kode captcha 5 kali gila gabut banget gabisa bisa,negatif,2024-03-04,2024,gajelas websitenya udah ngisi kode captcha kali gila gabut banget gabisa bisa,13,12,tidak jelas websitenya sudah mengisi kode captcha kali gila gabut banget tidak bisa bisa,12,14,"['tidak', 'jelas', 'websitenya', 'sudah', 'mengisi', 'kode', 'captcha', 'kali', 'gila', 'gabut', 'banget', 'tidak', 'bisa', 'bisa']","['tidak', 'websitenya', 'mengisi', 'kode', 'captcha', 'kali', 'gila', 'gabut', 'banget', 'tidak']",14,10,4,tidak websitenya isi kode captcha kali gila gabut banget tidak,10,10
"Dengan aplikasi ini membantu saya untuk mengembangkan bisnis,thanks",positif,2024-02-23,2024,dengan aplikasi ini membantu saya untuk mengembangkan bisnis thanks,8,9,dengan aplikasi ini membantu saya untuk mengembangkan bisnis terima kasih,9,10,"['dengan', 'aplikasi', 'ini', 'membantu', 'saya', 'untuk', 'mengembangkan', 'bisnis', 'terima', 'kasih']","['aplikasi', 'membantu', 'mengembangkan', 'bisnis', 'terima', 'kasih']",10,6,4,aplikasi bantu kembang bisnis terima kasih,6,6
bug captcha. Ga bisa login,negatif,2023-12-14,2023,bug captcha ga bisa login,5,5,bug captcha tidak bisa login,5,5,"['bug', 'captcha', 'tidak', 'bisa', 'login']","['bug', 'captcha', 'tidak', 'login']",5,4,1,bug captcha tidak login,4,4
Ada penipuan apa aja ya di aplikasi ini? Dari investasi atau pun lowongan pekerjaan,negatif,2020-12-12,2020,ada penipuan apa aja ya di aplikasi ini dari investasi atau pun lowongan pekerjaan,14,14,ada penipuan apa saja ya di aplikasi ini dari investasi atau pun lowongan pekerjaan,14,14,"['ada', 'penipuan', 'apa', 'saja', 'ya', 'di', 'aplikasi', 'ini', 'dari', 'investasi', 'atau', 'pun', 'lowongan', 'pekerjaan']","['penipuan', 'ya', 'aplikasi', 'investasi', 'lowongan', 'pekerjaan']",14,6,8,tipu ya aplikasi investasi lowong kerja,6,6
Cepat dan akurat,positif,2021-03-03,2021,cepat dan akurat,3,3,cepat dan akurat,3,3,"['cepat', 'dan', 'akurat']","['cepat', 'akurat']",3,2,1,cepat akurat,2,2
verivikasi berkali kali g bisa bisa,negatif,2022-05-19,2022,verivikasi berkali kali g bisa bisa,6,6,verivikasi berkali kali tidak bisa bisa,6,6,"['verivikasi', 'berkali', 'kali', 'tidak', 'bisa', 'bisa']","['verivikasi', 'berkali', 'kali', 'tidak']",6,4,2,verivikasi kali kali tidak,4,4
Rekomendasi untuk menjalin hubungan kerja secara profesional,positif,2021-09-06,2021,rekomendasi untuk menjalin hubungan kerja secara profesional,7,7,rekomendasi untuk menjalin hubungan kerja secara profesional,7,7,"['rekomendasi', 'untuk', 'menjalin', 'hubungan', 'kerja', 'secara', 'profesional']","['rekomendasi', 'menjalin', 'hubungan', 'kerja', 'profesional']",7,5,2,rekomendasi jalin hubung kerja profesional,5,5
Membantu saya dalam mencari pekerjaan yang sesuai dengan bidang saya,positif,2023-08-06,2023,membantu saya dalam mencari pekerjaan yang sesuai dengan bidang saya,10,10,membantu saya dalam mencari pekerjaan yang sesuai dengan bidang saya,10,10,"['membantu', 'saya', 'dalam', 'mencari', 'pekerjaan', 'yang', 'sesuai', 'dengan', 'bidang', 'saya']","['membantu', 'mencari', 'pekerjaan', 'sesuai', 'bidang']",10,5,5,bantu cari kerja sesuai bidang,5,5
Sangat bermanfaat sekali untuk karier saya,positif,2021-05-25,2021,sangat bermanfaat sekali untuk karier saya,6,6,sangat bermanfaat sekali untuk karier saya,6,6,"['sangat', 'bermanfaat', 'sekali', 'untuk', 'karier', 'saya']","['bermanfaat', 'karier']",6,2,4,manfaat karier,2,2
Inspiratif adalah hal terbanyak yang saya dapatkan dari LinkedIn selain info loker yg sebenarnya menjadi motivasi awal saya bergabung di sini 🤭🤗,positif,2021-04-24,2021,inspiratif adalah hal terbanyak yang saya dapatkan dari linkedin selain info loker yg sebenarnya menjadi motivasi awal saya bergabung di sini,22,21,inspiratif adalah hal terbanyak yang saya dapatkan dari linkedin selain informasi loker yang sebenarnya menjadi motivasi awal saya bergabung di sini,21,21,"['inspiratif', 'adalah', 'hal', 'terbanyak', 'yang', 'saya', 'dapatkan', 'dari', 'linkedin', 'selain', 'informasi', 'loker', 'yang', 'sebenarnya', 'menjadi', 'motivasi', 'awal', 'saya', 'bergabung', 'di', 'sini']","['inspiratif', 'dapatkan', 'linkedin', 'informasi', 'loker', 'motivasi', 'bergabung']",21,7,14,inspiratif dapat linkedin informasi loker motivasi gabung,7,7
"Pertama mencoba apl nya sih, smg ada keuntungan💪",positif,2024-07-22,2024,pertama mencoba apl nya sih smg ada keuntungan,8,8,pertama mencoba aplikasi nya sih semoga ada keuntungan,8,8,"['pertama', 'mencoba', 'aplikasi', 'nya', 'sih', 'semoga', 'ada', 'keuntungan']","['mencoba', 'aplikasi', 'nya', 'sih', 'semoga', 'keuntungan']",8,6,2,coba aplikasi nya sih moga untung,6,6
"Sangat membatu,dan bermanfaat aplikasi nya👍👍👍",positif,2021-10-22,2021,sangat membatu dan bermanfaat aplikasi nya,5,6,sangat membantu dan bermanfaat aplikasi nya,6,6,"['sangat', 'membantu', 'dan', 'bermanfaat', 'aplikasi', 'nya']","['membantu', 'bermanfaat', 'aplikasi', 'nya']",6,4,2,bantu manfaat aplikasi nya,4,4
Teralalu susah blok verifikasi gambarnya..,negatif,2022-06-05,2022,teralalu susah blok verifikasi gambarnya,5,5,teralalu susah blok verifikasi gambarnya,5,5,"['teralalu', 'susah', 'blok', 'verifikasi', 'gambarnya']","['teralalu', 'susah', 'blok', 'verifikasi', 'gambarnya']",5,5,0,teralalu susah blok verifikasi gambar,5,5
Lumayan dan bisa bertemu dengan orang orang seprofesi ataupun mungkin pernah pada satu pekerjaan yang sama,positif,2021-04-08,2021,lumayan dan bisa bertemu dengan orang orang seprofesi ataupun mungkin pernah pada satu pekerjaan yang sama,16,16,lumayan dan bisa bertemu dengan orang orang seprofesi ataupun mungkin pernah pada satu pekerjaan yang sama,16,16,"['lumayan', 'dan', 'bisa', 'bertemu', 'dengan', 'orang', 'orang', 'seprofesi', 'ataupun', 'mungkin', 'pernah', 'pada', 'satu', 'pekerjaan', 'yang', 'sama']","['lumayan', 'bertemu', 'orang', 'orang', 'seprofesi', 'pekerjaan']",16,6,10,lumayan temu orang orang profesi kerja,6,6
Bagus membuat koneksi saya bertambah,positif,2020-05-23,2020,bagus membuat koneksi saya bertambah,5,5,bagus membuat koneksi saya bertambah,5,5,"['bagus', 'membuat', 'koneksi', 'saya', 'bertambah']","['bagus', 'koneksi', 'bertambah']",5,3,2,bagus koneksi tambah,3,3
Suka banget aplikasinya banyak membantuku💛💛💛,positif,2021-11-07,2021,suka banget aplikasinya banyak membantuku,5,5,suka banget aplikasi nya banyak membantuku,5,6,"['suka', 'banget', 'aplikasi', 'nya', 'banyak', 'membantuku']","['suka', 'banget', 'aplikasi', 'nya', 'membantuku']",6,5,1,suka banget aplikasi nya bantu,5,5
Bagus buat link pekerjaan,positif,2022-08-01,2022,bagus buat link pekerjaan,4,4,bagus buat link pekerjaan,4,4,"['bagus', 'buat', 'link', 'pekerjaan']","['bagus', 'link', 'pekerjaan']",4,3,1,bagus link kerja,3,3
Aplikasi ga jelas bgt msuknya susah ga guna,negatif,2021-10-24,2021,aplikasi ga jelas bgt msuknya susah ga guna,8,8,aplikasi tidak jelas banget msuknya susah tidak guna,8,8,"['aplikasi', 'tidak', 'jelas', 'banget', 'msuknya', 'susah', 'tidak', 'guna']","['aplikasi', 'tidak', 'banget', 'msuknya', 'susah', 'tidak']",8,6,2,aplikasi tidak banget msuknya susah tidak,6,6
Saya mendapatkan pekerjaan karena Linkedin,positif,2023-08-09,2023,saya mendapatkan pekerjaan karena linkedin,5,5,saya mendapatkan pekerjaan karena linkedin,5,5,"['saya', 'mendapatkan', 'pekerjaan', 'karena', 'linkedin']","['pekerjaan', 'linkedin']",5,2,3,kerja linkedin,2,2
"Ya allah stres gara"" sudah verifikasi bahwa anda manusia, Sudah selesai malah kode erorr terus maunya gimana sih min?????",negatif,2023-05-26,2023,ya allah stres gara sudah verifikasi bahwa anda manusia sudah selesai malah kode erorr terus maunya gimana sih min,19,19,ya allah stres gara sudah verifikasi bahwa anda manusia sudah selesai bahkan kode erorr terus maunya bagaimana sih minimal,19,19,"['ya', 'allah', 'stres', 'gara', 'sudah', 'verifikasi', 'bahwa', 'anda', 'manusia', 'sudah', 'selesai', 'bahkan', 'kode', 'erorr', 'terus', 'maunya', 'bagaimana', 'sih', 'minimal']","['ya', 'allah', 'stres', 'gara', 'verifikasi', 'manusia', 'selesai', 'kode', 'erorr', 'maunya', 'sih', 'minimal']",19,12,7,ya allah stres gara verifikasi manusia selesai kode erorr mau sih minimal,12,12
Ini verifikasi nya bagaimana ya? Mohon diperbaiki!,negatif,2022-03-22,2022,ini verifikasi nya bagaimana ya mohon diperbaiki,7,7,ini verifikasi nya bagaimana ya mohon di perbaiki,7,8,"['ini', 'verifikasi', 'nya', 'bagaimana', 'ya', 'mohon', 'di', 'perbaiki']","['verifikasi', 'nya', 'ya', 'mohon', 'perbaiki']",8,5,3,verifikasi nya ya mohon baik,5,5
Salut buat LinkedIn!!,positif,2024-07-03,2024,salut buat linkedin,3,3,salut buat linkedin,3,3,"['salut', 'buat', 'linkedin']","['salut', 'linkedin']",3,2,1,salut linkedin,2,2
Masak gagal posting terus kenapa ya,negatif,2023-07-28,2023,masak gagal posting terus kenapa ya,6,6,masak gagal posting terus kenapa ya,6,6,"['masak', 'gagal', 'posting', 'terus', 'kenapa', 'ya']","['masak', 'gagal', 'posting', 'ya']",6,4,2,masak gagal posting ya,4,4
Sangat menolong untuk dunia kerja,positif,2021-06-20,2021,sangat menolong untuk dunia kerja,5,5,sangat menolong untuk dunia kerja,5,5,"['sangat', 'menolong', 'untuk', 'dunia', 'kerja']","['menolong', 'dunia', 'kerja']",5,3,2,tolong dunia kerja,3,3
Belajar jadi lebih baik,positif,2024-07-24,2024,belajar jadi lebih baik,4,4,belajar jadi lebih baik,4,4,"['belajar', 'jadi', 'lebih', 'baik']",['belajar'],4,1,3,ajar,1,1
Bagus bisa membantu,positif,2024-03-30,2024,bagus bisa membantu,3,3,bagus bisa membantu,3,3,"['bagus', 'bisa', 'membantu']","['bagus', 'membantu']",3,2,1,bagus bantu,2,2
Saya Suka Aplikasi ini Dapat Membantu Saya The best,positif,2020-12-26,2020,saya suka aplikasi ini dapat membantu saya the best,9,9,saya suka aplikasi ini dapat membantu saya the terbaik,9,9,"['saya', 'suka', 'aplikasi', 'ini', 'dapat', 'membantu', 'saya', 'the', 'terbaik']","['suka', 'aplikasi', 'membantu', 'the', 'terbaik']",9,5,4,suka aplikasi bantu the baik,5,5
Sekarang ribet hrus verif gambar malah salah mulu. Ga mutu,negatif,2021-09-06,2021,sekarang ribet hrus verif gambar malah salah mulu ga mutu,10,10,sekarang rumit harus verif gambar bahkan salah mulu tidak mutu,10,10,"['sekarang', 'rumit', 'harus', 'verif', 'gambar', 'bahkan', 'salah', 'mulu', 'tidak', 'mutu']","['rumit', 'verif', 'gambar', 'salah', 'mulu', 'tidak', 'mutu']",10,7,3,rumit verif gambar salah mulu tidak mutu,7,7
Sangat membantu memberikan informasi,positif,2021-07-04,2021,sangat membantu memberikan informasi,4,4,sangat membantu memberikan informasi,4,4,"['sangat', 'membantu', 'memberikan', 'informasi']","['membantu', 'informasi']",4,2,2,bantu informasi,2,2
"apaan..mau masuk lg gak bs,ngisi chapcta gagal terus..kocak",negatif,2023-04-12,2023,apaan mau masuk lg gak bs ngisi chapcta gagal terus kocak,8,11,apa mau masuk lagi tidak bisa mengisi chapcta gagal terus kocak,11,11,"['apa', 'mau', 'masuk', 'lagi', 'tidak', 'bisa', 'mengisi', 'chapcta', 'gagal', 'terus', 'kocak']","['masuk', 'tidak', 'mengisi', 'chapcta', 'gagal', 'kocak']",11,6,5,masuk tidak isi chapcta gagal kocak,6,6
"kode keamanan sulit, bikin pusing",negatif,2022-05-01,2022,kode keamanan sulit bikin pusing,5,5,kode keamanan sulit bikin pusing,5,5,"['kode', 'keamanan', 'sulit', 'bikin', 'pusing']","['kode', 'keamanan', 'sulit', 'bikin', 'pusing']",5,5,0,kode aman sulit bikin pusing,5,5
Jaringan yang amat luas....very much,positif,2021-11-04,2021,jaringan yang amat luas very much,5,6,jaringan yang amat luas sangat much,6,6,"['jaringan', 'yang', 'amat', 'luas', 'sangat', 'much']","['jaringan', 'luas', 'much']",6,3,3,jaring luas much,3,3
Pertemanan tanpa batas. Dari kasta terendah sampai kasta tertinggi ada disini.👌👌👌,positif,2022-04-16,2022,pertemanan tanpa batas dari kasta terendah sampai kasta tertinggi ada disini,11,11,pertemanan tanpa batas dari kasta terendah sampai kasta tertinggi ada disini,11,11,"['pertemanan', 'tanpa', 'batas', 'dari', 'kasta', 'terendah', 'sampai', 'kasta', 'tertinggi', 'ada', 'disini']","['pertemanan', 'batas', 'kasta', 'terendah', 'kasta', 'tertinggi']",11,6,5,teman batas kasta rendah kasta tinggi,6,6
Menambah wawasan untuk meningkatkan karir,positif,2022-03-18,2022,menambah wawasan untuk meningkatkan karir,5,5,menambah wawasan untuk meningkatkan karir,5,5,"['menambah', 'wawasan', 'untuk', 'meningkatkan', 'karir']","['menambah', 'wawasan', 'meningkatkan', 'karir']",5,4,1,tambah wawas tingkat karir,4,4
Aplikasi yg bagus untuk memperluas network,positif,2023-08-28,2023,aplikasi yg bagus untuk memperluas network,6,6,aplikasi yang bagus untuk memperluas network,6,6,"['aplikasi', 'yang', 'bagus', 'untuk', 'memperluas', 'network']","['aplikasi', 'bagus', 'memperluas', 'network']",6,4,2,aplikasi bagus luas network,4,4
Sangat membantu didunia kerja,positif,2021-11-05,2021,sangat membantu didunia kerja,4,4,sangat membantu didunia kerja,4,4,"['sangat', 'membantu', 'didunia', 'kerja']","['membantu', 'didunia', 'kerja']",4,3,1,bantu dunia kerja,3,3
"Tidak bisa login akun saya, padahal itu tempat bisnis saya",negatif,2023-08-21,2023,tidak bisa login akun saya padahal itu tempat bisnis saya,10,10,tidak bisa login akun saya padahal itu tempat bisnis saya,10,10,"['tidak', 'bisa', 'login', 'akun', 'saya', 'padahal', 'itu', 'tempat', 'bisnis', 'saya']","['tidak', 'login', 'akun', 'bisnis']",10,4,6,tidak login akun bisnis,4,4
masuknya sulit sekali disuruh tebak gambar segala saya bukan robot,negatif,2022-10-10,2022,masuknya sulit sekali disuruh tebak gambar segala saya bukan robot,10,10,masuknya sulit sekali disuruh tebak gambar segala saya bukan robot,10,10,"['masuknya', 'sulit', 'sekali', 'disuruh', 'tebak', 'gambar', 'segala', 'saya', 'bukan', 'robot']","['masuknya', 'sulit', 'disuruh', 'tebak', 'gambar', 'robot']",10,6,4,masuk sulit suruh tebak gambar robot,6,6
login sudah kebanyakan bla...bla... akun di hack lagi,negatif,2023-05-15,2023,login sudah kebanyakan bla bla akun di hack lagi,8,9,login sudah kebanyakan bla bla akun di hack lagi,9,9,"['login', 'sudah', 'kebanyakan', 'bla', 'bla', 'akun', 'di', 'hack', 'lagi']","['login', 'kebanyakan', 'bla', 'bla', 'akun', 'hack']",9,6,3,login banyak bla bla akun hack,6,6
Apknya kocak gak bisa log in,negatif,2023-09-10,2023,apknya kocak gak bisa log in,6,6,aplikasinya kocak tidak bisa log in,6,6,"['aplikasinya', 'kocak', 'tidak', 'bisa', 'log', 'in']","['aplikasinya', 'kocak', 'tidak', 'log', 'in']",6,5,1,aplikasi kocak tidak log in,5,5
"Bagus Apl y, semoga sy dapat pekerjaan. Terimakasih",positif,2021-01-22,2021,bagus apl y semoga sy dapat pekerjaan terimakasih,8,8,bagus aplikasi ya semoga saya dapat pekerjaan terima kasih,8,9,"['bagus', 'aplikasi', 'ya', 'semoga', 'saya', 'dapat', 'pekerjaan', 'terima', 'kasih']","['bagus', 'aplikasi', 'ya', 'semoga', 'pekerjaan', 'terima', 'kasih']",9,7,2,bagus aplikasi ya moga kerja terima kasih,7,7
Asli dari tadi stuck di no captcha terus,negatif,2023-12-21,2023,asli dari tadi stuck di no captcha terus,8,8,asli dari tadi stuck di nomor captcha terus,8,8,"['asli', 'dari', 'tadi', 'stuck', 'di', 'nomor', 'captcha', 'terus']","['asli', 'stuck', 'nomor', 'captcha']",8,4,4,asli stuck nomor captcha,4,4
Aplikasi kayak asu cuma login susah amat,negatif,2023-05-07,2023,aplikasi kayak asu cuma login susah amat,7,7,aplikasi kayak asu cuma login susah amat,7,7,"['aplikasi', 'kayak', 'asu', 'cuma', 'login', 'susah', 'amat']","['aplikasi', 'kayak', 'asu', 'login', 'susah']",7,5,2,aplikasi kayak asu login susah,5,5
Menyenangkan terhubung dengan orang2 hebat,positif,2023-12-24,2023,menyenangkan terhubung dengan orang hebat,5,5,menyenangkan terhubung dengan orang hebat,5,5,"['menyenangkan', 'terhubung', 'dengan', 'orang', 'hebat']","['menyenangkan', 'terhubung', 'orang', 'hebat']",5,4,1,senang hubung orang hebat,4,4
Sistem sering error,negatif,2020-02-27,2020,sistem sering error,3,3,sistem sering error,3,3,"['sistem', 'sering', 'error']","['sistem', 'error']",3,2,1,sistem error,2,2
mau verifikasi aja susah banget lah pusing,negatif,2021-09-21,2021,mau verifikasi aja susah banget lah pusing,7,7,mau verifikasi saja susah banget lah pusing,7,7,"['mau', 'verifikasi', 'saja', 'susah', 'banget', 'lah', 'pusing']","['verifikasi', 'susah', 'banget', 'pusing']",7,4,3,verifikasi susah banget pusing,4,4
Sangat membantu,positif,2024-08-17,2024,sangat membantu,2,2,sangat membantu,2,2,"['sangat', 'membantu']",['membantu'],2,1,1,bantu,1,1
Membantu sekali bagi saya yg sedang mencari kerja,positif,2021-03-23,2021,membantu sekali bagi saya yg sedang mencari kerja,8,8,membantu sekali bagi saya yang sedang mencari kerja,8,8,"['membantu', 'sekali', 'bagi', 'saya', 'yang', 'sedang', 'mencari', 'kerja']","['membantu', 'mencari', 'kerja']",8,3,5,bantu cari kerja,3,3
Terima kasih atas aplikasinya sangat membantu sekali,positif,2020-01-26,2020,terima kasih atas aplikasinya sangat membantu sekali,7,7,terima kasih atas aplikasi nya sangat membantu sekali,7,8,"['terima', 'kasih', 'atas', 'aplikasi', 'nya', 'sangat', 'membantu', 'sekali']","['terima', 'kasih', 'aplikasi', 'nya', 'membantu']",8,5,3,terima kasih aplikasi nya bantu,5,5
Sangat membantu informasi nya,positif,2022-08-22,2022,sangat membantu informasi nya,4,4,sangat membantu informasi nya,4,4,"['sangat', 'membantu', 'informasi', 'nya']","['membantu', 'informasi', 'nya']",4,3,1,bantu informasi nya,3,3
"Bagus, ditingkatkan lagi lowongan kerja wilayah Aceh",positif,2021-06-02,2021,bagus ditingkatkan lagi lowongan kerja wilayah aceh,7,7,bagus ditingkatkan lagi lowongan kerja wilayah aceh,7,7,"['bagus', 'ditingkatkan', 'lagi', 'lowongan', 'kerja', 'wilayah', 'aceh']","['bagus', 'ditingkatkan', 'lowongan', 'kerja', 'wilayah', 'aceh']",7,6,1,bagus tingkat lowong kerja wilayah aceh,6,6
Sangat mantab semoga lebih bagus lagi,positif,2021-07-04,2021,sangat mantab semoga lebih bagus lagi,6,6,sangat mantap semoga lebih bagus lagi,6,6,"['sangat', 'mantap', 'semoga', 'lebih', 'bagus', 'lagi']","['mantap', 'semoga', 'bagus']",6,3,3,mantap moga bagus,3,3
aplikasi gajelas buat ferivikasi aja susah banget,negatif,2023-05-30,2023,aplikasi gajelas buat ferivikasi aja susah banget,7,7,aplikasi tidak jelas buat ferivikasi saja susah banget,7,8,"['aplikasi', 'tidak', 'jelas', 'buat', 'ferivikasi', 'saja', 'susah', 'banget']","['aplikasi', 'tidak', 'ferivikasi', 'susah', 'banget']",8,5,3,aplikasi tidak ferivikasi susah banget,5,5
Terima kasih Tim kerja Aplikasi LinkedIn,positif,2020-09-18,2020,terima kasih tim kerja aplikasi linkedin,6,6,terima kasih tim kerja aplikasi linkedin,6,6,"['terima', 'kasih', 'tim', 'kerja', 'aplikasi', 'linkedin']","['terima', 'kasih', 'tim', 'kerja', 'aplikasi', 'linkedin']",6,6,0,terima kasih tim kerja aplikasi linkedin,6,6
Sangat membantu memperkenalkan diri dan bisnis di LinkedIn,positif,2024-05-27,2024,sangat membantu memperkenalkan diri dan bisnis di linkedin,8,8,sangat membantu memperkenalkan diri dan bisnis di linkedin,8,8,"['sangat', 'membantu', 'memperkenalkan', 'diri', 'dan', 'bisnis', 'di', 'linkedin']","['membantu', 'memperkenalkan', 'bisnis', 'linkedin']",8,4,4,bantu kenal bisnis linkedin,4,4
Semoga cepat membantu dalam mencari pekerjaan saya,positif,2024-03-22,2024,semoga cepat membantu dalam mencari pekerjaan saya,7,7,semoga cepat membantu dalam mencari pekerjaan saya,7,7,"['semoga', 'cepat', 'membantu', 'dalam', 'mencari', 'pekerjaan', 'saya']","['semoga', 'cepat', 'membantu', 'mencari', 'pekerjaan']",7,5,2,moga cepat bantu cari kerja,5,5
"Ga guna, guwa nyari kerja mending ke orang dalem dah",negatif,2024-05-14,2024,ga guna guwa nyari kerja mending ke orang dalem dah,10,10,tidak guna guwa mencari kerja mending ke orang dalam sudah,10,10,"['tidak', 'guna', 'guwa', 'mencari', 'kerja', 'mending', 'ke', 'orang', 'dalam', 'sudah']","['tidak', 'guwa', 'mencari', 'kerja', 'mending', 'orang']",10,6,4,tidak guwa cari kerja mending orang,6,6
Aplikasi babi gak sesuai dengan apa yang diharapkan,negatif,2024-03-27,2024,aplikasi babi gak sesuai dengan apa yang diharapkan,8,8,aplikasi babi tidak sesuai dengan apa yang diharapkan,8,8,"['aplikasi', 'babi', 'tidak', 'sesuai', 'dengan', 'apa', 'yang', 'diharapkan']","['aplikasi', 'babi', 'tidak', 'sesuai', 'diharapkan']",8,5,3,aplikasi babi tidak sesuai harap,5,5
Sangat membantu cara jitu,positif,2024-05-06,2024,sangat membantu cara jitu,4,4,sangat membantu cara jitu,4,4,"['sangat', 'membantu', 'cara', 'jitu']","['membantu', 'jitu']",4,2,2,bantu jitu,2,2
Kenapa sya tidak bisa terhubung oleh orang lain kenapa ya.,negatif,2024-04-14,2024,kenapa sya tidak bisa terhubung oleh orang lain kenapa ya,10,10,kenapa saya tidak bisa terhubung oleh orang lain kenapa ya,10,10,"['kenapa', 'saya', 'tidak', 'bisa', 'terhubung', 'oleh', 'orang', 'lain', 'kenapa', 'ya']","['tidak', 'terhubung', 'orang', 'ya']",10,4,6,tidak hubung orang ya,4,4
Aplikasi rampok .saldo saya di potong tanpa pemberitahuan,negatif,2024-03-20,2024,aplikasi rampok saldo saya di potong tanpa pemberitahuan,8,8,aplikasi rampok saldo saya di potong tanpa pemberitahuan,8,8,"['aplikasi', 'rampok', 'saldo', 'saya', 'di', 'potong', 'tanpa', 'pemberitahuan']","['aplikasi', 'rampok', 'saldo', 'potong', 'pemberitahuan']",8,5,3,aplikasi rampok saldo potong pemberitahuan,5,5
Keren buat ku di mengerti impormasi bisnis bisa membantu / mendorong,positif,2024-03-21,2024,keren buat ku di mengerti impormasi bisnis bisa membantu mendorong,11,10,keren buat saya di mengerti impormasi bisnis bisa membantu mendorong,10,10,"['keren', 'buat', 'saya', 'di', 'mengerti', 'impormasi', 'bisnis', 'bisa', 'membantu', 'mendorong']","['keren', 'mengerti', 'impormasi', 'bisnis', 'membantu', 'mendorong']",10,6,4,keren erti impormasi bisnis bantu dorong,6,6
pertama mencoba semoga dapat banyat mafaatnya,positif,2024-03-07,2024,pertama mencoba semoga dapat banyat mafaatnya,6,6,pertama mencoba semoga dapat banyat mafaatnya,6,6,"['pertama', 'mencoba', 'semoga', 'dapat', 'banyat', 'mafaatnya']","['mencoba', 'semoga', 'banyat', 'mafaatnya']",6,4,2,coba moga banyat mafaatnya,4,4
"Sangat mantap, saya kasih bintang 5",positif,2024-04-12,2024,sangat mantap saya kasih bintang,6,5,sangat mantap saya kasih bintang,5,5,"['sangat', 'mantap', 'saya', 'kasih', 'bintang']","['mantap', 'kasih', 'bintang']",5,3,2,mantap kasih bintang,3,3
Suka error waktu mau kasih video pendek,negatif,2024-05-05,2024,suka error waktu mau kasih video pendek,7,7,suka error waktu mau kasih video pendek,7,7,"['suka', 'error', 'waktu', 'mau', 'kasih', 'video', 'pendek']","['suka', 'error', 'kasih', 'video', 'pendek']",7,5,2,suka error kasih video pendek,5,5
Informasi loker bagus,positif,2024-04-20,2024,informasi loker bagus,3,3,informasi loker bagus,3,3,"['informasi', 'loker', 'bagus']","['informasi', 'loker', 'bagus']",3,3,0,informasi loker bagus,3,3
Semoga mudah untuk digunakan dalam proses Kastamer,positif,2024-04-16,2024,semoga mudah untuk digunakan dalam proses kastamer,7,7,semoga mudah untuk digunakan dalam proses kastamer,7,7,"['semoga', 'mudah', 'untuk', 'digunakan', 'dalam', 'proses', 'kastamer']","['semoga', 'mudah', 'proses', 'kastamer']",7,4,3,moga mudah proses kastamer,4,4
Isi mendapat info pekerjaan,positif,2024-05-14,2024,isi mendapat info pekerjaan,4,4,isi mendapat informasi pekerjaan,4,4,"['isi', 'mendapat', 'informasi', 'pekerjaan']","['isi', 'informasi', 'pekerjaan']",4,3,1,isi informasi kerja,3,3
Baik untuk bisnis dan bersentuhan dengan owner,positif,2024-04-13,2024,baik untuk bisnis dan bersentuhan dengan owner,7,7,baik untuk bisnis dan bersentuhan dengan owner,7,7,"['baik', 'untuk', 'bisnis', 'dan', 'bersentuhan', 'dengan', 'owner']","['bisnis', 'bersentuhan', 'owner']",7,3,4,bisnis sentuh owner,3,3
"Saya puas, lebih mudah mencari pekerjaan disini",positif,2023-01-04,2023,saya puas lebih mudah mencari pekerjaan disini,7,7,saya puas lebih mudah mencari pekerjaan disini,7,7,"['saya', 'puas', 'lebih', 'mudah', 'mencari', 'pekerjaan', 'disini']","['puas', 'mudah', 'mencari', 'pekerjaan']",7,4,3,puas mudah cari kerja,4,4
Linkedin:Aplikasi ini pasang saja saya beri rating bintang lima,positif,2022-11-17,2022,linkedin aplikasi ini pasang saja saya beri rating bintang lima,9,10,linkedin aplikasi ini pasang saja saya beri rating bintang lima,10,10,"['linkedin', 'aplikasi', 'ini', 'pasang', 'saja', 'saya', 'beri', 'rating', 'bintang', 'lima']","['linkedin', 'aplikasi', 'pasang', 'rating', 'bintang']",10,5,5,linkedin aplikasi pasang rating bintang,5,5
Sulit pemeriksaan kemanannya untuk login,negatif,2021-09-18,2021,sulit pemeriksaan kemanannya untuk login,5,5,sulit pemeriksaan kemanannya untuk login,5,5,"['sulit', 'pemeriksaan', 'kemanannya', 'untuk', 'login']","['sulit', 'pemeriksaan', 'kemanannya', 'login']",5,4,1,sulit periksa keman login,4,4
padahal gapernah instal ni apk knp malah nginstal sndiri sihh ksel,negatif,2021-03-15,2021,padahal gapernah instal ni apk knp malah nginstal sndiri sihh ksel,11,11,padahal tidak pernah memasang ini aplikasi kenapa bahkan nginstal sendiri sih ksel,11,12,"['padahal', 'tidak', 'pernah', 'memasang', 'ini', 'aplikasi', 'kenapa', 'bahkan', 'nginstal', 'sendiri', 'sih', 'ksel']","['tidak', 'memasang', 'aplikasi', 'nginstal', 'sih', 'ksel']",12,6,6,tidak pasang aplikasi nginstal sih ksel,6,6
"tai emg,pertanyaan keamanan yg gambar hewan salah mulu,gajelas bgt",negatif,2021-05-01,2021,tai emg pertanyaan keamanan yg gambar hewan salah mulu gajelas bgt,9,11,tai memang pertanyaan keamanan yang gambar hewan salah mulu tidak jelas banget,11,12,"['tai', 'memang', 'pertanyaan', 'keamanan', 'yang', 'gambar', 'hewan', 'salah', 'mulu', 'tidak', 'jelas', 'banget']","['tai', 'keamanan', 'gambar', 'hewan', 'salah', 'mulu', 'tidak', 'banget']",12,8,4,tai aman gambar hewan salah mulu tidak banget,8,8
Aplikasi gk jelas verifikasinya aneh banget najis,negatif,2022-01-18,2022,aplikasi gk jelas verifikasinya aneh banget najis,7,7,aplikasi tidak jelas verifikasinya aneh banget najis,7,7,"['aplikasi', 'tidak', 'jelas', 'verifikasinya', 'aneh', 'banget', 'najis']","['aplikasi', 'tidak', 'verifikasinya', 'aneh', 'banget', 'najis']",7,6,1,aplikasi tidak verifikasi aneh banget najis,6,6
Tidak bisa di un instal..pusing deh,negatif,2023-08-12,2023,tidak bisa di un instal pusing deh,6,7,tidak bisa di un memasang pusing deh,7,7,"['tidak', 'bisa', 'di', 'un', 'memasang', 'pusing', 'deh']","['tidak', 'un', 'memasang', 'pusing', 'deh']",7,5,2,tidak un pasang pusing deh,5,5
Saya gak bisa login kenapa dan mengapa???,negatif,2021-02-06,2021,saya gak bisa login kenapa dan mengapa,7,7,saya tidak bisa login kenapa dan mengapa,7,7,"['saya', 'tidak', 'bisa', 'login', 'kenapa', 'dan', 'mengapa']","['tidak', 'login']",7,2,5,tidak login,2,2
Siapa yg tak bisa tebak gambar berarti otaknya lagi eror 😄,negatif,2022-02-15,2022,siapa yg tak bisa tebak gambar berarti otaknya lagi eror,11,10,siapa yang tidak bisa tebak gambar berarti otaknya lagi error,10,10,"['siapa', 'yang', 'tidak', 'bisa', 'tebak', 'gambar', 'berarti', 'otaknya', 'lagi', 'error']","['tidak', 'tebak', 'gambar', 'otaknya', 'error']",10,5,5,tidak tebak gambar otak error,5,5
Lebih ringan dan aplikatif,positif,2020-02-15,2020,lebih ringan dan aplikatif,4,4,lebih ringan dan aplikatif,4,4,"['lebih', 'ringan', 'dan', 'aplikatif']","['ringan', 'aplikatif']",4,2,2,ringan aplikatif,2,2
Kenapa ga bisa diverifikasi? Padahal saya sudah menjawab dengan benar,negatif,2021-03-09,2021,kenapa ga bisa diverifikasi padahal saya sudah menjawab dengan benar,10,10,kenapa tidak bisa diverifikasi padahal saya sudah menjawab dengan benar,10,10,"['kenapa', 'tidak', 'bisa', 'diverifikasi', 'padahal', 'saya', 'sudah', 'menjawab', 'dengan', 'benar']","['tidak', 'diverifikasi']",10,2,8,tidak verifikasi,2,2
Sangat membantu untuk info loker,positif,2023-08-06,2023,sangat membantu untuk info loker,5,5,sangat membantu untuk informasi loker,5,5,"['sangat', 'membantu', 'untuk', 'informasi', 'loker']","['membantu', 'informasi', 'loker']",5,3,2,bantu informasi loker,3,3
Semoga dapat membantu mencari kerja lebih baik,positif,2022-01-03,2022,semoga dapat membantu mencari kerja lebih baik,7,7,semoga dapat membantu mencari kerja lebih baik,7,7,"['semoga', 'dapat', 'membantu', 'mencari', 'kerja', 'lebih', 'baik']","['semoga', 'membantu', 'mencari', 'kerja']",7,4,3,moga bantu cari kerja,4,4
Sgt bersyukur bnyak informasi pekerjaan,positif,2020-12-08,2020,sgt bersyukur bnyak informasi pekerjaan,5,5,sangat bersyukur banyak informasi pekerjaan,5,5,"['sangat', 'bersyukur', 'banyak', 'informasi', 'pekerjaan']","['bersyukur', 'informasi', 'pekerjaan']",5,3,2,syukur informasi kerja,3,3
Kenapa saya tidak masuk akun saya.. Sedang saya tidak melanggar standart komunitas.....,negatif,2022-02-28,2022,kenapa saya tidak masuk akun saya sedang saya tidak melanggar standart komunitas,12,12,kenapa saya tidak masuk akun saya sedang saya tidak melanggar standar komunitas,12,12,"['kenapa', 'saya', 'tidak', 'masuk', 'akun', 'saya', 'sedang', 'saya', 'tidak', 'melanggar', 'standar', 'komunitas']","['tidak', 'masuk', 'akun', 'tidak', 'melanggar', 'standar', 'komunitas']",12,7,5,tidak masuk akun tidak langgar standar komunitas,7,7
verifikasi identitas tidak kelar-kelar,negatif,2023-05-24,2023,verifikasi identitas tidak kelar kelar,4,5,verifikasi identitas tidak kelar kelar,5,5,"['verifikasi', 'identitas', 'tidak', 'kelar', 'kelar']","['verifikasi', 'identitas', 'tidak', 'kelar', 'kelar']",5,5,0,verifikasi identitas tidak kelar kelar,5,5
Jaringannya universal...member-member dari Mancanegara.banyak orang -orang penting nih.,positif,2021-10-15,2021,jaringannya universal member member dari mancanegara banyak orang orang penting nih,8,11,jaringannya universal member member dari mancanegara banyak orang orang penting nih,11,11,"['jaringannya', 'universal', 'member', 'member', 'dari', 'mancanegara', 'banyak', 'orang', 'orang', 'penting', 'nih']","['jaringannya', 'universal', 'member', 'member', 'mancanegara', 'orang', 'orang', 'nih']",11,8,3,jaring universal member member mancanegara orang orang nih,8,8
Susah dimengerti. Kayak keinginan bos.,negatif,2020-09-30,2020,susah dimengerti kayak keinginan bos,5,5,susah dimengerti kayak keinginan box,5,5,"['susah', 'dimengerti', 'kayak', 'keinginan', 'box']","['susah', 'dimengerti', 'kayak', 'box']",5,4,1,susah erti kayak box,4,4
LinkedIn adalah media sosial yg bagus untuk membangun jaringan profesionalitas kerja,positif,2021-09-16,2021,linkedin adalah media sosial yg bagus untuk membangun jaringan profesionalitas kerja,11,11,linkedin adalah media sosial yang bagus untuk membangun jaringan profesionalitas kerja,11,11,"['linkedin', 'adalah', 'media', 'sosial', 'yang', 'bagus', 'untuk', 'membangun', 'jaringan', 'profesionalitas', 'kerja']","['linkedin', 'media', 'sosial', 'bagus', 'membangun', 'jaringan', 'profesionalitas', 'kerja']",11,8,3,linkedin media sosial bagus bangun jaring profesionalitas kerja,8,8
Dapat mengakses bbrp orang dg berbagai jabatan dan professionalism,positif,2021-11-07,2021,dapat mengakses bbrp orang dg berbagai jabatan dan professionalism,9,9,dapat mengakses beberapa orang dengan berbagai jabatan dan professionalism,9,9,"['dapat', 'mengakses', 'beberapa', 'orang', 'dengan', 'berbagai', 'jabatan', 'dan', 'professionalism']","['mengakses', 'orang', 'jabatan', 'professionalism']",9,4,5,akses orang jabat professionalism,4,4
Sangat membantuu,positif,2024-06-01,2024,sangat membantuu,2,2,sangat membantu,2,2,"['sangat', 'membantu']",['membantu'],2,1,1,bantu,1,1
Aplikasi y sangat membantu saya kasih 3 bintang dulu,positif,2020-11-21,2020,aplikasi y sangat membantu saya kasih bintang dulu,9,8,aplikasi ya sangat membantu saya kasih bintang dahulu,8,8,"['aplikasi', 'ya', 'sangat', 'membantu', 'saya', 'kasih', 'bintang', 'dahulu']","['aplikasi', 'ya', 'membantu', 'kasih', 'bintang']",8,5,3,aplikasi ya bantu kasih bintang,5,5
Mudah untuk mendapatkan informasi,positif,2022-06-05,2022,mudah untuk mendapatkan informasi,4,4,mudah untuk mendapatkan informasi,4,4,"['mudah', 'untuk', 'mendapatkan', 'informasi']","['mudah', 'informasi']",4,2,2,mudah informasi,2,2
Kok saya ga bisa ganti profil? Note nya gagal terus... Mohon di jelaskan,negatif,2020-05-12,2020,kok saya ga bisa ganti profil note nya gagal terus mohon di jelaskan,13,13,kok saya tidak bisa ganti profil note nya gagal terus mohon di jelaskan,13,13,"['kok', 'saya', 'tidak', 'bisa', 'ganti', 'profil', 'note', 'nya', 'gagal', 'terus', 'mohon', 'di', 'jelaskan']","['tidak', 'ganti', 'profil', 'note', 'nya', 'gagal', 'mohon']",13,7,6,tidak ganti profil note nya gagal mohon,7,7
Trima kasih dengan adanya aplikasih ini,positif,2021-06-11,2021,trima kasih dengan adanya aplikasih ini,6,6,terima kasih dengan adanya aplikasih ini,6,6,"['terima', 'kasih', 'dengan', 'adanya', 'aplikasih', 'ini']","['terima', 'kasih', 'aplikasih']",6,3,3,terima kasih aplikasih,3,3
"Saya pengguna aktif LinkedIn, Alhamdulillah saya sangat puas",positif,2022-01-10,2022,saya pengguna aktif linkedin alhamdulillah saya sangat puas,8,8,saya pengguna aktif linkedin alhamdulillah saya sangat puas,8,8,"['saya', 'pengguna', 'aktif', 'linkedin', 'alhamdulillah', 'saya', 'sangat', 'puas']","['pengguna', 'aktif', 'linkedin', 'alhamdulillah', 'puas']",8,5,3,guna aktif linkedin alhamdulillah puas,5,5
"Apl bagus, membantu saya berinteraksi lebih luas. Amazing ########## Terbaik cuci service sofa surabaya sidorajo gresik. Poles lantai cuci gordyn",positif,2022-11-21,2022,apl bagus membantu saya berinteraksi lebih luas amazing terbaik cuci service sofa surabaya sidorajo gresik poles lantai cuci gordyn,20,19,aplikasi bagus membantu saya berinteraksi lebih luas amazing terbaik cuci pelayanan sofa surabaya sidorajo gresik poles lantai cuci gordyn,19,19,"['aplikasi', 'bagus', 'membantu', 'saya', 'berinteraksi', 'lebih', 'luas', 'amazing', 'terbaik', 'cuci', 'pelayanan', 'sofa', 'surabaya', 'sidorajo', 'gresik', 'poles', 'lantai', 'cuci', 'gordyn']","['aplikasi', 'bagus', 'membantu', 'berinteraksi', 'luas', 'amazing', 'terbaik', 'cuci', 'pelayanan', 'sofa', 'surabaya', 'sidorajo', 'gresik', 'poles', 'lantai', 'cuci', 'gordyn']",19,17,2,aplikasi bagus bantu interaksi luas amazing baik cuci layan sofa surabaya sidorajo gresik poles lantai cuci gordyn,17,17
Ini bagus 👍 dan bisa melamar mudah,positif,2022-09-17,2022,ini bagus dan bisa melamar mudah,7,6,ini bagus dan bisa melamar mudah,6,6,"['ini', 'bagus', 'dan', 'bisa', 'melamar', 'mudah']","['bagus', 'melamar', 'mudah']",6,3,3,bagus lamar mudah,3,3
Berharap bisa mendapatkan koneksi dan pekerjaan yg sesuai 🙏,positif,2020-06-06,2020,berharap bisa mendapatkan koneksi dan pekerjaan yg sesuai,9,8,berharap bisa mendapatkan koneksi dan pekerjaan yang sesuai,8,8,"['berharap', 'bisa', 'mendapatkan', 'koneksi', 'dan', 'pekerjaan', 'yang', 'sesuai']","['berharap', 'koneksi', 'pekerjaan', 'sesuai']",8,4,4,harap koneksi kerja sesuai,4,4
Mau nyari lowongan pun dipersulit dengan verifikasi,negatif,2022-06-22,2022,mau nyari lowongan pun dipersulit dengan verifikasi,7,7,mau mencari lowongan pun dipersulit dengan verifikasi,7,7,"['mau', 'mencari', 'lowongan', 'pun', 'dipersulit', 'dengan', 'verifikasi']","['mencari', 'lowongan', 'dipersulit', 'verifikasi']",7,4,3,cari lowong sulit verifikasi,4,4
"Mengubah lokasi susah,gagal terus",negatif,2020-09-30,2020,mengubah lokasi susah gagal terus,4,5,mengubah lokasi susah gagal terus,5,5,"['mengubah', 'lokasi', 'susah', 'gagal', 'terus']","['mengubah', 'lokasi', 'susah', 'gagal']",5,4,1,ubah lokasi susah gagal,4,4
Sangat membantu dlm info update,positif,2021-04-21,2021,sangat membantu dlm info update,5,5,sangat membantu dalam informasi diperbarui,5,5,"['sangat', 'membantu', 'dalam', 'informasi', 'diperbarui']","['membantu', 'informasi', 'diperbarui']",5,3,2,bantu informasi baru,3,3
"Bagus,oke,lanjut bro",positif,2024-07-29,2024,bagus oke lanjut bro,2,4,bagus oke lanjut bro,4,4,"['bagus', 'oke', 'lanjut', 'bro']","['bagus', 'oke', 'bro']",4,3,1,bagus oke bro,3,3
Saya sangat terbantu untuk informasi pekerjaan.,positif,2023-03-27,2023,saya sangat terbantu untuk informasi pekerjaan,6,6,saya sangat membantu untuk informasi pekerjaan,6,6,"['saya', 'sangat', 'membantu', 'untuk', 'informasi', 'pekerjaan']","['membantu', 'informasi', 'pekerjaan']",6,3,3,bantu informasi kerja,3,3
Bagus utk menjalin relasi dan hubungan dalam dunia kerja dan dunia nyata 👌✌,positif,2021-11-29,2021,bagus utk menjalin relasi dan hubungan dalam dunia kerja dan dunia nyata,13,12,bagus untuk menjalin relasi dan hubungan dalam dunia kerja dan dunia nyata,12,12,"['bagus', 'untuk', 'menjalin', 'relasi', 'dan', 'hubungan', 'dalam', 'dunia', 'kerja', 'dan', 'dunia', 'nyata']","['bagus', 'menjalin', 'relasi', 'hubungan', 'dunia', 'kerja', 'dunia', 'nyata']",12,8,4,bagus jalin relasi hubung dunia kerja dunia nyata,8,8
Mantap aplikasi yg sangat menyenangkan,positif,2020-09-11,2020,mantap aplikasi yg sangat menyenangkan,5,5,mantap aplikasi yang sangat menyenangkan,5,5,"['mantap', 'aplikasi', 'yang', 'sangat', 'menyenangkan']","['mantap', 'aplikasi', 'menyenangkan']",5,3,2,mantap aplikasi senang,3,3
Melestarikan budaya kerja dengan cinta akan pekerjaan yang telah diembani_,positif,2021-11-06,2021,melestarikan budaya kerja dengan cinta akan pekerjaan yang telah diembani,10,10,melestarikan budaya kerja dengan cinta akan pekerjaan yang telah diembani,10,10,"['melestarikan', 'budaya', 'kerja', 'dengan', 'cinta', 'akan', 'pekerjaan', 'yang', 'telah', 'diembani']","['melestarikan', 'budaya', 'kerja', 'cinta', 'pekerjaan', 'diembani']",10,6,4,lestari budaya kerja cinta kerja emban,6,6
"Sue mau lamarnya susah amat, harus daftar kemana2, walaupun sudah berbauar 500 ribu.",negatif,2022-10-13,2022,sue mau lamarnya susah amat harus daftar kemana walaupun sudah berbauar ribu,13,12,sue mau lamarnya susah amat harus daftar kemana walaupun sudah berbauar ribu,12,12,"['sue', 'mau', 'lamarnya', 'susah', 'amat', 'harus', 'daftar', 'kemana', 'walaupun', 'sudah', 'berbauar', 'ribu']","['sue', 'lamarnya', 'susah', 'daftar', 'kemana', 'berbauar', 'ribu']",12,7,5,sue lamar susah daftar mana berbauar ribu,7,7
Sangat bagus dan membantu sekali,positif,2020-10-02,2020,sangat bagus dan membantu sekali,5,5,sangat bagus dan membantu sekali,5,5,"['sangat', 'bagus', 'dan', 'membantu', 'sekali']","['bagus', 'membantu']",5,2,3,bagus bantu,2,2
Semoga bermanfaat dan bisa dapat pekerjaan yang mantap 🤲,positif,2022-05-13,2022,semoga bermanfaat dan bisa dapat pekerjaan yang mantap,9,8,semoga bermanfaat dan bisa dapat pekerjaan yang mantap,8,8,"['semoga', 'bermanfaat', 'dan', 'bisa', 'dapat', 'pekerjaan', 'yang', 'mantap']","['semoga', 'bermanfaat', 'pekerjaan', 'mantap']",8,4,4,moga manfaat kerja mantap,4,4
link terbaik utk koneksi bisnis,positif,2020-02-12,2020,link terbaik utk koneksi bisnis,5,5,link terbaik untuk koneksi bisnis,5,5,"['link', 'terbaik', 'untuk', 'koneksi', 'bisnis']","['link', 'terbaik', 'koneksi', 'bisnis']",5,4,1,link baik koneksi bisnis,4,4
Wahh aplikasi luar biasaa wajib buat download,positif,2022-02-15,2022,wahh aplikasi luar biasaa wajib buat download,7,7,wah aplikasi luar biasaa wajib buat unduh,7,7,"['wah', 'aplikasi', 'luar', 'biasaa', 'wajib', 'buat', 'unduh']","['aplikasi', 'biasaa', 'wajib', 'unduh']",7,4,3,aplikasi biasaa wajib unduh,4,4
"Melamar pekerjaan melalui linkedln,sagat membantu sy utk mencari pekerjan yang cocok utk saya,trimksh linkedln",positif,2021-02-10,2021,melamar pekerjaan melalui linkedln sagat membantu sy utk mencari pekerjan yang cocok utk saya trimksh linkedln,14,16,melamar pekerjaan melalui linkedln sagat membantu saya untuk mencari pekerjan yang cocok untuk saya trimksh linkedln,16,16,"['melamar', 'pekerjaan', 'melalui', 'linkedln', 'sagat', 'membantu', 'saya', 'untuk', 'mencari', 'pekerjan', 'yang', 'cocok', 'untuk', 'saya', 'trimksh', 'linkedln']","['melamar', 'pekerjaan', 'linkedln', 'sagat', 'membantu', 'mencari', 'pekerjan', 'cocok', 'trimksh', 'linkedln']",16,10,6,lamar kerja linkedln sagat bantu cari pekerjan cocok trimksh linkedln,10,10
Mau daftar aja susah banget !!!!!!!! Menyusahkan,negatif,2022-01-14,2022,mau daftar aja susah banget menyusahkan,7,6,mau daftar saja susah banget menyusahkan,6,6,"['mau', 'daftar', 'saja', 'susah', 'banget', 'menyusahkan']","['daftar', 'susah', 'banget', 'menyusahkan']",6,4,2,daftar susah banget susah,4,4
Ga bisa login hanya verifikasi,negatif,2023-12-05,2023,ga bisa login hanya verifikasi,5,5,tidak bisa login hanya verifikasi,5,5,"['tidak', 'bisa', 'login', 'hanya', 'verifikasi']","['tidak', 'login', 'verifikasi']",5,3,2,tidak login verifikasi,3,3
Apk berfungsi sangat baik,positif,2023-10-04,2023,apk berfungsi sangat baik,4,4,aplikasi berfungsi sangat baik,4,4,"['aplikasi', 'berfungsi', 'sangat', 'baik']","['aplikasi', 'berfungsi']",4,2,2,aplikasi fungsi,2,2
Membantu kita dalam mencari teman dan pekerjaan,positif,2022-07-27,2022,membantu kita dalam mencari teman dan pekerjaan,7,7,membantu kita dalam mencari teman dan pekerjaan,7,7,"['membantu', 'kita', 'dalam', 'mencari', 'teman', 'dan', 'pekerjaan']","['membantu', 'mencari', 'teman', 'pekerjaan']",7,4,3,bantu cari teman kerja,4,4
Selalu force close saat coba masuk,negatif,2023-09-06,2023,selalu force close saat coba masuk,6,6,selalu force close saat coba masuk,6,6,"['selalu', 'force', 'close', 'saat', 'coba', 'masuk']","['force', 'close', 'coba', 'masuk']",6,4,2,force close coba masuk,4,4
Saat menggunakan link sangat memuas kan saya,positif,2022-07-18,2022,saat menggunakan link sangat memuas kan saya,7,7,saat menggunakan link sangat memuas akan saya,7,7,"['saat', 'menggunakan', 'link', 'sangat', 'memuas', 'akan', 'saya']","['link', 'memuas']",7,2,5,link muas,2,2
Aplikasi sangat bagus dan membantu,positif,2020-07-06,2020,aplikasi sangat bagus dan membantu,5,5,aplikasi sangat bagus dan membantu,5,5,"['aplikasi', 'sangat', 'bagus', 'dan', 'membantu']","['aplikasi', 'bagus', 'membantu']",5,3,2,aplikasi bagus bantu,3,3
Ini knp sih security checknya astaga ngeprank apa gmn 🥲,negatif,2023-08-30,2023,ini knp sih security checknya astaga ngeprank apa gmn,10,9,ini kenapa sih security checknya astaga ngeprank apa bagaimana,9,9,"['ini', 'kenapa', 'sih', 'security', 'checknya', 'astaga', 'ngeprank', 'apa', 'bagaimana']","['sih', 'security', 'checknya', 'astaga', 'ngeprank']",9,5,4,sih security checknya astaga ngeprank,5,5
Berbagi pengalaman dan mendapat teman baru dr berbagai kalangan.,positif,2020-08-28,2020,berbagi pengalaman dan mendapat teman baru dr berbagai kalangan,9,9,berbagi pengalaman dan mendapat teman baru dari berbagai kalangan,9,9,"['berbagi', 'pengalaman', 'dan', 'mendapat', 'teman', 'baru', 'dari', 'berbagai', 'kalangan']","['berbagi', 'pengalaman', 'teman', 'kalangan']",9,4,5,bagi alam teman kalang,4,4
Apk apaan niih Aseeem..... Gagal log in kirim kode keamanan 7x,negatif,2022-10-09,2022,apk apaan niih aseeem gagal log in kirim kode keamanan x,11,11,aplikasi apa nih aseeem gagal log in kirim kode keamanan x,11,11,"['aplikasi', 'apa', 'nih', 'aseeem', 'gagal', 'log', 'in', 'kirim', 'kode', 'keamanan', 'x']","['aplikasi', 'nih', 'aseeem', 'gagal', 'log', 'in', 'kirim', 'kode', 'keamanan', 'x']",11,10,1,aplikasi nih aseeem gagal log in kirim kode aman x,10,10
Aplikasi bagus tuk karir..,positif,2020-03-07,2020,aplikasi bagus tuk karir,4,4,aplikasi bagus untuk karir,4,4,"['aplikasi', 'bagus', 'untuk', 'karir']","['aplikasi', 'bagus', 'karir']",4,3,1,aplikasi bagus karir,3,3
Memberi kemudahan utk berinteraksi dan komonikasi sekitar info bisnis.Dan loker..,positif,2022-03-02,2022,memberi kemudahan utk berinteraksi dan komonikasi sekitar info bisnis dan loker,10,11,memberi kemudahan untuk berinteraksi dan komonikasi sekitar informasi bisnis dan loker,11,11,"['memberi', 'kemudahan', 'untuk', 'berinteraksi', 'dan', 'komonikasi', 'sekitar', 'informasi', 'bisnis', 'dan', 'loker']","['kemudahan', 'berinteraksi', 'komonikasi', 'informasi', 'bisnis', 'loker']",11,6,5,mudah interaksi komonikasi informasi bisnis loker,6,6
"Kesel banget deh sama linkidn pas verif susaaaah banget, harusnya ngegampangin orang ini malah nyusahin orang:)",negatif,2022-05-31,2022,kesel banget deh sama linkidn pas verif susaaaah banget harusnya ngegampangin orang ini malah nyusahin orang,16,16,kesel banget deh sama linkidn pas verif susaaaah banget harusnya ngegampangin orang ini bahkan nyusahin orang,16,16,"['kesel', 'banget', 'deh', 'sama', 'linkidn', 'pas', 'verif', 'susaaaah', 'banget', 'harusnya', 'ngegampangin', 'orang', 'ini', 'bahkan', 'nyusahin', 'orang']","['kesel', 'banget', 'deh', 'linkidn', 'pas', 'verif', 'susaaaah', 'banget', 'ngegampangin', 'orang', 'nyusahin', 'orang']",16,12,4,kesel banget deh linkidn pas verif susaaaah banget ngegampangin orang nyusahin orang,12,12
Kode verifikasi nya lama gak ke kirim kirim,negatif,2023-03-31,2023,kode verifikasi nya lama gak ke kirim kirim,8,8,kode verifikasi nya lama tidak ke kirim kirim,8,8,"['kode', 'verifikasi', 'nya', 'lama', 'tidak', 'ke', 'kirim', 'kirim']","['kode', 'verifikasi', 'nya', 'tidak', 'kirim', 'kirim']",8,6,2,kode verifikasi nya tidak kirim kirim,6,6
"Semangat Pagi, Salam Sehat, Selamat, Sukses dan Bahagia",positif,2020-12-26,2020,semangat pagi salam sehat selamat sukses dan bahagia,8,8,semangat pagi salam sehat selamat sukses dan bahagia,8,8,"['semangat', 'pagi', 'salam', 'sehat', 'selamat', 'sukses', 'dan', 'bahagia']","['semangat', 'pagi', 'salam', 'sehat', 'selamat', 'sukses', 'bahagia']",8,7,1,semangat pagi salam sehat selamat sukses bahagia,7,7
Akun yg dipake di LinkedIn sering kebanned jadi harus verifikasi terus,negatif,2023-08-17,2023,akun yg dipake di linkedin sering kebanned jadi harus verifikasi terus,11,11,akun yang di pakai di linkedin sering kebanned jadi harus verifikasi terus,11,12,"['akun', 'yang', 'di', 'pakai', 'di', 'linkedin', 'sering', 'kebanned', 'jadi', 'harus', 'verifikasi', 'terus']","['akun', 'pakai', 'linkedin', 'kebanned', 'verifikasi']",12,5,7,akun pakai linkedin kebanned verifikasi,5,5
Terima kasih atas informasi yang baik ini..,positif,2022-12-21,2022,terima kasih atas informasi yang baik ini,7,7,terima kasih atas informasi yang baik ini,7,7,"['terima', 'kasih', 'atas', 'informasi', 'yang', 'baik', 'ini']","['terima', 'kasih', 'informasi']",7,3,4,terima kasih informasi,3,3
KENAPA SUSAH BANGETG MASUKNYA:( VERIFIKASINYA GAGAL MULU INI TEH KENAPA,negatif,2023-06-21,2023,kenapa susah bangetg masuknya verifikasinya gagal mulu ini teh kenapa,10,10,kenapa susah bangetg masuknya verifikasinya gagal mulu ini teh kenapa,10,10,"['kenapa', 'susah', 'bangetg', 'masuknya', 'verifikasinya', 'gagal', 'mulu', 'ini', 'teh', 'kenapa']","['susah', 'bangetg', 'masuknya', 'verifikasinya', 'gagal', 'mulu', 'teh']",10,7,3,susah bangetg masuk verifikasi gagal mulu teh,7,7
Membantu menghantar dalam keadaan apapun untuk menuju sukses,positif,2021-11-10,2021,membantu menghantar dalam keadaan apapun untuk menuju sukses,8,8,membantu menghantar dalam keadaan apapun untuk menuju sukses,8,8,"['membantu', 'menghantar', 'dalam', 'keadaan', 'apapun', 'untuk', 'menuju', 'sukses']","['membantu', 'menghantar', 'apapun', 'sukses']",8,4,4,bantu hantar apa sukses,4,4
Verivikasi keamanannya ribet. Bikin pusing,negatif,2022-06-02,2022,verivikasi keamanannya ribet bikin pusing,5,5,verivikasi keamanannya rumit bikin pusing,5,5,"['verivikasi', 'keamanannya', 'rumit', 'bikin', 'pusing']","['verivikasi', 'keamanannya', 'rumit', 'bikin', 'pusing']",5,5,0,verivikasi aman rumit bikin pusing,5,5
Sangat berguna,positif,2024-05-07,2024,sangat berguna,2,2,sangat berguna,2,2,"['sangat', 'berguna']",['berguna'],2,1,1,guna,1,1
Saya sangat suka dan sangat membantu sekali,positif,2020-07-18,2020,saya sangat suka dan sangat membantu sekali,7,7,saya sangat suka dan sangat membantu sekali,7,7,"['saya', 'sangat', 'suka', 'dan', 'sangat', 'membantu', 'sekali']","['suka', 'membantu']",7,2,5,suka bantu,2,2
Akun g bisa di buka verifikasi mulu...parah aplikasi,negatif,2023-12-11,2023,akun g bisa di buka verifikasi mulu parah aplikasi,8,9,akun tidak bisa di buka verifikasi mulu parah aplikasi,9,9,"['akun', 'tidak', 'bisa', 'di', 'buka', 'verifikasi', 'mulu', 'parah', 'aplikasi']","['akun', 'tidak', 'buka', 'verifikasi', 'mulu', 'parah', 'aplikasi']",9,7,2,akun tidak buka verifikasi mulu parah aplikasi,7,7
"Luar biasa, sangat bermanfaat untuk saya. Terimakasih",positif,2024-02-23,2024,luar biasa sangat bermanfaat untuk saya terimakasih,7,7,luar biasa sangat bermanfaat untuk saya terima kasih,7,8,"['luar', 'biasa', 'sangat', 'bermanfaat', 'untuk', 'saya', 'terima', 'kasih']","['bermanfaat', 'terima', 'kasih']",8,3,5,manfaat terima kasih,3,3
Apk sudah bagus .dan bermaanfaat buat semua,positif,2020-07-25,2020,apk sudah bagus dan bermaanfaat buat semua,7,7,aplikasi sudah bagus dan bermaanfaat buat semua,7,7,"['aplikasi', 'sudah', 'bagus', 'dan', 'bermaanfaat', 'buat', 'semua']","['aplikasi', 'bagus', 'bermaanfaat']",7,3,4,aplikasi bagus bermaanfaat,3,3
Mantap bro..Full rekomended...,positif,2020-10-03,2020,mantap bro full rekomended,3,4,mantap bro full rekomendasi,4,4,"['mantap', 'bro', 'full', 'rekomendasi']","['mantap', 'bro', 'full', 'rekomendasi']",4,4,0,mantap bro full rekomendasi,4,4
Login lost verifikasi ulang berulang mohon dibantu,negatif,2024-02-20,2024,login lost verifikasi ulang berulang mohon dibantu,7,7,login lost verifikasi ulang berulang mohon dibantu,7,7,"['login', 'lost', 'verifikasi', 'ulang', 'berulang', 'mohon', 'dibantu']","['login', 'lost', 'verifikasi', 'ulang', 'berulang', 'mohon', 'dibantu']",7,7,0,login lost verifikasi ulang ulang mohon bantu,7,7
Menarik dan aktual,positif,2020-11-28,2020,menarik dan aktual,3,3,menarik dan aktual,3,3,"['menarik', 'dan', 'aktual']","['menarik', 'aktual']",3,2,1,tarik aktual,2,2
"Cara daftar aja dipersulit, gimana mau makenya..",negatif,2021-09-27,2021,cara daftar aja dipersulit gimana mau makenya,7,7,cara daftar saja dipersulit bagaimana mau makenya,7,7,"['cara', 'daftar', 'saja', 'dipersulit', 'bagaimana', 'mau', 'makenya']","['daftar', 'dipersulit', 'makenya']",7,3,4,daftar sulit makenya,3,3
KONTOL iklan mulu ganggu anjingg,negatif,2024-06-06,2024,kontol iklan mulu ganggu anjingg,5,5,kontol iklan mulu ganggu anjingg,5,5,"['kontol', 'iklan', 'mulu', 'ganggu', 'anjingg']","['kontol', 'iklan', 'mulu', 'ganggu', 'anjingg']",5,5,0,kontol iklan mulu ganggu anjingg,5,5
Bagus Meskipun belum dapet kerja ny....... 😭😭😭,positif,2020-11-05,2020,bagus meskipun belum dapet kerja ny,7,6,bagus meskipun belum dapat kerja nya,6,6,"['bagus', 'meskipun', 'belum', 'dapat', 'kerja', 'nya']","['bagus', 'kerja', 'nya']",6,3,3,bagus kerja nya,3,3
"Di hapus saja aplikasinya. Tidak berguna, ribet",negatif,2024-01-01,2024,di hapus saja aplikasinya tidak berguna ribet,7,7,di hapus saja aplikasi nya tidak berguna rumit,7,8,"['di', 'hapus', 'saja', 'aplikasi', 'nya', 'tidak', 'berguna', 'rumit']","['hapus', 'aplikasi', 'nya', 'tidak', 'berguna', 'rumit']",8,6,2,hapus aplikasi nya tidak guna rumit,6,6
Mudah mudahan iny membantu sya yg habis di phk hiks hiks,positif,2022-02-07,2022,mudah mudahan iny membantu sya yg habis di phk hiks hiks,11,11,mudah mudahan iny membantu saya yang habis di phk hiks hiks,11,11,"['mudah', 'mudahan', 'iny', 'membantu', 'saya', 'yang', 'habis', 'di', 'phk', 'hiks', 'hiks']","['mudah', 'mudahan', 'iny', 'membantu', 'habis', 'phk', 'hiks', 'hiks']",11,8,3,mudah mudah iny bantu habis phk hiks hiks,8,8
"Gak guna, buat akun baru lama amat. Gak guna jadinya",negatif,2023-04-06,2023,gak guna buat akun baru lama amat gak guna jadinya,10,10,tidak guna buat akun baru lama amat tidak guna jadinya,10,10,"['tidak', 'guna', 'buat', 'akun', 'baru', 'lama', 'amat', 'tidak', 'guna', 'jadinya']","['tidak', 'akun', 'tidak']",10,3,7,tidak akun tidak,3,3
Sejak 2 minggu kemarin tidak bisa digunakan...,negatif,2021-01-11,2021,sejak minggu kemarin tidak bisa digunakan,7,6,sejak minggu kemarin tidak bisa digunakan,6,6,"['sejak', 'minggu', 'kemarin', 'tidak', 'bisa', 'digunakan']","['minggu', 'kemarin', 'tidak']",6,3,3,minggu kemarin tidak,3,3
Sangat bagus dan berguna dan bermanfaat,positif,2023-12-20,2023,sangat bagus dan berguna dan bermanfaat,6,6,sangat bagus dan berguna dan bermanfaat,6,6,"['sangat', 'bagus', 'dan', 'berguna', 'dan', 'bermanfaat']","['bagus', 'berguna', 'bermanfaat']",6,3,3,bagus guna manfaat,3,3
Aplikasi yg bagus untuk dunia kerja,positif,2021-01-22,2021,aplikasi yg bagus untuk dunia kerja,6,6,aplikasi yang bagus untuk dunia kerja,6,6,"['aplikasi', 'yang', 'bagus', 'untuk', 'dunia', 'kerja']","['aplikasi', 'bagus', 'dunia', 'kerja']",6,4,2,aplikasi bagus dunia kerja,4,4
Mau buat login susah amat,negatif,2024-01-19,2024,mau buat login susah amat,5,5,mau buat login susah amat,5,5,"['mau', 'buat', 'login', 'susah', 'amat']","['login', 'susah']",5,2,3,login susah,2,2
KENAPA AKUN SAYA DINONAKTIFKAN? KESALAHAN APA YG SUDAH KAMI BUAT? TOLONG JAWABANYA,negatif,2023-08-04,2023,kenapa akun saya dinonaktifkan kesalahan apa yg sudah kami buat tolong jawabanya,12,12,kenapa akun saya dinonaktifkan kesalahan apa yang sudah kami buat tolong jawabanya,12,12,"['kenapa', 'akun', 'saya', 'dinonaktifkan', 'kesalahan', 'apa', 'yang', 'sudah', 'kami', 'buat', 'tolong', 'jawabanya']","['akun', 'dinonaktifkan', 'kesalahan', 'tolong', 'jawabanya']",12,5,7,akun nonaktif salah tolong jawabanya,5,5
"Ngelamar kok login sana login sini, udah gitu pas regist gagal terus, dasar anak dajjal",negatif,2021-09-29,2021,ngelamar kok login sana login sini udah gitu pas regist gagal terus dasar anak dajjal,15,15,ngelamar kok login sana login sini sudah begitu pas regist gagal terus dasar anak dajjal,15,15,"['ngelamar', 'kok', 'login', 'sana', 'login', 'sini', 'sudah', 'begitu', 'pas', 'regist', 'gagal', 'terus', 'dasar', 'anak', 'dajjal']","['ngelamar', 'login', 'login', 'pas', 'regist', 'gagal', 'dasar', 'anak', 'dajjal']",15,9,6,ngelamar login login pas regist gagal dasar anak dajjal,9,9
apk gak guna uninstall aja broo nysel kalo download,negatif,2023-07-23,2023,apk gak guna uninstall aja broo nysel kalo download,9,9,aplikasi tidak guna uninstall saja bro nysel kalau unduh,9,9,"['aplikasi', 'tidak', 'guna', 'uninstall', 'saja', 'bro', 'nysel', 'kalau', 'unduh']","['aplikasi', 'tidak', 'uninstall', 'bro', 'nysel', 'unduh']",9,6,3,aplikasi tidak uninstall bro nysel unduh,6,6
"Bagus,menambah wawasan dunia usaha,terima kasih",positif,2023-05-15,2023,bagus menambah wawasan dunia usaha terima kasih,5,7,bagus menambah wawasan dunia usaha terima kasih,7,7,"['bagus', 'menambah', 'wawasan', 'dunia', 'usaha', 'terima', 'kasih']","['bagus', 'menambah', 'wawasan', 'dunia', 'usaha', 'terima', 'kasih']",7,7,0,bagus tambah wawas dunia usaha terima kasih,7,7
gabisa di uninstall,negatif,2021-09-14,2021,gabisa di uninstall,3,3,tidak bisa di uninstall,3,4,"['tidak', 'bisa', 'di', 'uninstall']","['tidak', 'uninstall']",4,2,2,tidak uninstall,2,2
Aplikasi Nya Sangat baik Dan Bagus,positif,2021-09-09,2021,aplikasi nya sangat baik dan bagus,6,6,aplikasi nya sangat baik dan bagus,6,6,"['aplikasi', 'nya', 'sangat', 'baik', 'dan', 'bagus']","['aplikasi', 'nya', 'bagus']",6,3,3,aplikasi nya bagus,3,3
Aplikasi pencuri data identitas.di suruh verifikasi identitas KTP.setelah di ambil.mala akun di block.,negatif,2023-04-15,2023,aplikasi pencuri data identitas di suruh verifikasi identitas ktp setelah di ambil mala akun di block,13,16,aplikasi pencuri data identitas di suruh verifikasi identitas ktp setelah di ambil mala akun di block,16,16,"['aplikasi', 'pencuri', 'data', 'identitas', 'di', 'suruh', 'verifikasi', 'identitas', 'ktp', 'setelah', 'di', 'ambil', 'mala', 'akun', 'di', 'block']","['aplikasi', 'pencuri', 'data', 'identitas', 'suruh', 'verifikasi', 'identitas', 'ktp', 'ambil', 'mala', 'akun', 'block']",16,12,4,aplikasi curi data identitas suruh verifikasi identitas ktp ambil mala akun block,12,12
Bisa untuk membuat jaringan kerja,positif,2020-06-26,2020,bisa untuk membuat jaringan kerja,5,5,bisa untuk membuat jaringan kerja,5,5,"['bisa', 'untuk', 'membuat', 'jaringan', 'kerja']","['jaringan', 'kerja']",5,2,3,jaring kerja,2,2
Tingkatkan kualitas aplikasi.,positif,2022-05-18,2022,tingkatkan kualitas aplikasi,3,3,tingkatkan kualitas aplikasi,3,3,"['tingkatkan', 'kualitas', 'aplikasi']","['tingkatkan', 'kualitas', 'aplikasi']",3,3,0,tingkat kualitas aplikasi,3,3
bagus sih aplikasinya,positif,2024-04-20,2024,bagus sih aplikasinya,3,3,bagus sih aplikasi nya,3,4,"['bagus', 'sih', 'aplikasi', 'nya']","['bagus', 'sih', 'aplikasi', 'nya']",4,4,0,bagus sih aplikasi nya,4,4
Terimakasih telah menjadikan kami bagian dari dunia,positif,2021-06-10,2021,terimakasih telah menjadikan kami bagian dari dunia,7,7,terima kasih telah menjadikan kami bagian dari dunia,7,8,"['terima', 'kasih', 'telah', 'menjadikan', 'kami', 'bagian', 'dari', 'dunia']","['terima', 'kasih', 'menjadikan', 'dunia']",8,4,4,terima kasih jadi dunia,4,4
Sangat membantu dan bermanfaat,positif,2020-09-29,2020,sangat membantu dan bermanfaat,4,4,sangat membantu dan bermanfaat,4,4,"['sangat', 'membantu', 'dan', 'bermanfaat']","['membantu', 'bermanfaat']",4,2,2,bantu manfaat,2,2
Verifikasi nya kenapa ga selesai2 ya min ?,negatif,2023-10-02,2023,verifikasi nya kenapa ga selesai ya min,8,7,verifikasi nya kenapa tidak selesai ya minimal,7,7,"['verifikasi', 'nya', 'kenapa', 'tidak', 'selesai', 'ya', 'minimal']","['verifikasi', 'nya', 'tidak', 'selesai', 'ya', 'minimal']",7,6,1,verifikasi nya tidak selesai ya minimal,6,6
Recomed dan membantu,positif,2024-07-17,2024,recomed dan membantu,3,3,recomed dan membantu,3,3,"['recomed', 'dan', 'membantu']","['recomed', 'membantu']",3,2,1,recomed bantu,2,2
Jangan download jelek sangat kurang membantu,negatif,2022-12-19,2022,jangan download jelek sangat kurang membantu,6,6,jangan unduh jelek sangat kurang membantu,6,6,"['jangan', 'unduh', 'jelek', 'sangat', 'kurang', 'membantu']","['unduh', 'jelek', 'membantu']",6,3,3,unduh jelek bantu,3,3
"Gak sesuai dg apa yag dicari, ribet",negatif,2023-12-07,2023,gak sesuai dg apa yag dicari ribet,7,7,tidak sesuai dengan apa yag dicari rumit,7,7,"['tidak', 'sesuai', 'dengan', 'apa', 'yag', 'dicari', 'rumit']","['tidak', 'sesuai', 'yag', 'dicari', 'rumit']",7,5,2,tidak sesuai yag cari rumit,5,5
LinkedIn membantu jaringan dalam dunia professional,positif,2020-11-10,2020,linkedin membantu jaringan dalam dunia professional,6,6,linkedin membantu jaringan dalam dunia professional,6,6,"['linkedin', 'membantu', 'jaringan', 'dalam', 'dunia', 'professional']","['linkedin', 'membantu', 'jaringan', 'dunia', 'professional']",6,5,1,linkedin bantu jaring dunia professional,5,5
"Aplikasi apa ini, gak bermanfaaat direkomendasikan",negatif,2023-01-31,2023,aplikasi apa ini gak bermanfaaat direkomendasikan,6,6,aplikasi apa ini tidak bermanfaaat direkomendasikan,6,6,"['aplikasi', 'apa', 'ini', 'tidak', 'bermanfaaat', 'direkomendasikan']","['aplikasi', 'tidak', 'bermanfaaat', 'direkomendasikan']",6,4,2,aplikasi tidak bermanfaaat rekomendasi,4,4
"Udah 2,5k+ relasi. Semoga tahun depan bisa 3.5k+",positif,2023-07-22,2023,udah k relasi semoga tahun depan bisa k,8,8,sudah ke relasi semoga tahun depan bisa ke,8,8,"['sudah', 'ke', 'relasi', 'semoga', 'tahun', 'depan', 'bisa', 'ke']","['relasi', 'semoga']",8,2,6,relasi moga,2,2
Mantap & semakin di depan,positif,2021-08-31,2021,mantap semakin di depan,5,4,mantap semakin di depan,4,4,"['mantap', 'semakin', 'di', 'depan']",['mantap'],4,1,3,mantap,1,1
Saya Sangat Suka Aplikasi ini Dapat Membantu,positif,2021-01-07,2021,saya sangat suka aplikasi ini dapat membantu,7,7,saya sangat suka aplikasi ini dapat membantu,7,7,"['saya', 'sangat', 'suka', 'aplikasi', 'ini', 'dapat', 'membantu']","['suka', 'aplikasi', 'membantu']",7,3,4,suka aplikasi bantu,3,3
Login ga bisa terus,negatif,2023-06-08,2023,login ga bisa terus,4,4,login tidak bisa terus,4,4,"['login', 'tidak', 'bisa', 'terus']","['login', 'tidak']",4,2,2,login tidak,2,2
Yah...smoga dgn ini sgala sesuatu yg saya perlukan lancar...,positif,2021-10-11,2021,yah smoga dgn ini sgala sesuatu yg saya perlukan lancar,9,10,ya semoga dengan ini sgala sesuatu yang saya perlukan lancar,10,10,"['ya', 'semoga', 'dengan', 'ini', 'sgala', 'sesuatu', 'yang', 'saya', 'perlukan', 'lancar']","['ya', 'semoga', 'sgala', 'perlukan', 'lancar']",10,5,5,ya moga sgala perlu lancar,5,5
Mudah dan cepat dlm verikasi kode,positif,2022-02-13,2022,mudah dan cepat dlm verikasi kode,6,6,mudah dan cepat dalam verikasi kode,6,6,"['mudah', 'dan', 'cepat', 'dalam', 'verikasi', 'kode']","['mudah', 'cepat', 'verikasi', 'kode']",6,4,2,mudah cepat verikasi kode,4,4
"Apk aneh, belum mulai udah disuruh jawab pertanyaan gak jelas",negatif,2023-08-13,2023,apk aneh belum mulai udah disuruh jawab pertanyaan gak jelas,10,10,aplikasi aneh belum mulai sudah disuruh jawab pertanyaan tidak jelas,10,10,"['aplikasi', 'aneh', 'belum', 'mulai', 'sudah', 'disuruh', 'jawab', 'pertanyaan', 'tidak', 'jelas']","['aplikasi', 'aneh', 'disuruh', 'tidak']",10,4,6,aplikasi aneh suruh tidak,4,4
Verifikasi nya susah,negatif,2024-05-05,2024,verifikasi nya susah,3,3,verifikasi nya susah,3,3,"['verifikasi', 'nya', 'susah']","['verifikasi', 'nya', 'susah']",3,3,0,verifikasi nya susah,3,3
Aplikasi lemot bikin emosi doang ada,negatif,2021-03-11,2021,aplikasi lemot bikin emosi doang ada,6,6,aplikasi lambat bikin emosi saja ada,6,6,"['aplikasi', 'lambat', 'bikin', 'emosi', 'saja', 'ada']","['aplikasi', 'lambat', 'bikin', 'emosi']",6,4,2,aplikasi lambat bikin emosi,4,4
Memudahkan membangun relasi serta koneksi dalam dunia kerja,positif,2021-02-05,2021,memudahkan membangun relasi serta koneksi dalam dunia kerja,8,8,memudahkan membangun relasi serta koneksi dalam dunia kerja,8,8,"['memudahkan', 'membangun', 'relasi', 'serta', 'koneksi', 'dalam', 'dunia', 'kerja']","['memudahkan', 'membangun', 'relasi', 'koneksi', 'dunia', 'kerja']",8,6,2,mudah bangun relasi koneksi dunia kerja,6,6
Bagus dan praktis,positif,2022-06-21,2022,bagus dan praktis,3,3,bagus dan praktis,3,3,"['bagus', 'dan', 'praktis']","['bagus', 'praktis']",3,2,1,bagus praktis,2,2
"""Kerjakan dengan upaya terbaik saat ini juga, apapun yg diamanahkan padamu""",positif,2021-11-11,2021,kerjakan dengan upaya terbaik saat ini juga apapun yg diamanahkan padamu,11,11,kerjakan dengan upaya terbaik saat ini juga apapun yang diamanahkan padamu,11,11,"['kerjakan', 'dengan', 'upaya', 'terbaik', 'saat', 'ini', 'juga', 'apapun', 'yang', 'diamanahkan', 'padamu']","['kerjakan', 'upaya', 'terbaik', 'apapun', 'diamanahkan', 'padamu']",11,6,5,kerja upaya baik apa amanah pada,6,6
SEMOGA BISA DAPAT PENGHA SILAN.YANG LEMAYAN DARI HP.TERIMA KASIH.,positif,2023-01-19,2023,semoga bisa dapat pengha silan yang lemayan dari hp terima kasih,9,11,semoga bisa dapat pengha silan yang lemayan dari handphone terima kasih,11,11,"['semoga', 'bisa', 'dapat', 'pengha', 'silan', 'yang', 'lemayan', 'dari', 'handphone', 'terima', 'kasih']","['semoga', 'pengha', 'silan', 'lemayan', 'handphone', 'terima', 'kasih']",11,7,4,moga pengha sil layan handphone terima kasih,7,7
"Bagi yang ngagur ini bermanpat banget buat para yng di rumah semoga cepet"" nemu kerjan yab",positif,2020-10-15,2020,bagi yang ngagur ini bermanpat banget buat para yng di rumah semoga cepet nemu kerjan yab,16,16,bagi yang ngagur ini bermanpat banget buat para yng di rumah semoga cepat ketemu kerjan yab,16,16,"['bagi', 'yang', 'ngagur', 'ini', 'bermanpat', 'banget', 'buat', 'para', 'yng', 'di', 'rumah', 'semoga', 'cepat', 'ketemu', 'kerjan', 'yab']","['ngagur', 'bermanpat', 'banget', 'yng', 'rumah', 'semoga', 'cepat', 'ketemu', 'kerjan', 'yab']",16,10,6,ngagur bermanpat banget yng rumah moga cepat ketemu kerjan yab,10,10
Biasa aja. Saya tidak ada kendala dalam hal daftar akun. 😆,positif,2021-12-27,2021,biasa aja saya tidak ada kendala dalam hal daftar akun,11,10,biasa saja saya tidak ada kendala dalam hal daftar akun,10,10,"['biasa', 'saja', 'saya', 'tidak', 'ada', 'kendala', 'dalam', 'hal', 'daftar', 'akun']","['tidak', 'kendala', 'daftar', 'akun']",10,4,6,tidak kendala daftar akun,4,4
Sistem Verifikasi ni aplikasi sampah! Ga becus yg ngurus pecat aja!!,negatif,2023-12-11,2023,sistem verifikasi ni aplikasi sampah ga becus yg ngurus pecat aja,11,11,sistem verifikasi ini aplikasi sampah tidak becus yang mengurus pecat saja,11,11,"['sistem', 'verifikasi', 'ini', 'aplikasi', 'sampah', 'tidak', 'becus', 'yang', 'mengurus', 'pecat', 'saja']","['sistem', 'verifikasi', 'aplikasi', 'sampah', 'tidak', 'becus', 'mengurus', 'pecat']",11,8,3,sistem verifikasi aplikasi sampah tidak becus urus pecat,8,8
Suka sama aplikasinya tapi jarang buka,positif,2022-09-13,2022,suka sama aplikasinya tapi jarang buka,6,6,suka sama aplikasi nya tapi jarang buka,6,7,"['suka', 'sama', 'aplikasi', 'nya', 'tapi', 'jarang', 'buka']","['suka', 'aplikasi', 'nya', 'jarang', 'buka']",7,5,2,suka aplikasi nya jarang buka,5,5
Sangat-sangat membantu keren banget,positif,2022-09-17,2022,sangat sangat membantu keren banget,4,5,sangat sangat membantu keren banget,5,5,"['sangat', 'sangat', 'membantu', 'keren', 'banget']","['membantu', 'keren', 'banget']",5,3,2,bantu keren banget,3,3
Good koneksi bertambah,positif,2020-09-15,2020,good koneksi bertambah,3,3,bagus koneksi bertambah,3,3,"['bagus', 'koneksi', 'bertambah']","['bagus', 'koneksi', 'bertambah']",3,3,0,bagus koneksi tambah,3,3
Cara melamar yang ribet selalu di alihkan ke website yang tidak jelas,negatif,2022-08-29,2022,cara melamar yang ribet selalu di alihkan ke website yang tidak jelas,12,12,cara melamar yang rumit selalu di alihkan ke website yang tidak jelas,12,12,"['cara', 'melamar', 'yang', 'rumit', 'selalu', 'di', 'alihkan', 'ke', 'website', 'yang', 'tidak', 'jelas']","['melamar', 'rumit', 'alihkan', 'website', 'tidak']",12,5,7,lamar rumit alih website tidak,5,5
Bagus dan profesional,positif,2020-02-23,2020,bagus dan profesional,3,3,bagus dan profesional,3,3,"['bagus', 'dan', 'profesional']","['bagus', 'profesional']",3,2,1,bagus profesional,2,2
Knp akun saya nonaktif ya? Gimana supaya aktif lagi?,negatif,2020-08-31,2020,knp akun saya nonaktif ya gimana supaya aktif lagi,9,9,kenapa akun saya nonaktif ya bagaimana supaya aktif lagi,9,9,"['kenapa', 'akun', 'saya', 'nonaktif', 'ya', 'bagaimana', 'supaya', 'aktif', 'lagi']","['akun', 'nonaktif', 'ya', 'aktif']",9,4,5,akun nonaktif ya aktif,4,4
Verifikasi gk masuk masuk,negatif,2022-03-28,2022,verifikasi gk masuk masuk,4,4,verifikasi tidak masuk masuk,4,4,"['verifikasi', 'tidak', 'masuk', 'masuk']","['verifikasi', 'tidak', 'masuk', 'masuk']",4,4,0,verifikasi tidak masuk masuk,4,4
Bagus sekali. Maaf pendapat saya hanya itu hihi,positif,2021-04-20,2021,bagus sekali maaf pendapat saya hanya itu hihi,8,8,bagus sekali maaf pendapat saya hanya itu hihi,8,8,"['bagus', 'sekali', 'maaf', 'pendapat', 'saya', 'hanya', 'itu', 'hihi']","['bagus', 'maaf', 'pendapat', 'hihi']",8,4,4,bagus maaf dapat hihi,4,4
Semoga cepat dapat kerjaan yg seauai skil sya.. Melalui Linkedln,positif,2022-01-30,2022,semoga cepat dapat kerjaan yg seauai skil sya melalui linkedln,10,10,semoga cepat dapat kerjaan yang seauai skil saya melalui linkedln,10,10,"['semoga', 'cepat', 'dapat', 'kerjaan', 'yang', 'seauai', 'skil', 'saya', 'melalui', 'linkedln']","['semoga', 'cepat', 'kerjaan', 'seauai', 'skil', 'linkedln']",10,6,4,moga cepat kerja seauai skil linkedln,6,6
"Masih coba2,tp lumayan membantu",positif,2020-07-22,2020,masih coba tp lumayan membantu,4,5,masih coba tapi lumayan membantu,5,5,"['masih', 'coba', 'tapi', 'lumayan', 'membantu']","['coba', 'lumayan', 'membantu']",5,3,2,coba lumayan bantu,3,3
Dahlah uninstal. Pemeriksaannya susah buat gue.,negatif,2022-02-01,2022,dahlah uninstal pemeriksaannya susah buat gue,6,6,sudahlah hapus instalan pemeriksaannya susah buat saya,6,7,"['sudahlah', 'hapus', 'instalan', 'pemeriksaannya', 'susah', 'buat', 'saya']","['hapus', 'instalan', 'pemeriksaannya', 'susah']",7,4,3,hapus instalan periksa susah,4,4
Aplikasi yang sangat penting dan membantu ...,positif,2020-02-16,2020,aplikasi yang sangat penting dan membantu,7,6,aplikasi yang sangat penting dan membantu,6,6,"['aplikasi', 'yang', 'sangat', 'penting', 'dan', 'membantu']","['aplikasi', 'membantu']",6,2,4,aplikasi bantu,2,2
Iklannya maksa,negatif,2024-06-22,2024,iklannya maksa,2,2,iklannya maksa,2,2,"['iklannya', 'maksa']","['iklannya', 'maksa']",2,2,0,iklan maksa,2,2
Sangat memudahkan Karir kerja,positif,2020-11-15,2020,sangat memudahkan karir kerja,4,4,sangat memudahkan karir kerja,4,4,"['sangat', 'memudahkan', 'karir', 'kerja']","['memudahkan', 'karir', 'kerja']",4,3,1,mudah karir kerja,3,3
APPLIKASI TAIIII . MAU LOGIN HARUS VERIFIKASI GAMBAR . SALAH TERUS TERUS COBA LAGI TERUS. GIMANA MAU LOGIN KALAU KAYAK GINI CERITANYA. 🖕🖕🖕🖕🖕🖕🖕🖕🖕,negatif,2023-08-06,2023,applikasi taiiii mau login harus verifikasi gambar salah terus terus coba lagi terus gimana mau login kalau kayak gini ceritanya,23,20,aplikasi taiiii mau login harus verifikasi gambar salah terus terus coba lagi terus bagaimana mau login kalau kayak begini ceritanya,20,20,"['aplikasi', 'taiiii', 'mau', 'login', 'harus', 'verifikasi', 'gambar', 'salah', 'terus', 'terus', 'coba', 'lagi', 'terus', 'bagaimana', 'mau', 'login', 'kalau', 'kayak', 'begini', 'ceritanya']","['aplikasi', 'taiiii', 'login', 'verifikasi', 'gambar', 'salah', 'coba', 'login', 'kayak', 'ceritanya']",20,10,10,aplikasi taiiii login verifikasi gambar salah coba login kayak cerita,10,10
Saya kasih lima bintang karena aplikasi ini asli bagus,positif,2021-12-07,2021,saya kasih lima bintang karena aplikasi ini asli bagus,9,9,saya kasih lima bintang karena aplikasi ini asli bagus,9,9,"['saya', 'kasih', 'lima', 'bintang', 'karena', 'aplikasi', 'ini', 'asli', 'bagus']","['kasih', 'bintang', 'aplikasi', 'asli', 'bagus']",9,5,4,kasih bintang aplikasi asli bagus,5,5
Aplikasi yg sangat baik dan sangat berguna,positif,2023-06-21,2023,aplikasi yg sangat baik dan sangat berguna,7,7,aplikasi yang sangat baik dan sangat berguna,7,7,"['aplikasi', 'yang', 'sangat', 'baik', 'dan', 'sangat', 'berguna']","['aplikasi', 'berguna']",7,2,5,aplikasi guna,2,2
Untuk jobseker dan berbagi pengalaman.,positif,2020-05-30,2020,untuk jobseker dan berbagi pengalaman,5,5,untuk jobseker dan berbagi pengalaman,5,5,"['untuk', 'jobseker', 'dan', 'berbagi', 'pengalaman']","['jobseker', 'berbagi', 'pengalaman']",5,3,2,jobseker bagi alam,3,3
Sosmed utk para Profesional..,positif,2024-05-15,2024,sosmed utk para profesional,4,4,sosmed untuk para profesional,4,4,"['sosmed', 'untuk', 'para', 'profesional']","['sosmed', 'profesional']",4,2,2,sosmed profesional,2,2
Sangat membantu untuk kita lebih maju lagi,positif,2020-10-11,2020,sangat membantu untuk kita lebih maju lagi,7,7,sangat membantu untuk kita lebih maju lagi,7,7,"['sangat', 'membantu', 'untuk', 'kita', 'lebih', 'maju', 'lagi']","['membantu', 'maju']",7,2,5,bantu maju,2,2
ribet dan tidak jelas aplikasi ini,negatif,2023-09-14,2023,ribet dan tidak jelas aplikasi ini,6,6,rumit dan tidak jelas aplikasi ini,6,6,"['rumit', 'dan', 'tidak', 'jelas', 'aplikasi', 'ini']","['rumit', 'tidak', 'aplikasi']",6,3,3,rumit tidak aplikasi,3,3
Bagus sekali dan sangat membantu,positif,2021-06-29,2021,bagus sekali dan sangat membantu,5,5,bagus sekali dan sangat membantu,5,5,"['bagus', 'sekali', 'dan', 'sangat', 'membantu']","['bagus', 'membantu']",5,2,3,bagus bantu,2,2
mencari pekerjaan mudah,positif,2020-04-16,2020,mencari pekerjaan mudah,3,3,mencari pekerjaan mudah,3,3,"['mencari', 'pekerjaan', 'mudah']","['mencari', 'pekerjaan', 'mudah']",3,3,0,cari kerja mudah,3,3
Baik dibanding aplikasi job seeker yg lain,positif,2021-09-24,2021,baik dibanding aplikasi job seeker yg lain,7,7,baik dibanding aplikasi kerja seeker yang lain,7,7,"['baik', 'dibanding', 'aplikasi', 'kerja', 'seeker', 'yang', 'lain']","['dibanding', 'aplikasi', 'kerja', 'seeker']",7,4,3,banding aplikasi kerja seeker,4,4
"Berkenalan dg tingkat direksi perusahaan, mengenal perusahaan sejenis usaha agar bisa ber interaksi, melihat posisi / jabatan seseorang u bisa saling diskudi",positif,2022-11-14,2022,berkenalan dg tingkat direksi perusahaan mengenal perusahaan sejenis usaha agar bisa ber interaksi melihat posisi jabatan seseorang u bisa saling diskudi,22,21,berkenalan dengan tingkat direksi perusahaan mengenal perusahaan sejenis usaha agar bisa ber interaksi melihat posisi jabatan seseorang untuk bisa saling diskudi,21,21,"['berkenalan', 'dengan', 'tingkat', 'direksi', 'perusahaan', 'mengenal', 'perusahaan', 'sejenis', 'usaha', 'agar', 'bisa', 'ber', 'interaksi', 'melihat', 'posisi', 'jabatan', 'seseorang', 'untuk', 'bisa', 'saling', 'diskudi']","['berkenalan', 'tingkat', 'direksi', 'perusahaan', 'mengenal', 'perusahaan', 'sejenis', 'usaha', 'ber', 'interaksi', 'posisi', 'jabatan', 'diskudi']",21,13,8,nal tingkat direksi usaha kenal usaha jenis usaha ber interaksi posisi jabat diskudi,13,13
Mempermudah untuk mencari nafkah,positif,2020-01-31,2020,mempermudah untuk mencari nafkah,4,4,mempermudah untuk mencari nafkah,4,4,"['mempermudah', 'untuk', 'mencari', 'nafkah']","['mempermudah', 'mencari', 'nafkah']",4,3,1,mudah cari nafkah,3,3
Lumayan untuk mencari pekerjaan,positif,2020-09-26,2020,lumayan untuk mencari pekerjaan,4,4,lumayan untuk mencari pekerjaan,4,4,"['lumayan', 'untuk', 'mencari', 'pekerjaan']","['lumayan', 'mencari', 'pekerjaan']",4,3,1,lumayan cari kerja,3,3
"LinkedIn oke, untuk bangun relasi",positif,2020-04-11,2020,linkedin oke untuk bangun relasi,5,5,linkedin oke untuk bangun relasi,5,5,"['linkedin', 'oke', 'untuk', 'bangun', 'relasi']","['linkedin', 'oke', 'bangun', 'relasi']",5,4,1,linkedin oke bangun relasi,4,4
Sangat membantu dan bermanfaat,positif,2022-09-08,2022,sangat membantu dan bermanfaat,4,4,sangat membantu dan bermanfaat,4,4,"['sangat', 'membantu', 'dan', 'bermanfaat']","['membantu', 'bermanfaat']",4,2,2,bantu manfaat,2,2
Keamanannya rendah. Akun gampang ke hack.,negatif,2023-07-14,2023,keamanannya rendah akun gampang ke hack,6,6,keamanannya rendah akun gampang ke hack,6,6,"['keamanannya', 'rendah', 'akun', 'gampang', 'ke', 'hack']","['keamanannya', 'rendah', 'akun', 'gampang', 'hack']",6,5,1,aman rendah akun gampang hack,5,5
Memberikan wawasan mengenai ilmu pengetahuan di segala bidang industri,positif,2022-08-01,2022,memberikan wawasan mengenai ilmu pengetahuan di segala bidang industri,9,9,memberikan wawasan mengenai ilmu pengetahuan di segala bidang industri,9,9,"['memberikan', 'wawasan', 'mengenai', 'ilmu', 'pengetahuan', 'di', 'segala', 'bidang', 'industri']","['wawasan', 'ilmu', 'pengetahuan', 'bidang', 'industri']",9,5,4,wawas ilmu tahu bidang industri,5,5
Berkesenian dan mengajar adalah duniaku,positif,2023-12-31,2023,berkesenian dan mengajar adalah duniaku,5,5,berkesenian dan mengajar adalah duniaku,5,5,"['berkesenian', 'dan', 'mengajar', 'adalah', 'duniaku']","['berkesenian', 'mengajar', 'duniaku']",5,3,2,nian ajar dunia,3,3
Banyak perusahaan palsu yg buka lowongan,negatif,2021-07-25,2021,banyak perusahaan palsu yg buka lowongan,6,6,banyak perusahaan palsu yang buka lowongan,6,6,"['banyak', 'perusahaan', 'palsu', 'yang', 'buka', 'lowongan']","['perusahaan', 'palsu', 'buka', 'lowongan']",6,4,2,usaha palsu buka lowong,4,4
Saya baca komentar banyak gagal.mudah-mudahan saya bisa coba...,negatif,2023-06-05,2023,saya baca komentar banyak gagal mudah mudahan saya bisa coba,8,10,saya baca komentar banyak gagal mudah mudahan saya bisa coba,10,10,"['saya', 'baca', 'komentar', 'banyak', 'gagal', 'mudah', 'mudahan', 'saya', 'bisa', 'coba']","['baca', 'komentar', 'gagal', 'mudah', 'mudahan', 'coba']",10,6,4,baca komentar gagal mudah mudah coba,6,6
"Apaan ini,, mau gabung aja mesti ada verifikasi. Parah, susah pula",negatif,2021-06-01,2021,apaan ini mau gabung aja mesti ada verifikasi parah susah pula,11,11,apa ini mau gabung saja mesti ada verifikasi parah susah pula,11,11,"['apa', 'ini', 'mau', 'gabung', 'saja', 'mesti', 'ada', 'verifikasi', 'parah', 'susah', 'pula']","['gabung', 'mesti', 'verifikasi', 'parah', 'susah']",11,5,6,gabung mesti verifikasi parah susah,5,5
Tingkatkan prestasimu tetap semangat tanpa batas Raihan 💪👍,positif,2023-07-18,2023,tingkatkan prestasimu tetap semangat tanpa batas raihan,8,7,tingkatkan prestasimu tetap semangat tanpa batas raihan,7,7,"['tingkatkan', 'prestasimu', 'tetap', 'semangat', 'tanpa', 'batas', 'raihan']","['tingkatkan', 'prestasimu', 'semangat', 'batas', 'raihan']",7,5,2,tingkat prestasi semangat batas raih,5,5
"Lebih terarah dan banyak teman, berbeda-beda",positif,2022-07-22,2022,lebih terarah dan banyak teman berbeda beda,6,7,lebih terarah dan banyak teman berbeda beda,7,7,"['lebih', 'terarah', 'dan', 'banyak', 'teman', 'berbeda', 'beda']","['terarah', 'teman', 'berbeda', 'beda']",7,4,3,arah teman beda beda,4,4
"Aplikasi OKE, menghubungkan pihak recruiter dgn pihak job seeker",positif,2022-12-23,2022,aplikasi oke menghubungkan pihak recruiter dgn pihak job seeker,9,9,aplikasi oke menghubungkan pihak recruiter dengan pihak kerja seeker,9,9,"['aplikasi', 'oke', 'menghubungkan', 'pihak', 'recruiter', 'dengan', 'pihak', 'kerja', 'seeker']","['aplikasi', 'oke', 'menghubungkan', 'recruiter', 'kerja', 'seeker']",9,6,3,aplikasi oke hubung recruiter kerja seeker,6,6
Luar biasa. Sangat membantu.,positif,2021-11-11,2021,luar biasa sangat membantu,4,4,luar biasa sangat membantu,4,4,"['luar', 'biasa', 'sangat', 'membantu']",['membantu'],4,1,3,bantu,1,1
Sangat membantu dan salam semangat,positif,2020-10-13,2020,sangat membantu dan salam semangat,5,5,sangat membantu dan salam semangat,5,5,"['sangat', 'membantu', 'dan', 'salam', 'semangat']","['membantu', 'salam', 'semangat']",5,3,2,bantu salam semangat,3,3
bagusss. saya suka. semoga rakamin X linkedin bakal fair yaaa. love u sekebon🤗🤍,positif,2024-04-29,2024,bagusss saya suka semoga rakamin x linkedin bakal fair yaaa love u sekebon,13,13,bagusss saya suka semoga rakamin x linkedin bakal fair yaaa love untuk sekebon,13,13,"['bagusss', 'saya', 'suka', 'semoga', 'rakamin', 'x', 'linkedin', 'bakal', 'fair', 'yaaa', 'love', 'untuk', 'sekebon']","['bagusss', 'suka', 'semoga', 'rakamin', 'x', 'linkedin', 'fair', 'yaaa', 'love', 'sekebon']",13,10,3,bagusss suka moga rakamin x linkedin fair yaaa love kebon,10,10
Ini apk gimana siii mau verifikasi aj terahirnya salah mulu pdhal udah bener,negatif,2022-06-11,2022,ini apk gimana siii mau verifikasi aj terahirnya salah mulu pdhal udah bener,13,13,ini aplikasi bagaimana siii mau verifikasi saja terahirnya salah mulu pdhal sudah benar,13,13,"['ini', 'aplikasi', 'bagaimana', 'siii', 'mau', 'verifikasi', 'saja', 'terahirnya', 'salah', 'mulu', 'pdhal', 'sudah', 'benar']","['aplikasi', 'siii', 'verifikasi', 'terahirnya', 'salah', 'mulu', 'pdhal']",13,7,6,aplikasi siii verifikasi terahirnya salah mulu pdhal,7,7
"Aplikasi ini membantu saya menemukan relasi,dan klien . Saya mudah dihubungi lewat dm instagram ke bnep_b saya melayani pembuatan jasa undangan video berbasis web.",positif,2023-05-28,2023,aplikasi ini membantu saya menemukan relasi dan klien saya mudah dihubungi lewat dm instagram ke bnep b saya melayani pembuatan jasa undangan video berbasis web,24,25,aplikasi ini membantu saya menemukan relasi dan klien saya mudah menghubungi lewat direct message instagram ke bnep biasa saya melayani pembuatan jasa undangan video berbasis web,25,26,"['aplikasi', 'ini', 'membantu', 'saya', 'menemukan', 'relasi', 'dan', 'klien', 'saya', 'mudah', 'menghubungi', 'lewat', 'direct', 'message', 'instagram', 'ke', 'bnep', 'biasa', 'saya', 'melayani', 'pembuatan', 'jasa', 'undangan', 'video', 'berbasis', 'web']","['aplikasi', 'membantu', 'menemukan', 'relasi', 'klien', 'mudah', 'menghubungi', 'direct', 'message', 'instagram', 'bnep', 'melayani', 'pembuatan', 'jasa', 'undangan', 'video', 'berbasis', 'web']",26,18,8,aplikasi bantu temu relasi klien mudah hubung direct message instagram bnep layan buat jasa undang video bas web,18,18
"Sulit banget login nya. Ga bisa""",negatif,2020-07-04,2020,sulit banget login nya ga bisa,6,6,sulit banget login nya tidak bisa,6,6,"['sulit', 'banget', 'login', 'nya', 'tidak', 'bisa']","['sulit', 'banget', 'login', 'nya', 'tidak']",6,5,1,sulit banget login nya tidak,5,5
"Tidak bisa login, ...!",negatif,2024-02-08,2024,tidak bisa login,4,3,tidak bisa login,3,3,"['tidak', 'bisa', 'login']","['tidak', 'login']",3,2,1,tidak login,2,2
Kualitas tingkatkan,positif,2021-09-16,2021,kualitas tingkatkan,2,2,kualitas tingkatkan,2,2,"['kualitas', 'tingkatkan']","['kualitas', 'tingkatkan']",2,2,0,kualitas tingkat,2,2
Bermanfaat dan menambah wawasan,positif,2022-07-20,2022,bermanfaat dan menambah wawasan,4,4,bermanfaat dan menambah wawasan,4,4,"['bermanfaat', 'dan', 'menambah', 'wawasan']","['bermanfaat', 'menambah', 'wawasan']",4,3,1,manfaat tambah wawas,3,3
"Tiba tiba akun di nonaktifkan, padahal gak ngapa ngapain juga",negatif,2021-07-14,2021,tiba tiba akun di nonaktifkan padahal gak ngapa ngapain juga,10,10,tiba tiba akun di nonaktifkan padahal tidak ngapa buat apa juga,10,11,"['tiba', 'tiba', 'akun', 'di', 'nonaktifkan', 'padahal', 'tidak', 'ngapa', 'buat', 'apa', 'juga']","['akun', 'nonaktifkan', 'tidak', 'ngapa']",11,4,7,akun nonaktif tidak ngapa,4,4
Agar dapat diberikan jalan peluang,positif,2022-01-14,2022,agar dapat diberikan jalan peluang,5,5,agar dapat diberikan jalan peluang,5,5,"['agar', 'dapat', 'diberikan', 'jalan', 'peluang']","['jalan', 'peluang']",5,2,3,jalan peluang,2,2
Terima kasih banyak inpo yg bermanfaat,positif,2021-11-27,2021,terima kasih banyak inpo yg bermanfaat,6,6,terima kasih banyak inpo yang bermanfaat,6,6,"['terima', 'kasih', 'banyak', 'inpo', 'yang', 'bermanfaat']","['terima', 'kasih', 'inpo', 'bermanfaat']",6,4,2,terima kasih inpo manfaat,4,4
"Ga jelas nih apk,dibikin ribet buat apply jobs",negatif,2021-03-16,2021,ga jelas nih apk dibikin ribet buat apply jobs,8,9,tidak jelas nih aplikasi dibikin rumit buat apply jobs,9,9,"['tidak', 'jelas', 'nih', 'aplikasi', 'dibikin', 'rumit', 'buat', 'apply', 'jobs']","['tidak', 'nih', 'aplikasi', 'dibikin', 'rumit', 'apply', 'jobs']",9,7,2,tidak nih aplikasi bikin rumit apply jobs,7,7
Sangat bagus responnya semoga bermanfaat,positif,2021-03-14,2021,sangat bagus responnya semoga bermanfaat,5,5,sangat bagus responsnya semoga bermanfaat,5,5,"['sangat', 'bagus', 'responsnya', 'semoga', 'bermanfaat']","['bagus', 'responsnya', 'semoga', 'bermanfaat']",5,4,1,bagus respons moga manfaat,4,4
Sangat membantu informasinya,positif,2022-11-05,2022,sangat membantu informasinya,3,3,sangat membantu informasinya,3,3,"['sangat', 'membantu', 'informasinya']","['membantu', 'informasinya']",3,2,1,bantu informasi,2,2
Sangat bermanraat,positif,2024-06-25,2024,sangat bermanraat,2,2,sangat bermanraat,2,2,"['sangat', 'bermanraat']",['bermanraat'],2,1,1,bermanraat,1,1
Mantap mudah menerima informasi,positif,2020-04-15,2020,mantap mudah menerima informasi,4,4,mantap mudah menerima informasi,4,4,"['mantap', 'mudah', 'menerima', 'informasi']","['mantap', 'mudah', 'menerima', 'informasi']",4,4,0,mantap mudah terima informasi,4,4
Baru instal tapi ga bisa daftar.,negatif,2021-01-02,2021,baru instal tapi ga bisa daftar,6,6,baru memasang tapi tidak bisa daftar,6,6,"['baru', 'memasang', 'tapi', 'tidak', 'bisa', 'daftar']","['memasang', 'tidak', 'daftar']",6,3,3,pasang tidak daftar,3,3
Sangat membantu mencari rekanan,positif,2022-03-12,2022,sangat membantu mencari rekanan,4,4,sangat membantu mencari rekanan,4,4,"['sangat', 'membantu', 'mencari', 'rekanan']","['membantu', 'mencari', 'rekanan']",4,3,1,bantu cari rekan,3,3
Kok susah ya dapat kerja di aplikasi ini,negatif,2021-10-16,2021,kok susah ya dapat kerja di aplikasi ini,8,8,kok susah ya dapat kerja di aplikasi ini,8,8,"['kok', 'susah', 'ya', 'dapat', 'kerja', 'di', 'aplikasi', 'ini']","['susah', 'ya', 'kerja', 'aplikasi']",8,4,4,susah ya kerja aplikasi,4,4
Mudah dan cepat,positif,2020-03-12,2020,mudah dan cepat,3,3,mudah dan cepat,3,3,"['mudah', 'dan', 'cepat']","['mudah', 'cepat']",3,2,1,mudah cepat,2,2
Informatif dan bermanfaat,positif,2020-06-12,2020,informatif dan bermanfaat,3,3,informatif dan bermanfaat,3,3,"['informatif', 'dan', 'bermanfaat']","['informatif', 'bermanfaat']",3,2,1,informatif manfaat,2,2
"Ok, nambah koneksi sesama pekerja",positif,2021-12-28,2021,ok nambah koneksi sesama pekerja,5,5,oke nambah koneksi sesama yang kerja,5,6,"['oke', 'nambah', 'koneksi', 'sesama', 'yang', 'kerja']","['oke', 'nambah', 'koneksi', 'kerja']",6,4,2,oke nambah koneksi kerja,4,4
"Linkedin sangat membantu utk merekrut karyawan, tks linkedin👍",positif,2022-05-16,2022,linkedin sangat membantu utk merekrut karyawan tks linkedin,8,8,linkedin sangat membantu untuk merekrut karyawan terima kasih linkedin,8,9,"['linkedin', 'sangat', 'membantu', 'untuk', 'merekrut', 'karyawan', 'terima', 'kasih', 'linkedin']","['linkedin', 'membantu', 'merekrut', 'karyawan', 'terima', 'kasih', 'linkedin']",9,7,2,linkedin bantu rekrut karyawan terima kasih linkedin,7,7
Tidak bisa login,negatif,2022-09-24,2022,tidak bisa login,3,3,tidak bisa login,3,3,"['tidak', 'bisa', 'login']","['tidak', 'login']",3,2,1,tidak login,2,2
Tidak bisa verifikasi. 10x gagal.,negatif,2022-02-25,2022,tidak bisa verifikasi x gagal,5,5,tidak bisa verifikasi x gagal,5,5,"['tidak', 'bisa', 'verifikasi', 'x', 'gagal']","['tidak', 'verifikasi', 'x', 'gagal']",5,4,1,tidak verifikasi x gagal,4,4
Ok trima kasih mudah-mudahan berhasil 🙂,positif,2023-10-24,2023,ok trima kasih mudah mudahan berhasil,6,6,oke terima kasih mudah mudahan berhasil,6,6,"['oke', 'terima', 'kasih', 'mudah', 'mudahan', 'berhasil']","['oke', 'terima', 'kasih', 'mudah', 'mudahan', 'berhasil']",6,6,0,oke terima kasih mudah mudah hasil,6,6
Cukup nyaman digunakan aplikasinya,positif,2021-02-10,2021,cukup nyaman digunakan aplikasinya,4,4,cukup nyaman digunakan aplikasi nya,4,5,"['cukup', 'nyaman', 'digunakan', 'aplikasi', 'nya']","['nyaman', 'aplikasi', 'nya']",5,3,2,nyaman aplikasi nya,3,3
"Good,membuka jaringan pertemanan",positif,2021-02-25,2021,good membuka jaringan pertemanan,3,4,bagus membuka jaringan pertemanan,4,4,"['bagus', 'membuka', 'jaringan', 'pertemanan']","['bagus', 'membuka', 'jaringan', 'pertemanan']",4,4,0,bagus buka jaring teman,4,4
Amazing dan menyenangkan,positif,2022-02-23,2022,amazing dan menyenangkan,3,3,amazing dan menyenangkan,3,3,"['amazing', 'dan', 'menyenangkan']","['amazing', 'menyenangkan']",3,2,1,amazing senang,2,2
Aplikasi yg banyak menginspirasi,positif,2021-12-12,2021,aplikasi yg banyak menginspirasi,4,4,aplikasi yang banyak menginspirasi,4,4,"['aplikasi', 'yang', 'banyak', 'menginspirasi']","['aplikasi', 'menginspirasi']",4,2,2,aplikasi inspirasi,2,2
"Gak jelas, aku mau daftar susah",negatif,2023-04-30,2023,gak jelas aku mau daftar susah,6,6,tidak jelas aku mau daftar susah,6,6,"['tidak', 'jelas', 'aku', 'mau', 'daftar', 'susah']","['tidak', 'daftar', 'susah']",6,3,3,tidak daftar susah,3,3
Tidak bisa login,negatif,2020-12-02,2020,tidak bisa login,3,3,tidak bisa login,3,3,"['tidak', 'bisa', 'login']","['tidak', 'login']",3,2,1,tidak login,2,2
Kok gak bisa masuk yak padahal udah pake google,negatif,2021-12-12,2021,kok gak bisa masuk yak padahal udah pake google,9,9,kok tidak bisa masuk yak padahal sudah pakai google,9,9,"['kok', 'tidak', 'bisa', 'masuk', 'yak', 'padahal', 'sudah', 'pakai', 'google']","['tidak', 'masuk', 'yak', 'pakai', 'google']",9,5,4,tidak masuk yak pakai google,5,5
Selalu aktif beraktifitas,positif,2021-11-29,2021,selalu aktif beraktifitas,3,3,selalu aktif beraktifitas,3,3,"['selalu', 'aktif', 'beraktifitas']","['aktif', 'beraktifitas']",3,2,1,aktif beraktifitas,2,2
Berpikir positif dan selalu cool,positif,2022-02-09,2022,berpikir positif dan selalu cool,5,5,berpikir positif dan selalu cool,5,5,"['berpikir', 'positif', 'dan', 'selalu', 'cool']","['berpikir', 'positif', 'cool']",5,3,2,pikir positif cool,3,3
Sangat bermanfaat membangun hubungan bisnis,positif,2021-03-22,2021,sangat bermanfaat membangun hubungan bisnis,5,5,sangat bermanfaat membangun hubungan bisnis,5,5,"['sangat', 'bermanfaat', 'membangun', 'hubungan', 'bisnis']","['bermanfaat', 'membangun', 'hubungan', 'bisnis']",5,4,1,manfaat bangun hubung bisnis,4,4
Sangat membantu dan bermanfaat.,positif,2021-05-10,2021,sangat membantu dan bermanfaat,4,4,sangat membantu dan bermanfaat,4,4,"['sangat', 'membantu', 'dan', 'bermanfaat']","['membantu', 'bermanfaat']",4,2,2,bantu manfaat,2,2
Verifikasi terlalu rumit,negatif,2021-07-30,2021,verifikasi terlalu rumit,3,3,verifikasi terlalu rumit,3,3,"['verifikasi', 'terlalu', 'rumit']","['verifikasi', 'rumit']",3,2,1,verifikasi rumit,2,2
Bagus dan menyenangkan,positif,2022-03-21,2022,bagus dan menyenangkan,3,3,bagus dan menyenangkan,3,3,"['bagus', 'dan', 'menyenangkan']","['bagus', 'menyenangkan']",3,2,1,bagus senang,2,2
Baik untuk menemukan pekerjaan,positif,2024-01-16,2024,baik untuk menemukan pekerjaan,4,4,baik untuk menemukan pekerjaan,4,4,"['baik', 'untuk', 'menemukan', 'pekerjaan']","['menemukan', 'pekerjaan']",4,2,2,temu kerja,2,2
Sangat membantu dan. Banyak wawasan,positif,2021-09-20,2021,sangat membantu dan banyak wawasan,5,5,sangat membantu dan banyak wawasan,5,5,"['sangat', 'membantu', 'dan', 'banyak', 'wawasan']","['membantu', 'wawasan']",5,2,3,bantu wawas,2,2
susah banget buat login,negatif,2023-08-04,2023,susah banget buat login,4,4,susah banget buat login,4,4,"['susah', 'banget', 'buat', 'login']","['susah', 'banget', 'login']",4,3,1,susah banget login,3,3
Bagus dan cukup membantu,positif,2022-06-16,2022,bagus dan cukup membantu,4,4,bagus dan cukup membantu,4,4,"['bagus', 'dan', 'cukup', 'membantu']","['bagus', 'membantu']",4,2,2,bagus bantu,2,2
Apk error gak bisa login,negatif,2022-11-01,2022,apk error gak bisa login,5,5,aplikasi error tidak bisa login,5,5,"['aplikasi', 'error', 'tidak', 'bisa', 'login']","['aplikasi', 'error', 'tidak', 'login']",5,4,1,aplikasi error tidak login,4,4
ok sangat memuaskan dan dapat mengetahui dunia bisnis,positif,2020-09-18,2020,ok sangat memuaskan dan dapat mengetahui dunia bisnis,8,8,oke sangat memuaskan dan dapat mengetahui dunia bisnis,8,8,"['oke', 'sangat', 'memuaskan', 'dan', 'dapat', 'mengetahui', 'dunia', 'bisnis']","['oke', 'memuaskan', 'dunia', 'bisnis']",8,4,4,oke muas dunia bisnis,4,4
Sangat bagus sekali LinkedIn ini,positif,2023-12-18,2023,sangat bagus sekali linkedin ini,5,5,sangat bagus sekali linkedin ini,5,5,"['sangat', 'bagus', 'sekali', 'linkedin', 'ini']","['bagus', 'linkedin']",5,2,3,bagus linkedin,2,2
Cepat & bermanfaat sekali,positif,2020-12-13,2020,cepat bermanfaat sekali,4,3,cepat bermanfaat sekali,3,3,"['cepat', 'bermanfaat', 'sekali']","['cepat', 'bermanfaat']",3,2,1,cepat manfaat,2,2
Saya kasih bintang 5 biar saya cepat dapat kerja,positif,2023-07-26,2023,saya kasih bintang biar saya cepat dapat kerja,9,8,saya kasih bintang biar saya cepat dapat kerja,8,8,"['saya', 'kasih', 'bintang', 'biar', 'saya', 'cepat', 'dapat', 'kerja']","['kasih', 'bintang', 'biar', 'cepat', 'kerja']",8,5,3,kasih bintang biar cepat kerja,5,5
SETELAH UPDATE TIDAK BISA MENYIMPAN FOTO. HADEUHHH,negatif,2023-09-17,2023,setelah update tidak bisa menyimpan foto hadeuhhh,7,7,setelah diperbarui tidak bisa menyimpan foto hadeuhhh,7,7,"['setelah', 'diperbarui', 'tidak', 'bisa', 'menyimpan', 'foto', 'hadeuhhh']","['diperbarui', 'tidak', 'menyimpan', 'foto', 'hadeuhhh']",7,5,2,baru tidak simpan foto hadeuhhh,5,5
"Banyak berjalan, banyak yang dilihat",positif,2020-11-04,2020,banyak berjalan banyak yang dilihat,5,5,banyak berjalan banyak yang dilihat,5,5,"['banyak', 'berjalan', 'banyak', 'yang', 'dilihat']",['berjalan'],5,1,4,jalan,1,1
Aplikasi keren dan sangat bermanfaat,positif,2024-03-06,2024,aplikasi keren dan sangat bermanfaat,5,5,aplikasi keren dan sangat bermanfaat,5,5,"['aplikasi', 'keren', 'dan', 'sangat', 'bermanfaat']","['aplikasi', 'keren', 'bermanfaat']",5,3,2,aplikasi keren manfaat,3,3
"Sama aja 😊, tetap jalur dalam yang menang.",positif,2023-09-03,2023,sama aja tetap jalur dalam yang menang,8,7,sama saja tetap jalur dalam yang menang,7,7,"['sama', 'saja', 'tetap', 'jalur', 'dalam', 'yang', 'menang']","['jalur', 'menang']",7,2,5,jalur menang,2,2
Mudah dan cepat,positif,2021-08-25,2021,mudah dan cepat,3,3,mudah dan cepat,3,3,"['mudah', 'dan', 'cepat']","['mudah', 'cepat']",3,2,1,mudah cepat,2,2
Lumayan mudah untuk melihatmu,positif,2023-08-23,2023,lumayan mudah untuk melihatmu,4,4,lumayan mudah untuk melihatmu,4,4,"['lumayan', 'mudah', 'untuk', 'melihatmu']","['lumayan', 'mudah', 'melihatmu']",4,3,1,lumayan mudah lihat,3,3
"Memberikan wawasan yang luas, dengan rekan SE profesi 👍",positif,2023-07-15,2023,memberikan wawasan yang luas dengan rekan se profesi,9,8,memberikan wawasan yang luas dengan rekan se profesi,8,8,"['memberikan', 'wawasan', 'yang', 'luas', 'dengan', 'rekan', 'se', 'profesi']","['wawasan', 'luas', 'rekan', 'profesi']",8,4,4,wawas luas rekan profesi,4,4
Bagus dan sangat membantu,positif,2023-07-24,2023,bagus dan sangat membantu,4,4,bagus dan sangat membantu,4,4,"['bagus', 'dan', 'sangat', 'membantu']","['bagus', 'membantu']",4,2,2,bagus bantu,2,2
Lemot bro ..knp ya hp ini,negatif,2023-12-09,2023,lemot bro knp ya hp ini,6,6,lambat bro kenapa ya handphone ini,6,6,"['lambat', 'bro', 'kenapa', 'ya', 'handphone', 'ini']","['lambat', 'bro', 'ya', 'handphone']",6,4,2,lambat bro ya handphone,4,4
Sangat membantu dan berguna,positif,2023-12-29,2023,sangat membantu dan berguna,4,4,sangat membantu dan berguna,4,4,"['sangat', 'membantu', 'dan', 'berguna']","['membantu', 'berguna']",4,2,2,bantu guna,2,2
Benar benar membantu saya terhubung dengan banyak orang yang se karir dengan saya di seluruh dunia,positif,2020-01-09,2020,benar benar membantu saya terhubung dengan banyak orang yang se karir dengan saya di seluruh dunia,16,16,benar benar membantu saya terhubung dengan banyak orang yang se karir dengan saya di seluruh dunia,16,16,"['benar', 'benar', 'membantu', 'saya', 'terhubung', 'dengan', 'banyak', 'orang', 'yang', 'se', 'karir', 'dengan', 'saya', 'di', 'seluruh', 'dunia']","['membantu', 'terhubung', 'orang', 'karir', 'dunia']",16,5,11,bantu hubung orang karir dunia,5,5
Saya suka aplikasi nya Mudah di mengerti dan lain lain,positif,2024-01-05,2024,saya suka aplikasi nya mudah di mengerti dan lain lain,10,10,saya suka aplikasi nya mudah di mengerti dan lain lain,10,10,"['saya', 'suka', 'aplikasi', 'nya', 'mudah', 'di', 'mengerti', 'dan', 'lain', 'lain']","['suka', 'aplikasi', 'nya', 'mudah', 'mengerti']",10,5,5,suka aplikasi nya mudah erti,5,5
Tambah luas relasi Bisnis. Semoga bermanfaat,positif,2020-03-05,2020,tambah luas relasi bisnis semoga bermanfaat,6,6,tambah luas relasi bisnis semoga bermanfaat,6,6,"['tambah', 'luas', 'relasi', 'bisnis', 'semoga', 'bermanfaat']","['luas', 'relasi', 'bisnis', 'semoga', 'bermanfaat']",6,5,1,luas relasi bisnis moga manfaat,5,5
Tidak bisa login,negatif,2024-01-29,2024,tidak bisa login,3,3,tidak bisa login,3,3,"['tidak', 'bisa', 'login']","['tidak', 'login']",3,2,1,tidak login,2,2
Tidak bisa login,negatif,2023-09-19,2023,tidak bisa login,3,3,tidak bisa login,3,3,"['tidak', 'bisa', 'login']","['tidak', 'login']",3,2,1,tidak login,2,2
Sangat luar biasa aplikasinya the best,positif,2024-01-10,2024,sangat luar biasa aplikasinya the best,6,6,sangat luar biasa aplikasi nya the terbaik,6,7,"['sangat', 'luar', 'biasa', 'aplikasi', 'nya', 'the', 'terbaik']","['aplikasi', 'nya', 'the', 'terbaik']",7,4,3,aplikasi nya the baik,4,4
Nggak bisa login pdhl baru buat akun.,negatif,2023-09-11,2023,nggak bisa login pdhl baru buat akun,7,7,tidak bisa login padahal baru buat akun,7,7,"['tidak', 'bisa', 'login', 'padahal', 'baru', 'buat', 'akun']","['tidak', 'login', 'akun']",7,3,4,tidak login akun,3,3
Apk yg membingungkan rumit dan berbelit-belit,negatif,2024-03-01,2024,apk yg membingungkan rumit dan berbelit belit,6,7,aplikasi yang membingungkan rumit dan berbelit belit,7,7,"['aplikasi', 'yang', 'membingungkan', 'rumit', 'dan', 'berbelit', 'belit']","['aplikasi', 'membingungkan', 'rumit', 'berbelit', 'belit']",7,5,2,aplikasi bingung rumit belit belit,5,5
Susah verivikasi ny salah terus,negatif,2023-12-17,2023,susah verivikasi ny salah terus,5,5,susah verivikasi nya salah terus,5,5,"['susah', 'verivikasi', 'nya', 'salah', 'terus']","['susah', 'verivikasi', 'nya', 'salah']",5,4,1,susah verivikasi nya salah,4,4
verifikasi kemanannya ga jelas ribet,negatif,2023-11-19,2023,verifikasi kemanannya ga jelas ribet,5,5,verifikasi kemanannya tidak jelas rumit,5,5,"['verifikasi', 'kemanannya', 'tidak', 'jelas', 'rumit']","['verifikasi', 'kemanannya', 'tidak', 'rumit']",5,4,1,verifikasi keman tidak rumit,4,4
Aplikasi ini sangat oke banget,positif,2024-01-19,2024,aplikasi ini sangat oke banget,5,5,aplikasi ini sangat oke banget,5,5,"['aplikasi', 'ini', 'sangat', 'oke', 'banget']","['aplikasi', 'oke', 'banget']",5,3,2,aplikasi oke banget,3,3
"Sangat membantu,bagus sekali",positif,2020-11-12,2020,sangat membantu bagus sekali,3,4,sangat membantu bagus sekali,4,4,"['sangat', 'membantu', 'bagus', 'sekali']","['membantu', 'bagus']",4,2,2,bantu bagus,2,2
Mantap banyak info lowongan,positif,2024-01-13,2024,mantap banyak info lowongan,4,4,mantap banyak informasi lowongan,4,4,"['mantap', 'banyak', 'informasi', 'lowongan']","['mantap', 'informasi', 'lowongan']",4,3,1,mantap informasi lowong,3,3
SAYA SETUJU DENGAN POSTINGAN INI,positif,2024-06-19,2024,saya setuju dengan postingan ini,5,5,saya setuju dengan postingan ini,5,5,"['saya', 'setuju', 'dengan', 'postingan', 'ini']","['setuju', 'postingan']",5,2,3,tuju postingan,2,2
Selalu diarahkan dan mantap,positif,2022-03-02,2022,selalu diarahkan dan mantap,4,4,selalu diarahkan dan mantap,4,4,"['selalu', 'diarahkan', 'dan', 'mantap']","['diarahkan', 'mantap']",4,2,2,arah mantap,2,2
Pas login verifikasi nya ribet amat,negatif,2023-08-10,2023,pas login verifikasi nya ribet amat,6,6,pas login verifikasi nya rumit amat,6,6,"['pas', 'login', 'verifikasi', 'nya', 'rumit', 'amat']","['pas', 'login', 'verifikasi', 'nya', 'rumit']",6,5,1,pas login verifikasi nya rumit,5,5
"Gajelas , verif kode tapi gak ke kirim kirim",negatif,2023-10-12,2023,gajelas verif kode tapi gak ke kirim kirim,9,8,tidak jelas verif kode tapi tidak ke kirim kirim,8,9,"['tidak', 'jelas', 'verif', 'kode', 'tapi', 'tidak', 'ke', 'kirim', 'kirim']","['tidak', 'verif', 'kode', 'tidak', 'kirim', 'kirim']",9,6,3,tidak verif kode tidak kirim kirim,6,6
"Banyak informasi lowongan kerja, semoga saya bisa mendapatkan pekerjaan dari sini Aamiin 🤲",positif,2023-08-03,2023,banyak informasi lowongan kerja semoga saya bisa mendapatkan pekerjaan dari sini aamiin,13,12,banyak informasi lowongan kerja semoga saya bisa mendapatkan pekerjaan dari sini aamiin,12,12,"['banyak', 'informasi', 'lowongan', 'kerja', 'semoga', 'saya', 'bisa', 'mendapatkan', 'pekerjaan', 'dari', 'sini', 'aamiin']","['informasi', 'lowongan', 'kerja', 'semoga', 'pekerjaan', 'aamiin']",12,6,6,informasi lowong kerja moga kerja aamiin,6,6
Surga professional dan pencari kerja,positif,2023-10-03,2023,surga professional dan pencari kerja,5,5,surga professional dan pencari kerja,5,5,"['surga', 'professional', 'dan', 'pencari', 'kerja']","['surga', 'professional', 'pencari', 'kerja']",5,4,1,surga professional cari kerja,4,4
Sangat Puas sama app ini 👍👍,positif,2022-05-29,2022,sangat puas sama app ini,6,5,sangat puas sama aplikasi ini,5,5,"['sangat', 'puas', 'sama', 'aplikasi', 'ini']","['puas', 'aplikasi']",5,2,3,puas aplikasi,2,2
Sangat baik dan mudah sekali,positif,2022-02-19,2022,sangat baik dan mudah sekali,5,5,sangat baik dan mudah sekali,5,5,"['sangat', 'baik', 'dan', 'mudah', 'sekali']",['mudah'],5,1,4,mudah,1,1
Membantu komunikasi bisnis dan pekerjaan kita,positif,2022-06-30,2022,membantu komunikasi bisnis dan pekerjaan kita,6,6,membantu komunikasi bisnis dan pekerjaan kita,6,6,"['membantu', 'komunikasi', 'bisnis', 'dan', 'pekerjaan', 'kita']","['membantu', 'komunikasi', 'bisnis', 'pekerjaan']",6,4,2,bantu komunikasi bisnis kerja,4,4
verifikasi gambar selalu salah,negatif,2022-04-09,2022,verifikasi gambar selalu salah,4,4,verifikasi gambar selalu salah,4,4,"['verifikasi', 'gambar', 'selalu', 'salah']","['verifikasi', 'gambar', 'salah']",4,3,1,verifikasi gambar salah,3,3
Mempermudah jaringan,positif,2020-07-11,2020,mempermudah jaringan,2,2,mempermudah jaringan,2,2,"['mempermudah', 'jaringan']","['mempermudah', 'jaringan']",2,2,0,mudah jaring,2,2
Informasi pekerjaan sangat akurat.,positif,2021-06-10,2021,informasi pekerjaan sangat akurat,4,4,informasi pekerjaan sangat akurat,4,4,"['informasi', 'pekerjaan', 'sangat', 'akurat']","['informasi', 'pekerjaan', 'akurat']",4,3,1,informasi kerja akurat,3,3
Info bagus Dan sangat membantu,positif,2020-11-01,2020,info bagus dan sangat membantu,5,5,informasi bagus dan sangat membantu,5,5,"['informasi', 'bagus', 'dan', 'sangat', 'membantu']","['informasi', 'bagus', 'membantu']",5,3,2,informasi bagus bantu,3,3
.#_cepat berinteraksi bersama Linkedln.,positif,2023-08-17,2023,cepat berinteraksi bersama linkedln,4,4,cepat berinteraksi bersama linkedln,4,4,"['cepat', 'berinteraksi', 'bersama', 'linkedln']","['cepat', 'berinteraksi', 'linkedln']",4,3,1,cepat interaksi linkedln,3,3
Ini sangat berkualitas,positif,2020-10-19,2020,ini sangat berkualitas,3,3,ini sangat berkualitas,3,3,"['ini', 'sangat', 'berkualitas']",['berkualitas'],3,1,2,kualitas,1,1
Apk ini sangat membantu. Thanks,positif,2020-05-12,2020,apk ini sangat membantu thanks,5,5,aplikasi ini sangat membantu terima kasih,5,6,"['aplikasi', 'ini', 'sangat', 'membantu', 'terima', 'kasih']","['aplikasi', 'membantu', 'terima', 'kasih']",6,4,2,aplikasi bantu terima kasih,4,4
"BUG VERIFIKASI CAPTCHA TOLONG DIPERBAIKI, BANYAK PENGGGUN YANG TIDAK BISA LOGIN PERKARA BUG ITU",negatif,2023-07-23,2023,bug verifikasi captcha tolong diperbaiki banyak pengggun yang tidak bisa login perkara bug itu,14,14,bug verifikasi captcha tolong di perbaiki banyak pengggun yang tidak bisa login perkara bug itu,14,15,"['bug', 'verifikasi', 'captcha', 'tolong', 'di', 'perbaiki', 'banyak', 'pengggun', 'yang', 'tidak', 'bisa', 'login', 'perkara', 'bug', 'itu']","['bug', 'verifikasi', 'captcha', 'tolong', 'perbaiki', 'pengggun', 'tidak', 'login', 'perkara', 'bug']",15,10,5,bug verifikasi captcha tolong baik pengggun tidak login perkara bug,10,10
Bad!! Terjadi kesalahan terus,negatif,2023-04-29,2023,bad terjadi kesalahan terus,4,4,bad terjadi kesalahan terus,4,4,"['bad', 'terjadi', 'kesalahan', 'terus']","['bad', 'kesalahan']",4,2,2,bad salah,2,2
Bagus utk koneksi,positif,2020-11-07,2020,bagus utk koneksi,3,3,bagus untuk koneksi,3,3,"['bagus', 'untuk', 'koneksi']","['bagus', 'koneksi']",3,2,1,bagus koneksi,2,2
Ribet jangan donload banyak vertivikasi terus gua di sangka robot,negatif,2021-07-08,2021,ribet jangan donload banyak vertivikasi terus gua di sangka robot,10,10,rumit jangan donload banyak vertivikasi terus saya di sangka robot,10,10,"['rumit', 'jangan', 'donload', 'banyak', 'vertivikasi', 'terus', 'saya', 'di', 'sangka', 'robot']","['rumit', 'donload', 'vertivikasi', 'sangka', 'robot']",10,5,5,rumit donload vertivikasi sangka robot,5,5
Permainan ini seru banget aku suka,positif,2020-03-25,2020,permainan ini seru banget aku suka,6,6,permainan ini seru banget aku suka,6,6,"['permainan', 'ini', 'seru', 'banget', 'aku', 'suka']","['permainan', 'seru', 'banget', 'suka']",6,4,2,main seru banget suka,4,4
terimakasih telah membantu pengguna lebih baik🙏,positif,2020-05-11,2020,terimakasih telah membantu pengguna lebih baik,6,6,terima kasih telah membantu pengguna lebih baik,6,7,"['terima', 'kasih', 'telah', 'membantu', 'pengguna', 'lebih', 'baik']","['terima', 'kasih', 'membantu', 'pengguna']",7,4,3,terima kasih bantu guna,4,4
Aplikasi asu mau masuk aja susah bngt,negatif,2022-10-20,2022,aplikasi asu mau masuk aja susah bngt,7,7,aplikasi asu mau masuk saja susah banget,7,7,"['aplikasi', 'asu', 'mau', 'masuk', 'saja', 'susah', 'banget']","['aplikasi', 'asu', 'masuk', 'susah', 'banget']",7,5,2,aplikasi asu masuk susah banget,5,5
Semoga bisa membantu dalam mencari pekerjaan,positif,2020-09-12,2020,semoga bisa membantu dalam mencari pekerjaan,6,6,semoga bisa membantu dalam mencari pekerjaan,6,6,"['semoga', 'bisa', 'membantu', 'dalam', 'mencari', 'pekerjaan']","['semoga', 'membantu', 'mencari', 'pekerjaan']",6,4,2,moga bantu cari kerja,4,4
Banyak sekali info loker di linkdin,positif,2022-01-26,2022,banyak sekali info loker di linkdin,6,6,banyak sekali informasi loker di linkdin,6,6,"['banyak', 'sekali', 'informasi', 'loker', 'di', 'linkdin']","['informasi', 'loker', 'linkdin']",6,3,3,informasi loker linkdin,3,3
Semoga membantu kerja saya dan kluarga saya linkendin,positif,2020-07-05,2020,semoga membantu kerja saya dan kluarga saya linkendin,8,8,semoga membantu kerja saya dan kluarga saya linkendin,8,8,"['semoga', 'membantu', 'kerja', 'saya', 'dan', 'kluarga', 'saya', 'linkendin']","['semoga', 'membantu', 'kerja', 'kluarga', 'linkendin']",8,5,3,moga bantu kerja kluarga linkendin,5,5
Kami langsung bintang 5 kalau ssya liat bagus,positif,2023-07-14,2023,kami langsung bintang kalau ssya liat bagus,8,7,kami langsung bintang kalau ssya lihat bagus,7,7,"['kami', 'langsung', 'bintang', 'kalau', 'ssya', 'lihat', 'bagus']","['langsung', 'bintang', 'ssya', 'lihat', 'bagus']",7,5,2,langsung bintang ssya lihat bagus,5,5
saya merasa terbantu ada aplikasi i,positif,2023-06-06,2023,saya merasa terbantu ada aplikasi i,6,6,saya merasa membantu ada aplikasi i,6,6,"['saya', 'merasa', 'membantu', 'ada', 'aplikasi', 'i']","['membantu', 'aplikasi', 'i']",6,3,3,bantu aplikasi i,3,3
Sangat penting untuk pemberangkatan,positif,2021-06-14,2021,sangat penting untuk pemberangkatan,4,4,sangat penting untuk pemberangkatan,4,4,"['sangat', 'penting', 'untuk', 'pemberangkatan']",['pemberangkatan'],4,1,3,berangkat,1,1
"Linkedin,perlindungan dasar hukum kami,bersamamoe akoeSelamanya",positif,2021-07-20,2021,linkedin perlindungan dasar hukum kami bersamamoe akoeselamanya,5,7,linkedin perlindungan dasar hukum kami bersamamoe akoeselamanya,7,7,"['linkedin', 'perlindungan', 'dasar', 'hukum', 'kami', 'bersamamoe', 'akoeselamanya']","['linkedin', 'perlindungan', 'dasar', 'hukum', 'bersamamoe', 'akoeselamanya']",7,6,1,linkedin lindung dasar hukum bersamamoe akoeselamanya,6,6
Terima kasih sdh memberikan fasilitas untuk kita bisa lbh baik dlm karir atau bisnis 🙏,positif,2020-03-29,2020,terima kasih sdh memberikan fasilitas untuk kita bisa lbh baik dlm karir atau bisnis,15,14,terima kasih sudah memberikan fasilitas untuk kita bisa lebih baik dalam karir atau bisnis,14,14,"['terima', 'kasih', 'sudah', 'memberikan', 'fasilitas', 'untuk', 'kita', 'bisa', 'lebih', 'baik', 'dalam', 'karir', 'atau', 'bisnis']","['terima', 'kasih', 'fasilitas', 'karir', 'bisnis']",14,5,9,terima kasih fasilitas karir bisnis,5,5
Semoga bermanfaat untuk saya dan semua orang yang memakai aplikasi ini,positif,2020-08-02,2020,semoga bermanfaat untuk saya dan semua orang yang memakai aplikasi ini,11,11,semoga bermanfaat untuk saya dan semua orang yang memakai aplikasi ini,11,11,"['semoga', 'bermanfaat', 'untuk', 'saya', 'dan', 'semua', 'orang', 'yang', 'memakai', 'aplikasi', 'ini']","['semoga', 'bermanfaat', 'orang', 'memakai', 'aplikasi']",11,5,6,moga manfaat orang pakai aplikasi,5,5
informasi tentang job,positif,2022-06-25,2022,informasi tentang job,3,3,informasi tentang kerja,3,3,"['informasi', 'tentang', 'kerja']","['informasi', 'kerja']",3,2,1,informasi kerja,2,2
mantap ne krn info x akurat....,positif,2022-01-17,2022,mantap ne krn info x akurat,6,6,mantap ne karena informasi x akurat,6,6,"['mantap', 'ne', 'karena', 'informasi', 'x', 'akurat']","['mantap', 'ne', 'informasi', 'x', 'akurat']",6,5,1,mantap ne informasi x akurat,5,5
Bagus dan mudah,positif,2020-09-12,2020,bagus dan mudah,3,3,bagus dan mudah,3,3,"['bagus', 'dan', 'mudah']","['bagus', 'mudah']",3,2,1,bagus mudah,2,2
aplikasi gajelas akun saya tiba-tiba di banned.,negatif,2023-08-12,2023,aplikasi gajelas akun saya tiba tiba di banned,7,8,aplikasi tidak jelas akun saya tiba tiba di banned,8,9,"['aplikasi', 'tidak', 'jelas', 'akun', 'saya', 'tiba', 'tiba', 'di', 'banned']","['aplikasi', 'tidak', 'akun', 'banned']",9,4,5,aplikasi tidak akun banned,4,4
Saya membantu saya untuk mencari pekerjaan,positif,2020-09-12,2020,saya membantu saya untuk mencari pekerjaan,6,6,saya membantu saya untuk mencari pekerjaan,6,6,"['saya', 'membantu', 'saya', 'untuk', 'mencari', 'pekerjaan']","['membantu', 'mencari', 'pekerjaan']",6,3,3,bantu cari kerja,3,3
Mudah2an bermanfaat untuk semua orang..!,positif,2023-02-20,2023,mudah an bermanfaat untuk semua orang,5,6,mudah an bermanfaat untuk semua orang,6,6,"['mudah', 'an', 'bermanfaat', 'untuk', 'semua', 'orang']","['mudah', 'an', 'bermanfaat', 'orang']",6,4,2,mudah an manfaat orang,4,4
Sangat membantu terimakasih 🙏,positif,2021-06-27,2021,sangat membantu terimakasih,4,3,sangat membantu terima kasih,3,4,"['sangat', 'membantu', 'terima', 'kasih']","['membantu', 'terima', 'kasih']",4,3,1,bantu terima kasih,3,3
Sangat bagus dan membantu,positif,2021-05-02,2021,sangat bagus dan membantu,4,4,sangat bagus dan membantu,4,4,"['sangat', 'bagus', 'dan', 'membantu']","['bagus', 'membantu']",4,2,2,bagus bantu,2,2
Terimakasih kami bisa bergabung di aplikasi ini,positif,2021-07-28,2021,terimakasih kami bisa bergabung di aplikasi ini,7,7,terima kasih kami bisa bergabung di aplikasi ini,7,8,"['terima', 'kasih', 'kami', 'bisa', 'bergabung', 'di', 'aplikasi', 'ini']","['terima', 'kasih', 'bergabung', 'aplikasi']",8,4,4,terima kasih gabung aplikasi,4,4
Wow aplikasi ini sangat membantu,positif,2022-02-04,2022,wow aplikasi ini sangat membantu,5,5,wow aplikasi ini sangat membantu,5,5,"['wow', 'aplikasi', 'ini', 'sangat', 'membantu']","['wow', 'aplikasi', 'membantu']",5,3,2,wow aplikasi bantu,3,3
Bagus aplikasi yang bisa membantu saya,positif,2022-05-17,2022,bagus aplikasi yang bisa membantu saya,6,6,bagus aplikasi yang bisa membantu saya,6,6,"['bagus', 'aplikasi', 'yang', 'bisa', 'membantu', 'saya']","['bagus', 'aplikasi', 'membantu']",6,3,3,bagus aplikasi bantu,3,3
Bagus untuk perusahaan,positif,2023-09-23,2023,bagus untuk perusahaan,3,3,bagus untuk perusahaan,3,3,"['bagus', 'untuk', 'perusahaan']","['bagus', 'perusahaan']",3,2,1,bagus usaha,2,2
Verifikasi macam apa ini gagal terus !!!!,negatif,2023-04-15,2023,verifikasi macam apa ini gagal terus,7,6,verifikasi macam apa ini gagal terus,6,6,"['verifikasi', 'macam', 'apa', 'ini', 'gagal', 'terus']","['verifikasi', 'gagal']",6,2,4,verifikasi gagal,2,2
Sy coba 2x24 jam sma saja aplikasi tai,negatif,2021-03-09,2021,sy coba x jam sma saja aplikasi tai,8,8,saya coba x jam sama saja aplikasi tai,8,8,"['saya', 'coba', 'x', 'jam', 'sama', 'saja', 'aplikasi', 'tai']","['coba', 'x', 'jam', 'aplikasi', 'tai']",8,5,3,coba x jam aplikasi tai,5,5
"Verif gajelas, captcha trus trusan sampe 1 jam",negatif,2023-05-13,2023,verif gajelas captcha trus trusan sampe jam,8,7,verif tidak jelas captcha terus trusan sampai jam,7,8,"['verif', 'tidak', 'jelas', 'captcha', 'terus', 'trusan', 'sampai', 'jam']","['verif', 'tidak', 'captcha', 'trusan', 'jam']",8,5,3,verif tidak captcha trusan jam,5,5
Susah untuk mendapatkan kerja,negatif,2021-11-18,2021,susah untuk mendapatkan kerja,4,4,susah untuk mendapatkan kerja,4,4,"['susah', 'untuk', 'mendapatkan', 'kerja']","['susah', 'kerja']",4,2,2,susah kerja,2,2
Goblok ini apk info loker atau aplikasi tebak gambar susah amat verifikasi,negatif,2022-02-15,2022,goblok ini apk info loker atau aplikasi tebak gambar susah amat verifikasi,12,12,goblok ini aplikasi informasi loker atau aplikasi tebak gambar susah amat verifikasi,12,12,"['goblok', 'ini', 'aplikasi', 'informasi', 'loker', 'atau', 'aplikasi', 'tebak', 'gambar', 'susah', 'amat', 'verifikasi']","['goblok', 'aplikasi', 'informasi', 'loker', 'aplikasi', 'tebak', 'gambar', 'susah', 'verifikasi']",12,9,3,goblok aplikasi informasi loker aplikasi tebak gambar susah verifikasi,9,9
"App tai, 5 akun Ku coba main selalu di ban",negatif,2023-06-03,2023,app tai akun ku coba main selalu di ban,10,9,aplikasi tai akun saya coba main selalu di ban,9,9,"['aplikasi', 'tai', 'akun', 'saya', 'coba', 'main', 'selalu', 'di', 'ban']","['aplikasi', 'tai', 'akun', 'coba', 'main', 'ban']",9,6,3,aplikasi tai akun coba main ban,6,6
Terimakasih buat App LinkedIn ..,positif,2020-04-29,2020,terimakasih buat app linkedin,5,4,terima kasih buat aplikasi linkedin,4,5,"['terima', 'kasih', 'buat', 'aplikasi', 'linkedin']","['terima', 'kasih', 'aplikasi', 'linkedin']",5,4,1,terima kasih aplikasi linkedin,4,4
Ini memudah kan saya untuk mencari wawasan,positif,2022-12-22,2022,ini memudah kan saya untuk mencari wawasan,7,7,ini memudah akan saya untuk mencari wawasan,7,7,"['ini', 'memudah', 'akan', 'saya', 'untuk', 'mencari', 'wawasan']","['memudah', 'mencari', 'wawasan']",7,3,4,mudah cari wawas,3,3
Mau daftar verifikasi setengah modar 😂,negatif,2022-05-31,2022,mau daftar verifikasi setengah modar,6,5,mau daftar verifikasi setengah modar,5,5,"['mau', 'daftar', 'verifikasi', 'setengah', 'modar']","['daftar', 'verifikasi', 'modar']",5,3,2,daftar verifikasi modar,3,3
Lebih ditingkatkan lgi,positif,2022-07-07,2022,lebih ditingkatkan lgi,3,3,lebih ditingkatkan lagi,3,3,"['lebih', 'ditingkatkan', 'lagi']",['ditingkatkan'],3,1,2,tingkat,1,1
Linkedin sungguh luar biasa,positif,2021-02-21,2021,linkedin sungguh luar biasa,4,4,linkedin sungguh luar biasa,4,4,"['linkedin', 'sungguh', 'luar', 'biasa']","['linkedin', 'sungguh']",4,2,2,linkedin sungguh,2,2
Sangat bagus dan membantu,positif,2020-07-15,2020,sangat bagus dan membantu,4,4,sangat bagus dan membantu,4,4,"['sangat', 'bagus', 'dan', 'membantu']","['bagus', 'membantu']",4,2,2,bagus bantu,2,2
Sangat mendukung sekali,positif,2020-03-10,2020,sangat mendukung sekali,3,3,sangat mendukung sekali,3,3,"['sangat', 'mendukung', 'sekali']",['mendukung'],3,1,2,dukung,1,1
Aplikasi yang sangat bagus,positif,2021-10-30,2021,aplikasi yang sangat bagus,4,4,aplikasi yang sangat bagus,4,4,"['aplikasi', 'yang', 'sangat', 'bagus']","['aplikasi', 'bagus']",4,2,2,aplikasi bagus,2,2
Mantap 👍 Sangat membantu,positif,2021-03-09,2021,mantap sangat membantu,4,3,mantap sangat membantu,3,3,"['mantap', 'sangat', 'membantu']","['mantap', 'membantu']",3,2,1,mantap bantu,2,2
Bismillah semogah bisa kerja di tempat impian contohnya di SanBox ㅋㅋㅋ,positif,2021-02-25,2021,bismillah semogah bisa kerja di tempat impian contohnya di sanbox,11,10,bismillah semogah bisa kerja di tempat impian contohnya di sanbox,10,10,"['bismillah', 'semogah', 'bisa', 'kerja', 'di', 'tempat', 'impian', 'contohnya', 'di', 'sanbox']","['bismillah', 'semogah', 'kerja', 'impian', 'contohnya', 'sanbox']",10,6,4,bismillah semogah kerja impi contoh sanbox,6,6
Ini akun saya kenapa tidak bisa dibuka lagi?,negatif,2020-05-14,2020,ini akun saya kenapa tidak bisa dibuka lagi,8,8,ini akun saya kenapa tidak bisa dibuka lagi,8,8,"['ini', 'akun', 'saya', 'kenapa', 'tidak', 'bisa', 'dibuka', 'lagi']","['akun', 'tidak', 'dibuka']",8,3,5,akun tidak buka,3,3
Saya tidak bisa mengganti foto profile,negatif,2020-11-01,2020,saya tidak bisa mengganti foto profile,6,6,saya tidak bisa mengganti foto profile,6,6,"['saya', 'tidak', 'bisa', 'mengganti', 'foto', 'profile']","['tidak', 'mengganti', 'foto', 'profile']",6,4,2,tidak ganti foto profile,4,4
Bagus dan sangat bermanfaat ...,positif,2022-12-19,2022,bagus dan sangat bermanfaat,5,4,bagus dan sangat bermanfaat,4,4,"['bagus', 'dan', 'sangat', 'bermanfaat']","['bagus', 'bermanfaat']",4,2,2,bagus manfaat,2,2
Verifikasi gagal terus,negatif,2023-03-16,2023,verifikasi gagal terus,3,3,verifikasi gagal terus,3,3,"['verifikasi', 'gagal', 'terus']","['verifikasi', 'gagal']",3,2,1,verifikasi gagal,2,2
Banyak manfaat dan orang2 hebat di dalamnya...,positif,2021-12-29,2021,banyak manfaat dan orang hebat di dalamnya,7,7,banyak manfaat dan orang hebat di dalamnya,7,7,"['banyak', 'manfaat', 'dan', 'orang', 'hebat', 'di', 'dalamnya']","['manfaat', 'orang', 'hebat', 'dalamnya']",7,4,3,manfaat orang hebat dalam,4,4
Sangat membantu kami.terimakasih,positif,2021-06-30,2021,sangat membantu kami terimakasih,3,4,sangat membantu kami terima kasih,4,5,"['sangat', 'membantu', 'kami', 'terima', 'kasih']","['membantu', 'terima', 'kasih']",5,3,2,bantu terima kasih,3,3
Info2 Lowongan kerja yg akurat bagi jobs seeker..,positif,2021-09-04,2021,info lowongan kerja yg akurat bagi jobs seeker,8,8,informasi lowongan kerja yang akurat bagi jobs seeker,8,8,"['informasi', 'lowongan', 'kerja', 'yang', 'akurat', 'bagi', 'jobs', 'seeker']","['informasi', 'lowongan', 'kerja', 'akurat', 'jobs', 'seeker']",8,6,2,informasi lowong kerja akurat jobs seeker,6,6
Bad !!! Akun saya di nonaktifkan..,negatif,2020-06-23,2020,bad akun saya di nonaktifkan,6,5,bad akun saya di nonaktifkan,5,5,"['bad', 'akun', 'saya', 'di', 'nonaktifkan']","['bad', 'akun', 'nonaktifkan']",5,3,2,bad akun nonaktif,3,3
Bagus menambah link bisnis,positif,2021-09-13,2021,bagus menambah link bisnis,4,4,bagus menambah link bisnis,4,4,"['bagus', 'menambah', 'link', 'bisnis']","['bagus', 'menambah', 'link', 'bisnis']",4,4,0,bagus tambah link bisnis,4,4
Terima kasih sudah bisa bergabung,positif,2022-05-21,2022,terima kasih sudah bisa bergabung,5,5,terima kasih sudah bisa bergabung,5,5,"['terima', 'kasih', 'sudah', 'bisa', 'bergabung']","['terima', 'kasih', 'bergabung']",5,3,2,terima kasih gabung,3,3
Bagus linkedin untuk persahabatan dan berbisnis,positif,2021-07-22,2021,bagus linkedin untuk persahabatan dan berbisnis,6,6,bagus linkedin untuk persahabatan dan berbisnis,6,6,"['bagus', 'linkedin', 'untuk', 'persahabatan', 'dan', 'berbisnis']","['bagus', 'linkedin', 'persahabatan', 'berbisnis']",6,4,2,bagus linkedin sahabat bisnis,4,4
Rancu semua loker di apk ini,negatif,2023-02-07,2023,rancu semua loker di apk ini,6,6,rancu semua loker di aplikasi ini,6,6,"['rancu', 'semua', 'loker', 'di', 'aplikasi', 'ini']","['rancu', 'loker', 'aplikasi']",6,3,3,rancu loker aplikasi,3,3
Salah satu aplikasi berfaedah 👍,positif,2020-03-10,2020,salah satu aplikasi berfaedah,5,4,salah satu aplikasi berfaedah,4,4,"['salah', 'satu', 'aplikasi', 'berfaedah']","['salah', 'aplikasi', 'berfaedah']",4,3,1,salah aplikasi faedah,3,3
mantap..bisa terhubung sma orang2 sepropesi..,positif,2023-07-21,2023,mantap bisa terhubung sma orang sepropesi,5,6,mantap bisa terhubung sama orang sepropesi,6,6,"['mantap', 'bisa', 'terhubung', 'sama', 'orang', 'sepropesi']","['mantap', 'terhubung', 'orang', 'sepropesi']",6,4,2,mantap hubung orang sepropesi,4,4
"mantab jos, untuk tambah relasi",positif,2023-07-17,2023,mantab jos untuk tambah relasi,5,5,mantap jos untuk tambah relasi,5,5,"['mantap', 'jos', 'untuk', 'tambah', 'relasi']","['mantap', 'jos', 'relasi']",5,3,2,mantap jos relasi,3,3
Komunitas sosial para profesional,positif,2022-08-18,2022,komunitas sosial para profesional,4,4,komunitas sosial para profesional,4,4,"['komunitas', 'sosial', 'para', 'profesional']","['komunitas', 'sosial', 'profesional']",4,3,1,komunitas sosial profesional,3,3
Menambah jaringan dan shering knowledge,positif,2021-06-01,2021,menambah jaringan dan shering knowledge,5,5,menambah jaringan dan shering knowledge,5,5,"['menambah', 'jaringan', 'dan', 'shering', 'knowledge']","['menambah', 'jaringan', 'shering', 'knowledge']",5,4,1,tambah jaring shering knowledge,4,4
"Aplikasi ini seperti hasil kolaborasi antara facebook dengan jobstreet, semoga kedepan akan ada fitur-fitur yang mampu mendukung dalam pelaksanaan sourcing saat proses rekrutmen karyawan",positif,2022-02-06,2022,aplikasi ini seperti hasil kolaborasi antara facebook dengan jobstreet semoga kedepan akan ada fitur fitur yang mampu mendukung dalam pelaksanaan sourcing saat proses rekrutmen karyawan,24,25,aplikasi ini seperti hasil kolaborasi antara facebook dengan jobstreet semoga kedepan akan ada fitur fitur yang mampu mendukung dalam pelaksanaan sourcing saat proses rekrutmen karyawan,25,25,"['aplikasi', 'ini', 'seperti', 'hasil', 'kolaborasi', 'antara', 'facebook', 'dengan', 'jobstreet', 'semoga', 'kedepan', 'akan', 'ada', 'fitur', 'fitur', 'yang', 'mampu', 'mendukung', 'dalam', 'pelaksanaan', 'sourcing', 'saat', 'proses', 'rekrutmen', 'karyawan']","['aplikasi', 'hasil', 'kolaborasi', 'facebook', 'jobstreet', 'semoga', 'kedepan', 'fitur', 'fitur', 'mendukung', 'pelaksanaan', 'sourcing', 'proses', 'rekrutmen', 'karyawan']",25,15,10,aplikasi hasil kolaborasi facebook jobstreet moga depan fitur fitur dukung laksana sourcing proses rekrutmen karyawan,15,15
Aplikasi ini sangat bermanfaat bagi saya,positif,2023-01-12,2023,aplikasi ini sangat bermanfaat bagi saya,6,6,aplikasi ini sangat bermanfaat bagi saya,6,6,"['aplikasi', 'ini', 'sangat', 'bermanfaat', 'bagi', 'saya']","['aplikasi', 'bermanfaat']",6,2,4,aplikasi manfaat,2,2
Bagus dan membantu!!!,positif,2021-05-04,2021,bagus dan membantu,3,3,bagus dan membantu,3,3,"['bagus', 'dan', 'membantu']","['bagus', 'membantu']",3,2,1,bagus bantu,2,2
Aplikasi hebat dan terpercaya,positif,2020-08-11,2020,aplikasi hebat dan terpercaya,4,4,aplikasi hebat dan terpercaya,4,4,"['aplikasi', 'hebat', 'dan', 'terpercaya']","['aplikasi', 'hebat', 'terpercaya']",4,3,1,aplikasi hebat percaya,3,3
Informasi yang banyak memperluas Wawasan berfikir,positif,2023-02-13,2023,informasi yang banyak memperluas wawasan berfikir,6,6,informasi yang banyak memperluas wawasan berfikir,6,6,"['informasi', 'yang', 'banyak', 'memperluas', 'wawasan', 'berfikir']","['informasi', 'memperluas', 'wawasan', 'berfikir']",6,4,2,informasi luas wawas berfikir,4,4
Mau login aja di persulit asuu,negatif,2023-09-17,2023,mau login aja di persulit asuu,6,6,mau login saja di persulit asuu,6,6,"['mau', 'login', 'saja', 'di', 'persulit', 'asuu']","['login', 'persulit', 'asuu']",6,3,3,login sulit asuu,3,3
Banyak lowker Tersedia di sini,positif,2023-09-05,2023,banyak lowker tersedia di sini,5,5,banyak lowker tersedia di sini,5,5,"['banyak', 'lowker', 'tersedia', 'di', 'sini']","['lowker', 'tersedia']",5,2,3,lowker sedia,2,2
Senang memakai aplikasi linkend By,positif,2023-09-30,2023,senang memakai aplikasi linkend by,5,5,senang memakai aplikasi linkend by,5,5,"['senang', 'memakai', 'aplikasi', 'linkend', 'by']","['senang', 'memakai', 'aplikasi', 'linkend', 'by']",5,5,0,senang pakai aplikasi linkend by,5,5
Semoga mudah membantu saya mencari kerja,positif,2021-12-23,2021,semoga mudah membantu saya mencari kerja,6,6,semoga mudah membantu saya mencari kerja,6,6,"['semoga', 'mudah', 'membantu', 'saya', 'mencari', 'kerja']","['semoga', 'mudah', 'membantu', 'mencari', 'kerja']",6,5,1,moga mudah bantu cari kerja,5,5
Pepek akun tiba2 nonaktifkan,negatif,2020-11-29,2020,pepek akun tiba nonaktifkan,4,4,pepek akun tiba nonaktifkan,4,4,"['pepek', 'akun', 'tiba', 'nonaktifkan']","['pepek', 'akun', 'nonaktifkan']",4,3,1,pepek akun nonaktif,3,3
"Jelek, ga bisa masuk",negatif,2023-09-11,2023,jelek ga bisa masuk,4,4,jelek tidak bisa masuk,4,4,"['jelek', 'tidak', 'bisa', 'masuk']","['jelek', 'tidak', 'masuk']",4,3,1,jelek tidak masuk,3,3
Aplikasi sangat membantu,negatif,2021-04-03,2021,aplikasi sangat membantu,3,3,aplikasi sangat membantu,3,3,"['aplikasi', 'sangat', 'membantu']","['aplikasi', 'membantu']",3,2,1,aplikasi bantu,2,2
kok saya gak bisa memperbarui...,negatif,2020-11-12,2020,kok saya gak bisa memperbarui,5,5,kok saya tidak bisa memperbarui,5,5,"['kok', 'saya', 'tidak', 'bisa', 'memperbarui']","['tidak', 'memperbarui']",5,2,3,tidak baru,2,2
Saya pasti bisa jadi programmer,positif,2023-05-07,2023,saya pasti bisa jadi programmer,5,5,saya pasti bisa jadi programmer,5,5,"['saya', 'pasti', 'bisa', 'jadi', 'programmer']",['programmer'],5,1,4,programmer,1,1
Mudah mudahan bisa,positif,2022-07-02,2022,mudah mudahan bisa,3,3,mudah mudahan bisa,3,3,"['mudah', 'mudahan', 'bisa']","['mudah', 'mudahan']",3,2,1,mudah mudah,2,2
Bagus sangat membantu,positif,2020-05-26,2020,bagus sangat membantu,3,3,bagus sangat membantu,3,3,"['bagus', 'sangat', 'membantu']","['bagus', 'membantu']",3,2,1,bagus bantu,2,2
Nyari kerja aja dipersulit goblok pendaftaran ke apk,negatif,2022-10-08,2022,nyari kerja aja dipersulit goblok pendaftaran ke apk,8,8,mencari kerja saja dipersulit goblok pendaftaran ke aplikasi,8,8,"['mencari', 'kerja', 'saja', 'dipersulit', 'goblok', 'pendaftaran', 'ke', 'aplikasi']","['mencari', 'kerja', 'dipersulit', 'goblok', 'pendaftaran', 'aplikasi']",8,6,2,cari kerja sulit goblok daftar aplikasi,6,6
Sulit verifikasi email,negatif,2023-08-13,2023,sulit verifikasi email,3,3,sulit verifikasi email,3,3,"['sulit', 'verifikasi', 'email']","['sulit', 'verifikasi', 'email']",3,3,0,sulit verifikasi email,3,3
Semoga dpt kerja dari linkedin,positif,2021-08-13,2021,semoga dpt kerja dari linkedin,5,5,semoga dapat kerja dari linkedin,5,5,"['semoga', 'dapat', 'kerja', 'dari', 'linkedin']","['semoga', 'kerja', 'linkedin']",5,3,2,moga kerja linkedin,3,3
Riweh cara loginnya banyakan iklan,negatif,2020-06-14,2020,riweh cara loginnya banyakan iklan,5,5,riweh cara loginnya banyakan iklan,5,5,"['riweh', 'cara', 'loginnya', 'banyakan', 'iklan']","['riweh', 'loginnya', 'banyakan', 'iklan']",5,4,1,riweh loginnya banyak iklan,4,4
Mendapatkan Impormasi Berita Perusahaan Dari Seluruh Dunia.,positif,2020-01-12,2020,mendapatkan impormasi berita perusahaan dari seluruh dunia,7,7,mendapatkan impormasi berita perusahaan dari seluruh dunia,7,7,"['mendapatkan', 'impormasi', 'berita', 'perusahaan', 'dari', 'seluruh', 'dunia']","['impormasi', 'berita', 'perusahaan', 'dunia']",7,4,3,impormasi berita usaha dunia,4,4
apps bagus bagi saya,positif,2020-12-16,2020,apps bagus bagi saya,4,4,aplikasi bagus bagi saya,4,4,"['aplikasi', 'bagus', 'bagi', 'saya']","['aplikasi', 'bagus']",4,2,2,aplikasi bagus,2,2
Bagus buat info loker,positif,2020-07-30,2020,bagus buat info loker,4,4,bagus buat informasi loker,4,4,"['bagus', 'buat', 'informasi', 'loker']","['bagus', 'informasi', 'loker']",4,3,1,bagus informasi loker,3,3
mantap linked ini 👍,positif,2020-02-07,2020,mantap linked ini,4,3,mantap linked ini,3,3,"['mantap', 'linked', 'ini']","['mantap', 'linked']",3,2,1,mantap linked,2,2
Verifikasi gambar terossssssss 😠,negatif,2022-06-15,2022,verifikasi gambar terossssssss,4,3,verifikasi gambar terossssssss,3,3,"['verifikasi', 'gambar', 'terossssssss']","['verifikasi', 'gambar', 'terossssssss']",3,3,0,verifikasi gambar terossssssss,3,3
Susah bgt verifikasi nya ajg,negatif,2023-03-15,2023,susah bgt verifikasi nya ajg,5,5,susah banget verifikasi nya ajg,5,5,"['susah', 'banget', 'verifikasi', 'nya', 'ajg']","['susah', 'banget', 'verifikasi', 'nya', 'ajg']",5,5,0,susah banget verifikasi nya ajg,5,5
Ribet tidak sesimpel sebelumnya,negatif,2022-10-11,2022,ribet tidak sesimpel sebelumnya,4,4,rumit tidak sesimpel sebelumnya,4,4,"['rumit', 'tidak', 'sesimpel', 'sebelumnya']","['rumit', 'tidak', 'sesimpel']",4,3,1,rumit tidak simpel,3,3
Bikin akun gagal mulu !!,negatif,2020-03-21,2020,bikin akun gagal mulu,5,4,bikin akun gagal mulu,4,4,"['bikin', 'akun', 'gagal', 'mulu']","['bikin', 'akun', 'gagal', 'mulu']",4,4,0,bikin akun gagal mulu,4,4
"MUTER"" TERUS VERIFIKASI MASUK KAGA...",negatif,2023-10-04,2023,muter terus verifikasi masuk kaga,5,5,memutar terus verifikasi masuk tidak,5,5,"['memutar', 'terus', 'verifikasi', 'masuk', 'tidak']","['memutar', 'verifikasi', 'masuk', 'tidak']",5,4,1,putar verifikasi masuk tidak,4,4
APLIKASI SANGAT MEMBANTU MENCARI PEKERJAAN JARAK JAU MENGARTUR PERFORMANCE BIO DATA SAYA RAHMAT HIDAYAT 🥀,positif,2023-09-11,2023,aplikasi sangat membantu mencari pekerjaan jarak jau mengartur performance bio data saya rahmat hidayat,15,14,aplikasi sangat membantu mencari pekerjaan jarak jau mengartur performance bio data saya rahmat hidayat,14,14,"['aplikasi', 'sangat', 'membantu', 'mencari', 'pekerjaan', 'jarak', 'jau', 'mengartur', 'performance', 'bio', 'data', 'saya', 'rahmat', 'hidayat']","['aplikasi', 'membantu', 'mencari', 'pekerjaan', 'jarak', 'jau', 'mengartur', 'performance', 'bio', 'data', 'rahmat', 'hidayat']",14,12,2,aplikasi bantu cari kerja jarak jau mengartur performance bio data rahmat hidayat,12,12
Semoga mendapat pekerjaan yg sesuai dengan ekspektasi,positif,2020-12-02,2020,semoga mendapat pekerjaan yg sesuai dengan ekspektasi,7,7,semoga mendapat pekerjaan yang sesuai dengan ekspektasi,7,7,"['semoga', 'mendapat', 'pekerjaan', 'yang', 'sesuai', 'dengan', 'ekspektasi']","['semoga', 'pekerjaan', 'sesuai', 'ekspektasi']",7,4,3,moga kerja sesuai ekspektasi,4,4
Security check terus.. aneh,negatif,2024-02-23,2024,security check terus aneh,4,4,security cek terus aneh,4,4,"['security', 'cek', 'terus', 'aneh']","['security', 'cek', 'aneh']",4,3,1,security cek aneh,3,3
"Kereen ni App, bisa jadi saingan Inst...m.. Salam Vtuber dari Vtuber Depok.",positif,2020-12-21,2020,kereen ni app bisa jadi saingan inst m salam vtuber dari vtuber depok,12,13,keren ini aplikasi bisa jadi saingan inst m salam vtuber dari vtuber depok,13,13,"['keren', 'ini', 'aplikasi', 'bisa', 'jadi', 'saingan', 'inst', 'm', 'salam', 'vtuber', 'dari', 'vtuber', 'depok']","['keren', 'aplikasi', 'saingan', 'inst', 'm', 'salam', 'vtuber', 'vtuber', 'depok']",13,9,4,keren aplikasi saing inst m salam vtuber vtuber depok,9,9
kami baru masuk semoga bermanfaat slalu,positif,2020-08-30,2020,kami baru masuk semoga bermanfaat slalu,6,6,kami baru masuk semoga bermanfaat selalu,6,6,"['kami', 'baru', 'masuk', 'semoga', 'bermanfaat', 'selalu']","['masuk', 'semoga', 'bermanfaat']",6,3,3,masuk moga manfaat,3,3
Ribet gunainnya gak kyk apk sebelah tinggal apply²,negatif,2020-07-23,2020,ribet gunainnya gak kyk apk sebelah tinggal apply²,8,8,rumit gunainnya tidak seperti aplikasi sebelah tinggal apply²,8,8,"['rumit', 'gunainnya', 'tidak', 'seperti', 'aplikasi', 'sebelah', 'tinggal', 'apply²']","['rumit', 'gunainnya', 'tidak', 'aplikasi', 'sebelah', 'tinggal', 'apply²']",8,7,1,rumit gunainnya tidak aplikasi belah tinggal apply,7,7
"tiba"" akun dibatasi, GAJELASS bangett!",negatif,2023-04-18,2023,tiba akun dibatasi gajelass bangett,5,5,tiba akun dibatasi gajelass banget,5,5,"['tiba', 'akun', 'dibatasi', 'gajelass', 'banget']","['akun', 'dibatasi', 'gajelass', 'banget']",5,4,1,akun batas gajelass banget,4,4
verivikasi ajg gapernah bener masa blok,negatif,2022-02-03,2022,verivikasi ajg gapernah bener masa blok,6,6,verivikasi ajg tidak pernah benar masa blok,6,7,"['verivikasi', 'ajg', 'tidak', 'pernah', 'benar', 'masa', 'blok']","['verivikasi', 'ajg', 'tidak', 'blok']",7,4,3,verivikasi ajg tidak blok,4,4
Setelah Membaca Ulasan Teman Teman .Mf Saya Tak Tertarik Tuk Gabung ....,positif,2020-03-14,2020,setelah membaca ulasan teman teman mf saya tak tertarik tuk gabung,12,11,setelah membaca ulasan teman teman maaf saya tidak tertarik untuk gabung,11,11,"['setelah', 'membaca', 'ulasan', 'teman', 'teman', 'maaf', 'saya', 'tidak', 'tertarik', 'untuk', 'gabung']","['membaca', 'ulasan', 'teman', 'teman', 'maaf', 'tidak', 'tertarik', 'gabung']",11,8,3,baca ulas teman teman maaf tidak tarik gabung,8,8
Lebih ok dibanding bersi lawas,positif,2020-04-24,2020,lebih ok dibanding bersi lawas,5,5,lebih oke dibanding bersi lawas,5,5,"['lebih', 'oke', 'dibanding', 'bersi', 'lawas']","['oke', 'dibanding', 'bersi', 'lawas']",5,4,1,oke banding bersi lawas,4,4
Semoga di LinkedIn ni bisa membantu saya untuk dapat partner kerja yg pasti dan sesuai dengan saya..🤲🤲🤲,positif,2021-03-03,2021,semoga di linkedin ni bisa membantu saya untuk dapat partner kerja yg pasti dan sesuai dengan saya,17,17,semoga di linkedin ini bisa membantu saya untuk dapat partner kerja yang pasti dan sesuai dengan saya,17,17,"['semoga', 'di', 'linkedin', 'ini', 'bisa', 'membantu', 'saya', 'untuk', 'dapat', 'partner', 'kerja', 'yang', 'pasti', 'dan', 'sesuai', 'dengan', 'saya']","['semoga', 'linkedin', 'membantu', 'partner', 'kerja', 'sesuai']",17,6,11,moga linkedin bantu partner kerja sesuai,6,6
Makin susah untuk login.,negatif,2024-02-29,2024,makin susah untuk login,4,4,makin susah untuk login,4,4,"['makin', 'susah', 'untuk', 'login']","['susah', 'login']",4,2,2,susah login,2,2
Asu login nya susah nian bangsat,negatif,2021-09-17,2021,asu login nya susah nian bangsat,6,6,asu login nya susah nian bangsat,6,6,"['asu', 'login', 'nya', 'susah', 'nian', 'bangsat']","['asu', 'login', 'nya', 'susah', 'nian', 'bangsat']",6,6,0,asu login nya susah nian bangsat,6,6
Bgus utk penyimpanan dokumenya,positif,2020-02-18,2020,bgus utk penyimpanan dokumenya,4,4,bagus untuk penyimpanan dokumenya,4,4,"['bagus', 'untuk', 'penyimpanan', 'dokumenya']","['bagus', 'penyimpanan', 'dokumenya']",4,3,1,bagus simpan dokumenya,3,3
Gajelas maau login aja gabisa,negatif,2023-11-21,2023,gajelas maau login aja gabisa,5,5,tidak jelas maau login saja tidak bisa,5,7,"['tidak', 'jelas', 'maau', 'login', 'saja', 'tidak', 'bisa']","['tidak', 'maau', 'login', 'tidak']",7,4,3,tidak maau login tidak,4,4
Tolol bener mau masuk verifikasi kaga jelas,negatif,2023-05-31,2023,tolol bener mau masuk verifikasi kaga jelas,7,7,tolol benar mau masuk verifikasi tidak jelas,7,7,"['tolol', 'benar', 'mau', 'masuk', 'verifikasi', 'tidak', 'jelas']","['tolol', 'masuk', 'verifikasi', 'tidak']",7,4,3,tolol masuk verifikasi tidak,4,4
Ingin mencoba insya Allah bagus Aamiin 🤲,positif,2022-07-16,2022,ingin mencoba insya allah bagus aamiin,7,6,ingin mencoba insya allah bagus aamiin,6,6,"['ingin', 'mencoba', 'insya', 'allah', 'bagus', 'aamiin']","['mencoba', 'insya', 'allah', 'bagus', 'aamiin']",6,5,1,coba insya allah bagus aamiin,5,5
Bangke ni apk bikinn emosi naik aja,negatif,2022-06-01,2022,bangke ni apk bikinn emosi naik aja,7,7,bangke ini aplikasi bikinn emosi naik saja,7,7,"['bangke', 'ini', 'aplikasi', 'bikinn', 'emosi', 'naik', 'saja']","['bangke', 'aplikasi', 'bikinn', 'emosi']",7,4,3,bangke aplikasi bikinn emosi,4,4
Semangkin jelas n cemerlang. Mampu menyatukan msy.pendidikan.,positif,2021-12-22,2021,semangkin jelas n cemerlang mampu menyatukan msy pendidikan,7,8,semangkin jelas dan cemerlang mampu menyatukan msy pendidikan,8,8,"['semangkin', 'jelas', 'dan', 'cemerlang', 'mampu', 'menyatukan', 'msy', 'pendidikan']","['semangkin', 'cemerlang', 'menyatukan', 'msy', 'pendidikan']",8,5,3,semangkin cemerlang satu msy didik,5,5
Bismillah semoga aplikasi ya bermanfaat aamiin,positif,2020-11-05,2020,bismillah semoga aplikasi ya bermanfaat aamiin,6,6,bismillah semoga aplikasi ya bermanfaat aamiin,6,6,"['bismillah', 'semoga', 'aplikasi', 'ya', 'bermanfaat', 'aamiin']","['bismillah', 'semoga', 'aplikasi', 'ya', 'bermanfaat', 'aamiin']",6,6,0,bismillah moga aplikasi ya manfaat aamiin,6,6
Membantu saya mendptkan kerjaan,positif,2022-08-26,2022,membantu saya mendptkan kerjaan,4,4,membantu saya mendptkan kerjaan,4,4,"['membantu', 'saya', 'mendptkan', 'kerjaan']","['membantu', 'mendptkan', 'kerjaan']",4,3,1,bantu mendptkan kerja,3,3
Hoax tak sesuai yg d datengin ternyata,negatif,2021-01-18,2021,hoax tak sesuai yg d datengin ternyata,7,7,isu bohong tidak sesuai yang di datengin ternyata,7,8,"['isu', 'bohong', 'tidak', 'sesuai', 'yang', 'di', 'datengin', 'ternyata']","['isu', 'bohong', 'tidak', 'sesuai', 'datengin']",8,5,3,isu bohong tidak sesuai datengin,5,5
Keren bisa terhubung dengan orang orang sukses,positif,2021-02-07,2021,keren bisa terhubung dengan orang orang sukses,7,7,keren bisa terhubung dengan orang orang sukses,7,7,"['keren', 'bisa', 'terhubung', 'dengan', 'orang', 'orang', 'sukses']","['keren', 'terhubung', 'orang', 'orang', 'sukses']",7,5,2,keren hubung orang orang sukses,5,5
Aplikasi yg sangat bermanfaat 👍,positif,2022-06-19,2022,aplikasi yg sangat bermanfaat,5,4,aplikasi yang sangat bermanfaat,4,4,"['aplikasi', 'yang', 'sangat', 'bermanfaat']","['aplikasi', 'bermanfaat']",4,2,2,aplikasi manfaat,2,2
APKX SANGAT MEMBANTU Z MENCARI PEKERJAAN Z SANGAT SUKA BANGETYTT,positif,2022-04-14,2022,apkx sangat membantu z mencari pekerjaan z sangat suka bangetytt,10,10,apkx sangat membantu z mencari pekerjaan z sangat suka bangetytt,10,10,"['apkx', 'sangat', 'membantu', 'z', 'mencari', 'pekerjaan', 'z', 'sangat', 'suka', 'bangetytt']","['apkx', 'membantu', 'z', 'mencari', 'pekerjaan', 'z', 'suka', 'bangetytt']",10,8,2,apkx bantu z cari kerja z suka bangetytt,8,8
Paling jelek jngn di donlod boros2 kuota,negatif,2022-09-04,2022,paling jelek jngn di donlod boros kuota,7,7,paling jelek jangan di download boros kuota,7,7,"['paling', 'jelek', 'jangan', 'di', 'download', 'boros', 'kuota']","['jelek', 'download', 'boros', 'kuota']",7,4,3,jelek download boros kuota,4,4
Kenapa pas feriv salah terus?,negatif,2021-02-03,2021,kenapa pas feriv salah terus,5,5,kenapa pas feriv salah terus,5,5,"['kenapa', 'pas', 'feriv', 'salah', 'terus']","['pas', 'feriv', 'salah']",5,3,2,pas feriv salah,3,3
Sangat baik untuk digunakan,positif,2021-01-25,2021,sangat baik untuk digunakan,4,4,sangat baik untuk digunakan,4,4,"['sangat', 'baik', 'untuk', 'digunakan']",[],4,1,3,,1,0
Apl bagussss..terpercaya loker.,positif,2021-12-17,2021,apl bagussss terpercaya loker,3,4,aplikasi bagussss terpercaya loker,4,4,"['aplikasi', 'bagussss', 'terpercaya', 'loker']","['aplikasi', 'bagussss', 'terpercaya', 'loker']",4,4,0,aplikasi bagussss percaya loker,4,4
Sangat luar biasa,positif,2020-03-18,2020,sangat luar biasa,3,3,sangat luar biasa,3,3,"['sangat', 'luar', 'biasa']",[],3,1,2,,1,0
Mantul terimakasih luarbiasa siplah,positif,2020-04-10,2020,mantul terimakasih luarbiasa siplah,4,4,mantap betul terima kasih luarbiasa siplah,4,6,"['mantap', 'betul', 'terima', 'kasih', 'luarbiasa', 'siplah']","['mantap', 'terima', 'kasih', 'luarbiasa', 'siplah']",6,5,1,mantap terima kasih luarbiasa sip,5,5
Cari berita lowongan kerja,positif,2022-01-24,2022,cari berita lowongan kerja,4,4,cari berita lowongan kerja,4,4,"['cari', 'berita', 'lowongan', 'kerja']","['cari', 'berita', 'lowongan', 'kerja']",4,4,0,cari berita lowong kerja,4,4
Membantu dalam mencari hubungan baru,positif,2022-01-11,2022,membantu dalam mencari hubungan baru,5,5,membantu dalam mencari hubungan baru,5,5,"['membantu', 'dalam', 'mencari', 'hubungan', 'baru']","['membantu', 'mencari', 'hubungan']",5,3,2,bantu cari hubung,3,3
Aplikasi yang bagus,positif,2021-11-15,2021,aplikasi yang bagus,3,3,aplikasi yang bagus,3,3,"['aplikasi', 'yang', 'bagus']","['aplikasi', 'bagus']",3,2,1,aplikasi bagus,2,2
Aplikasi ini tidak berguna,negatif,2022-09-27,2022,aplikasi ini tidak berguna,4,4,aplikasi ini tidak berguna,4,4,"['aplikasi', 'ini', 'tidak', 'berguna']","['aplikasi', 'tidak', 'berguna']",4,3,1,aplikasi tidak guna,3,3
Kenapa minta verifikasi terus jmbt,negatif,2024-02-05,2024,kenapa minta verifikasi terus jmbt,5,5,kenapa minta verifikasi terus jmbt,5,5,"['kenapa', 'minta', 'verifikasi', 'terus', 'jmbt']","['verifikasi', 'jmbt']",5,2,3,verifikasi jmbt,2,2
Gk jls bet mau login aja susah mesti teka teki spiral dl,negatif,2020-12-01,2020,gk jls bet mau login aja susah mesti teka teki spiral dl,12,12,tidak jls banget mau login saja susah mesti teka teki spiral dulu,12,12,"['tidak', 'jls', 'banget', 'mau', 'login', 'saja', 'susah', 'mesti', 'teka', 'teki', 'spiral', 'dulu']","['tidak', 'jls', 'banget', 'login', 'susah', 'mesti', 'teka', 'teki', 'spiral']",12,9,3,tidak jls banget login susah mesti teka teki spiral,9,9
Sangat membantu. Terima Kasih.,positif,2020-08-04,2020,sangat membantu terima kasih,4,4,sangat membantu terima kasih,4,4,"['sangat', 'membantu', 'terima', 'kasih']","['membantu', 'terima', 'kasih']",4,3,1,bantu terima kasih,3,3
Terima kasih atas aplikasi ini,positif,2020-12-30,2020,terima kasih atas aplikasi ini,5,5,terima kasih atas aplikasi ini,5,5,"['terima', 'kasih', 'atas', 'aplikasi', 'ini']","['terima', 'kasih', 'aplikasi']",5,3,2,terima kasih aplikasi,3,3
Bolehlah buat info lokernya,positif,2022-08-24,2022,bolehlah buat info lokernya,4,4,bolehlah buat informasi lokernya,4,4,"['bolehlah', 'buat', 'informasi', 'lokernya']","['informasi', 'lokernya']",4,2,2,informasi lokernya,2,2
Bagus dan Profesional,positif,2021-06-16,2021,bagus dan profesional,3,3,bagus dan profesional,3,3,"['bagus', 'dan', 'profesional']","['bagus', 'profesional']",3,2,1,bagus profesional,2,2
Terima kasih LinkedIn,positif,2024-08-19,2024,terima kasih linkedin,3,3,terima kasih linkedin,3,3,"['terima', 'kasih', 'linkedin']","['terima', 'kasih', 'linkedin']",3,3,0,terima kasih linkedin,3,3
Lumayan buat wawasan dunia tetangga,positif,2022-07-29,2022,lumayan buat wawasan dunia tetangga,5,5,lumayan buat wawasan dunia tetangga,5,5,"['lumayan', 'buat', 'wawasan', 'dunia', 'tetangga']","['lumayan', 'wawasan', 'dunia', 'tetangga']",5,4,1,lumayan wawas dunia tetangga,4,4
Baguss banget ini aplikasi,positif,2021-03-08,2021,baguss banget ini aplikasi,4,4,bagus banget ini aplikasi,4,4,"['bagus', 'banget', 'ini', 'aplikasi']","['bagus', 'banget', 'aplikasi']",4,3,1,bagus banget aplikasi,3,3
Oke banget informasinya...,positif,2021-09-19,2021,oke banget informasinya,3,3,oke banget informasinya,3,3,"['oke', 'banget', 'informasinya']","['oke', 'banget', 'informasinya']",3,3,0,oke banget informasi,3,3
Memulai dan ingin mengembangkan usaha ikan asap,positif,2023-05-24,2023,memulai dan ingin mengembangkan usaha ikan asap,7,7,memulai dan ingin mengembangkan usaha ikan as soon as possible,7,10,"['memulai', 'dan', 'ingin', 'mengembangkan', 'usaha', 'ikan', 'as', 'soon', 'as', 'possible']","['mengembangkan', 'usaha', 'ikan', 'as', 'soon', 'as', 'possible']",10,7,3,kembang usaha ikan as soon as possible,7,7
Linkedlin memang mantap........,positif,2020-09-03,2020,linkedlin memang mantap,3,3,linkedlin memang mantap,3,3,"['linkedlin', 'memang', 'mantap']","['linkedlin', 'mantap']",3,2,1,linkedlin mantap,2,2
Penting ini buat para Pekerja,positif,2022-02-23,2022,penting ini buat para pekerja,5,5,penting ini buat para yang kerja,5,6,"['penting', 'ini', 'buat', 'para', 'yang', 'kerja']",['kerja'],6,1,5,kerja,1,1
Aplikasi yg sangat berguna,positif,2022-03-30,2022,aplikasi yg sangat berguna,4,4,aplikasi yang sangat berguna,4,4,"['aplikasi', 'yang', 'sangat', 'berguna']","['aplikasi', 'berguna']",4,2,2,aplikasi guna,2,2
"Knp saya di nonaktifkan,",negatif,2020-06-21,2020,knp saya di nonaktifkan,4,4,kenapa saya di nonaktifkan,4,4,"['kenapa', 'saya', 'di', 'nonaktifkan']",['nonaktifkan'],4,1,3,nonaktif,1,1
Aplikasi yang sangat berguna,positif,2021-06-03,2021,aplikasi yang sangat berguna,4,4,aplikasi yang sangat berguna,4,4,"['aplikasi', 'yang', 'sangat', 'berguna']","['aplikasi', 'berguna']",4,2,2,aplikasi guna,2,2
Sangat bermanfaat sekali,positif,2020-05-22,2020,sangat bermanfaat sekali,3,3,sangat bermanfaat sekali,3,3,"['sangat', 'bermanfaat', 'sekali']",['bermanfaat'],3,1,2,manfaat,1,1
"Dengan mensyukuri nikmat Allah yang tidak terhitung jumlahnya kepada kita, hidup terasa lebih barakah. Tabarakallahu fikum, aamiiin ya rabb al aamiiin..",positif,2020-02-19,2020,dengan mensyukuri nikmat allah yang tidak terhitung jumlahnya kepada kita hidup terasa lebih barakah tabarakallahu fikum aamiiin ya rabb al aamiiin,21,21,dengan mensyukuri nikmat allah yang tidak terhitung jumlahnya kepada kita hidup terasa lebih barakah tabarakallahu fikum aamiiin ya rabb al aamiiin,21,21,"['dengan', 'mensyukuri', 'nikmat', 'allah', 'yang', 'tidak', 'terhitung', 'jumlahnya', 'kepada', 'kita', 'hidup', 'terasa', 'lebih', 'barakah', 'tabarakallahu', 'fikum', 'aamiiin', 'ya', 'rabb', 'al', 'aamiiin']","['mensyukuri', 'nikmat', 'allah', 'tidak', 'terhitung', 'hidup', 'barakah', 'tabarakallahu', 'fikum', 'aamiiin', 'ya', 'rabb', 'al', 'aamiiin']",21,14,7,syukur nikmat allah tidak hitung hidup bara tabarakallahu fikum aamiiin ya rabb al aamiiin,14,14
Bagaimana cara membatalkan langganan,negatif,2024-03-18,2024,bagaimana cara membatalkan langganan,4,4,bagaimana cara membatalkan langganan,4,4,"['bagaimana', 'cara', 'membatalkan', 'langganan']","['membatalkan', 'langganan']",4,2,2,batal langgan,2,2
Mau coba aplikasi ini beri bintang 5 dulu,positif,2020-07-11,2020,mau coba aplikasi ini beri bintang dulu,8,7,mau coba aplikasi ini beri bintang dahulu,7,7,"['mau', 'coba', 'aplikasi', 'ini', 'beri', 'bintang', 'dahulu']","['coba', 'aplikasi', 'bintang']",7,3,4,coba aplikasi bintang,3,3
Thank u LinkedIn sudah banyak membantu saya semoga segera saya bisa mendapatkan impian saya..,positif,2020-09-28,2020,thank u linkedin sudah banyak membantu saya semoga segera saya bisa mendapatkan impian saya,14,14,terima kasih untuk linkedin sudah banyak membantu saya semoga segera saya bisa mendapatkan impian saya,14,15,"['terima', 'kasih', 'untuk', 'linkedin', 'sudah', 'banyak', 'membantu', 'saya', 'semoga', 'segera', 'saya', 'bisa', 'mendapatkan', 'impian', 'saya']","['terima', 'kasih', 'linkedin', 'membantu', 'semoga', 'impian']",15,6,9,terima kasih linkedin bantu moga impi,6,6
"Mantap.,..,sangat membantu",positif,2020-11-12,2020,mantap sangat membantu,2,3,mantap sangat membantu,3,3,"['mantap', 'sangat', 'membantu']","['mantap', 'membantu']",3,2,1,mantap bantu,2,2
Aplikasi yang bagus,positif,2022-03-20,2022,aplikasi yang bagus,3,3,aplikasi yang bagus,3,3,"['aplikasi', 'yang', 'bagus']","['aplikasi', 'bagus']",3,2,1,aplikasi bagus,2,2
Aplikasi yang sangat membantu👍👍👍👍👍👍,positif,2021-10-14,2021,aplikasi yang sangat membantu,4,4,aplikasi yang sangat membantu,4,4,"['aplikasi', 'yang', 'sangat', 'membantu']","['aplikasi', 'membantu']",4,2,2,aplikasi bantu,2,2
banyak info job,positif,2020-05-11,2020,banyak info job,3,3,banyak informasi kerja,3,3,"['banyak', 'informasi', 'kerja']","['informasi', 'kerja']",3,2,1,informasi kerja,2,2
Untuk mencari wawasan,positif,2021-11-18,2021,untuk mencari wawasan,3,3,untuk mencari wawasan,3,3,"['untuk', 'mencari', 'wawasan']","['mencari', 'wawasan']",3,2,1,cari wawas,2,2
"Semoga bisa membantu sy utk mencari pekerjaan, Mitra bisnis dll",positif,2020-05-10,2020,semoga bisa membantu sy utk mencari pekerjaan mitra bisnis dll,10,10,semoga bisa membantu saya untuk mencari pekerjaan mitra bisnis dan lain lain,10,12,"['semoga', 'bisa', 'membantu', 'saya', 'untuk', 'mencari', 'pekerjaan', 'mitra', 'bisnis', 'dan', 'lain', 'lain']","['semoga', 'membantu', 'mencari', 'pekerjaan', 'mitra', 'bisnis']",12,6,6,moga bantu cari kerja mitra bisnis,6,6
Saya suka dengan cara aplikasi ini,positif,2020-09-02,2020,saya suka dengan cara aplikasi ini,6,6,saya suka dengan cara aplikasi ini,6,6,"['saya', 'suka', 'dengan', 'cara', 'aplikasi', 'ini']","['suka', 'aplikasi']",6,2,4,suka aplikasi,2,2
Ini aplikasi yang keren,positif,2021-04-09,2021,ini aplikasi yang keren,4,4,ini aplikasi yang keren,4,4,"['ini', 'aplikasi', 'yang', 'keren']","['aplikasi', 'keren']",4,2,2,aplikasi keren,2,2
"TOLONG!!!! KETIKA SAYA LOGIN,TULISANNYA ""AKUN ANDA NONAKTIF"" TRUS AKUN SAYA DI TULISAN TELAH DIPAKAI ORANG LAIN KANNN???!!! GIMANNAAAA SAYA TAKUT AKUN SAYA DIPAKAI ORANG TAK BERTANGGUNG JAWAB",negatif,2021-08-20,2021,tolong ketika saya login tulisannya akun anda nonaktif trus akun saya di tulisan telah dipakai orang lain kannn gimannaaaa saya takut akun saya dipakai orang tak bertanggung jawab,27,28,tolong ketika saya login tulisannya akun anda nonaktif terus akun saya di tulisan telah dipakai orang lain kannn gimannaaaa saya takut akun saya dipakai orang tidak bertanggung jawab,28,28,"['tolong', 'ketika', 'saya', 'login', 'tulisannya', 'akun', 'anda', 'nonaktif', 'terus', 'akun', 'saya', 'di', 'tulisan', 'telah', 'dipakai', 'orang', 'lain', 'kannn', 'gimannaaaa', 'saya', 'takut', 'akun', 'saya', 'dipakai', 'orang', 'tidak', 'bertanggung', 'jawab']","['tolong', 'login', 'tulisannya', 'akun', 'nonaktif', 'akun', 'tulisan', 'dipakai', 'orang', 'kannn', 'gimannaaaa', 'takut', 'akun', 'dipakai', 'orang', 'tidak', 'bertanggung']",28,17,11,tolong login tulis akun nonaktif akun tulis pakai orang kannn gimannaaaa takut akun pakai orang tidak tanggung,17,17
Linkedln sngt bagus,positif,2020-10-27,2020,linkedln sngt bagus,3,3,linkedln sangat bagus,3,3,"['linkedln', 'sangat', 'bagus']","['linkedln', 'bagus']",3,2,1,linkedln bagus,2,2
bagus sangat membatu,positif,2020-02-02,2020,bagus sangat membatu,3,3,bagus sangat membantu,3,3,"['bagus', 'sangat', 'membantu']","['bagus', 'membantu']",3,2,1,bagus bantu,2,2
bisa dapet kerja. mantap,positif,2020-08-01,2020,bisa dapet kerja mantap,4,4,bisa dapat kerja mantap,4,4,"['bisa', 'dapat', 'kerja', 'mantap']","['kerja', 'mantap']",4,2,2,kerja mantap,2,2
Suka sama aplikasinya,positif,2020-07-16,2020,suka sama aplikasinya,3,3,suka sama aplikasi nya,3,4,"['suka', 'sama', 'aplikasi', 'nya']","['suka', 'aplikasi', 'nya']",4,3,1,suka aplikasi nya,3,3
Verifikasi tidak jelas,negatif,2023-05-15,2023,verifikasi tidak jelas,3,3,verifikasi tidak jelas,3,3,"['verifikasi', 'tidak', 'jelas']","['verifikasi', 'tidak']",3,2,1,verifikasi tidak,2,2
Bagus...lanjutkan terus,negatif,2024-02-08,2024,bagus lanjutkan terus,2,3,bagus lanjutkan terus,3,3,"['bagus', 'lanjutkan', 'terus']","['bagus', 'lanjutkan']",3,2,1,bagus lanjut,2,2
Tambah Sukses selalu,positif,2024-04-10,2024,tambah sukses selalu,3,3,tambah sukses selalu,3,3,"['tambah', 'sukses', 'selalu']",['sukses'],3,1,2,sukses,1,1
Sangat baik dan membantu.,positif,2021-12-12,2021,sangat baik dan membantu,4,4,sangat baik dan membantu,4,4,"['sangat', 'baik', 'dan', 'membantu']",['membantu'],4,1,3,bantu,1,1
Lama kali upgrade nya,negatif,2021-10-29,2021,lama kali upgrade nya,4,4,lama kali upgrade nya,4,4,"['lama', 'kali', 'upgrade', 'nya']","['kali', 'upgrade', 'nya']",4,3,1,kali upgrade nya,3,3
App Jobseeker terbaik,positif,2021-06-30,2021,app jobseeker terbaik,3,3,aplikasi jobseeker terbaik,3,3,"['aplikasi', 'jobseeker', 'terbaik']","['aplikasi', 'jobseeker', 'terbaik']",3,3,0,aplikasi jobseeker baik,3,3
Gak bisa pilh daerah,negatif,2023-01-20,2023,gak bisa pilh daerah,4,4,tidak bisa pilh daerah,4,4,"['tidak', 'bisa', 'pilh', 'daerah']","['tidak', 'pilh', 'daerah']",4,3,1,tidak pilh daerah,3,3
akun saya di bajak mohon bantun nya untuk saya makasih,negatif,2021-05-07,2021,akun saya di bajak mohon bantun nya untuk saya makasih,10,10,akun saya di bajak mohon bantun nya untuk saya terima kasih,10,11,"['akun', 'saya', 'di', 'bajak', 'mohon', 'bantun', 'nya', 'untuk', 'saya', 'terima', 'kasih']","['akun', 'bajak', 'mohon', 'bantun', 'nya', 'terima', 'kasih']",11,7,4,akun bajak mohon bantun nya terima kasih,7,7
Bagus sekali,positif,2024-03-26,2024,bagus sekali,2,2,bagus sekali,2,2,"['bagus', 'sekali']",['bagus'],2,1,1,bagus,1,1
kebanyakan verivikasi akun gajelas,negatif,2023-08-12,2023,kebanyakan verivikasi akun gajelas,4,4,kebanyakan verivikasi akun tidak jelas,4,5,"['kebanyakan', 'verivikasi', 'akun', 'tidak', 'jelas']","['kebanyakan', 'verivikasi', 'akun', 'tidak']",5,4,1,banyak verivikasi akun tidak,4,4
Dahsyatnya bagus sekali,positif,2021-12-10,2021,dahsyatnya bagus sekali,3,3,dahsyatnya bagus sekali,3,3,"['dahsyatnya', 'bagus', 'sekali']","['dahsyatnya', 'bagus']",3,2,1,dahsyat bagus,2,2
Nambah Ribet gak kaya dulu. Buat akun aja ribet,negatif,2022-02-22,2022,nambah ribet gak kaya dulu buat akun aja ribet,9,9,nambah rumit tidak kayak dahulu buat akun saja rumit,9,9,"['nambah', 'rumit', 'tidak', 'kayak', 'dahulu', 'buat', 'akun', 'saja', 'rumit']","['nambah', 'rumit', 'tidak', 'kayak', 'akun', 'rumit']",9,6,3,nambah rumit tidak kayak akun rumit,6,6
Semoga bisa dapat perkejaan dari sini,positif,2020-05-11,2020,semoga bisa dapat perkejaan dari sini,6,6,semoga bisa dapat perkejaan dari sini,6,6,"['semoga', 'bisa', 'dapat', 'perkejaan', 'dari', 'sini']","['semoga', 'perkejaan']",6,2,4,moga perkejaan,2,2
Kode captcha nya bikin ribet,negatif,2023-08-24,2023,kode captcha nya bikin ribet,5,5,kode captcha nya bikin rumit,5,5,"['kode', 'captcha', 'nya', 'bikin', 'rumit']","['kode', 'captcha', 'nya', 'bikin', 'rumit']",5,5,0,kode captcha nya bikin rumit,5,5
"Masa login"" terus",negatif,2023-08-01,2023,masa login terus,3,3,masa login terus,3,3,"['masa', 'login', 'terus']",['login'],3,1,2,login,1,1
Tingkatkan linkedin,positif,2022-05-13,2022,tingkatkan linkedin,2,2,tingkatkan linkedin,2,2,"['tingkatkan', 'linkedin']","['tingkatkan', 'linkedin']",2,2,0,tingkat linkedin,2,2
Aplikasi yg sangat berguna,positif,2023-09-03,2023,aplikasi yg sangat berguna,4,4,aplikasi yang sangat berguna,4,4,"['aplikasi', 'yang', 'sangat', 'berguna']","['aplikasi', 'berguna']",4,2,2,aplikasi guna,2,2
"Akun saya hilang, bagaimana cara mengembalikannya....????",negatif,2020-02-25,2020,akun saya hilang bagaimana cara mengembalikannya,6,6,akun saya hilang bagaimana cara mengembalikannya,6,6,"['akun', 'saya', 'hilang', 'bagaimana', 'cara', 'mengembalikannya']","['akun', 'hilang', 'mengembalikannya']",6,3,3,akun hilang kembali,3,3
Sangat cocok untuk Anda,positif,2022-04-24,2022,sangat cocok untuk anda,4,4,sangat cocok untuk anda,4,4,"['sangat', 'cocok', 'untuk', 'anda']",['cocok'],4,1,3,cocok,1,1
"Terimakasih, Banyak membatu orang banyak",positif,2021-10-10,2021,terimakasih banyak membatu orang banyak,5,5,terima kasih banyak membantu orang banyak,5,6,"['terima', 'kasih', 'banyak', 'membantu', 'orang', 'banyak']","['terima', 'kasih', 'membantu', 'orang']",6,4,2,terima kasih bantu orang,4,4
Aplikasi in bagus tapi,positif,2021-03-09,2021,aplikasi in bagus tapi,4,4,aplikasi in bagus tapi,4,4,"['aplikasi', 'in', 'bagus', 'tapi']","['aplikasi', 'in', 'bagus']",4,3,1,aplikasi in bagus,3,3
Saya ingin cari kerja sampingan,positif,2022-02-18,2022,saya ingin cari kerja sampingan,5,5,saya ingin cari kerja sampingan,5,5,"['saya', 'ingin', 'cari', 'kerja', 'sampingan']","['cari', 'kerja', 'sampingan']",5,3,2,cari kerja samping,3,3
Bisa membuat Happy,positif,2020-09-15,2020,bisa membuat happy,3,3,bisa membuat senang,3,3,"['bisa', 'membuat', 'senang']",['senang'],3,1,2,senang,1,1
bagus appsnya,positif,2021-03-23,2021,bagus appsnya,2,2,bagus aplikasinya,2,2,"['bagus', 'aplikasinya']","['bagus', 'aplikasinya']",2,2,0,bagus aplikasi,2,2
"Jelek, verifikasinya aneh",negatif,2023-06-13,2023,jelek verifikasinya aneh,3,3,jelek verifikasinya aneh,3,3,"['jelek', 'verifikasinya', 'aneh']","['jelek', 'verifikasinya', 'aneh']",3,3,0,jelek verifikasi aneh,3,3
Jaringan internet lancar,positif,2021-07-22,2021,jaringan internet lancar,3,3,jaringan internet lancar,3,3,"['jaringan', 'internet', 'lancar']","['jaringan', 'internet', 'lancar']",3,3,0,jaring internet lancar,3,3
Aplikasi yang bermanfaat 👍🏻👍🏻👍🏻,positif,2023-07-24,2023,aplikasi yang bermanfaat,4,3,aplikasi yang bermanfaat,3,3,"['aplikasi', 'yang', 'bermanfaat']","['aplikasi', 'bermanfaat']",3,2,1,aplikasi manfaat,2,2
Sangat suka sekali,positif,2020-08-28,2020,sangat suka sekali,3,3,sangat suka sekali,3,3,"['sangat', 'suka', 'sekali']",['suka'],3,1,2,suka,1,1
"GA JELAS... BUKA LOWONGAN, LAMAR TAPI GA JELAS CARANYA",negatif,2020-11-04,2020,ga jelas buka lowongan lamar tapi ga jelas caranya,9,9,tidak jelas buka lowongan lamar tapi tidak jelas caranya,9,9,"['tidak', 'jelas', 'buka', 'lowongan', 'lamar', 'tapi', 'tidak', 'jelas', 'caranya']","['tidak', 'buka', 'lowongan', 'lamar', 'tidak']",9,5,4,tidak buka lowong lamar tidak,5,5
"Baik,dan membantu",positif,2022-05-27,2022,baik dan membantu,2,3,baik dan membantu,3,3,"['baik', 'dan', 'membantu']",['membantu'],3,1,2,bantu,1,1
"Kode verifikasinya ribet, rancu",negatif,2022-06-18,2022,kode verifikasinya ribet rancu,4,4,kode verifikasinya rumit rancu,4,4,"['kode', 'verifikasinya', 'rumit', 'rancu']","['kode', 'verifikasinya', 'rumit', 'rancu']",4,4,0,kode verifikasi rumit rancu,4,4
Mencoba mengunakan aplikasi Linkdln,positif,2020-10-02,2020,mencoba mengunakan aplikasi linkdln,4,4,mencoba mengunakan aplikasi linkdln,4,4,"['mencoba', 'mengunakan', 'aplikasi', 'linkdln']","['mencoba', 'mengunakan', 'aplikasi', 'linkdln']",4,4,0,coba mengunakan aplikasi linkdln,4,4
Membangun relasi dengan asyik,positif,2022-04-04,2022,membangun relasi dengan asyik,4,4,membangun relasi dengan asyik,4,4,"['membangun', 'relasi', 'dengan', 'asyik']","['membangun', 'relasi', 'asyik']",4,3,1,bangun relasi asyik,3,3
Susah login ampun dahhhh *1,negatif,2023-09-21,2023,susah login ampun dahhhh,5,4,susah login ampun dahhhh,4,4,"['susah', 'login', 'ampun', 'dahhhh']","['susah', 'login', 'ampun', 'dahhhh']",4,4,0,susah login ampun dahhhh,4,4
Susah untuk login,negatif,2024-01-17,2024,susah untuk login,3,3,susah untuk login,3,3,"['susah', 'untuk', 'login']","['susah', 'login']",3,2,1,susah login,2,2
Apa lh update ini malah nyusahin,negatif,2023-12-18,2023,apa lh update ini malah nyusahin,6,6,apa lh diperbarui ini bahkan nyusahin,6,6,"['apa', 'lh', 'diperbarui', 'ini', 'bahkan', 'nyusahin']","['lh', 'diperbarui', 'nyusahin']",6,3,3,lh baru nyusahin,3,3
Sangat membantu,positif,2024-08-23,2024,sangat membantu,2,2,sangat membantu,2,2,"['sangat', 'membantu']",['membantu'],2,1,1,bantu,1,1
Bagus sekali,positif,2024-03-22,2024,bagus sekali,2,2,bagus sekali,2,2,"['bagus', 'sekali']",['bagus'],2,1,1,bagus,1,1
Semoga bisa bermanfaat bukan hanya janji manis doang.,positif,2022-01-19,2022,semoga bisa bermanfaat bukan hanya janji manis doang,8,8,semoga bisa bermanfaat bukan hanya janji manis saja,8,8,"['semoga', 'bisa', 'bermanfaat', 'bukan', 'hanya', 'janji', 'manis', 'saja']","['semoga', 'bermanfaat', 'janji', 'manis']",8,4,4,moga manfaat janji manis,4,4
Bagus bermanfaat sekali,positif,2023-12-19,2023,bagus bermanfaat sekali,3,3,bagus bermanfaat sekali,3,3,"['bagus', 'bermanfaat', 'sekali']","['bagus', 'bermanfaat']",3,2,1,bagus manfaat,2,2
Bagus juga aplikasi ini,positif,2022-09-27,2022,bagus juga aplikasi ini,4,4,bagus juga aplikasi ini,4,4,"['bagus', 'juga', 'aplikasi', 'ini']","['bagus', 'aplikasi']",4,2,2,bagus aplikasi,2,2
Mga aplikasi nie bs membantu,positif,2020-06-11,2020,mga aplikasi nie bs membantu,5,5,mga aplikasi nie bisa membantu,5,5,"['mga', 'aplikasi', 'nie', 'bisa', 'membantu']","['mga', 'aplikasi', 'nie', 'membantu']",5,4,1,mga aplikasi nie bantu,4,4
Aplikasinya bagus,positif,2020-11-30,2020,aplikasinya bagus,2,2,aplikasi nya bagus,2,3,"['aplikasi', 'nya', 'bagus']","['aplikasi', 'nya', 'bagus']",3,3,0,aplikasi nya bagus,3,3
Banyak info lokernya,positif,2020-07-01,2020,banyak info lokernya,3,3,banyak informasi lokernya,3,3,"['banyak', 'informasi', 'lokernya']","['informasi', 'lokernya']",3,2,1,informasi lokernya,2,2
APLIKASI BANYAK IKLAN NYA GUA MALAS DOWNLOAD,negatif,2022-09-14,2022,aplikasi banyak iklan nya gua malas download,7,7,aplikasi banyak iklan nya saya malas unduh,7,7,"['aplikasi', 'banyak', 'iklan', 'nya', 'saya', 'malas', 'unduh']","['aplikasi', 'iklan', 'nya', 'malas', 'unduh']",7,5,2,aplikasi iklan nya malas unduh,5,5
Aplikasinya bagus,positif,2022-03-12,2022,aplikasinya bagus,2,2,aplikasi nya bagus,2,3,"['aplikasi', 'nya', 'bagus']","['aplikasi', 'nya', 'bagus']",3,3,0,aplikasi nya bagus,3,3
Ga jelas teka2 tekinya..uninstal ajalah,negatif,2022-05-31,2022,ga jelas teka tekinya uninstal ajalah,5,6,tidak jelas teka tekinya hapus instalan ajalah,6,7,"['tidak', 'jelas', 'teka', 'tekinya', 'hapus', 'instalan', 'ajalah']","['tidak', 'teka', 'tekinya', 'hapus', 'instalan', 'ajalah']",7,6,1,tidak teka teki hapus instalan aja,6,6
Semoga ini bermanfaat bagi kita semua,positif,2020-09-30,2020,semoga ini bermanfaat bagi kita semua,6,6,semoga ini bermanfaat bagi kita semua,6,6,"['semoga', 'ini', 'bermanfaat', 'bagi', 'kita', 'semua']","['semoga', 'bermanfaat']",6,2,4,moga manfaat,2,2
Bagus bisa membantu.,positif,2020-06-15,2020,bagus bisa membantu,3,3,bagus bisa membantu,3,3,"['bagus', 'bisa', 'membantu']","['bagus', 'membantu']",3,2,1,bagus bantu,2,2
Sesuai kebutuhan..,positif,2020-08-22,2020,sesuai kebutuhan,2,2,sesuai kebutuhan,2,2,"['sesuai', 'kebutuhan']","['sesuai', 'kebutuhan']",2,2,0,sesuai butuh,2,2
Aplikasi yang bagus,positif,2021-07-08,2021,aplikasi yang bagus,3,3,aplikasi yang bagus,3,3,"['aplikasi', 'yang', 'bagus']","['aplikasi', 'bagus']",3,2,1,aplikasi bagus,2,2
Kasih 4 dulu kalau bagus full bintang,positif,2020-01-23,2020,kasih dulu kalau bagus full bintang,7,6,kasih dahulu kalau bagus full bintang,6,6,"['kasih', 'dahulu', 'kalau', 'bagus', 'full', 'bintang']","['kasih', 'bagus', 'full', 'bintang']",6,4,2,kasih bagus full bintang,4,4
Sejauh ini bagus gan,positif,2021-11-10,2021,sejauh ini bagus gan,4,4,sejauh ini bagus juragan,4,4,"['sejauh', 'ini', 'bagus', 'juragan']","['bagus', 'juragan']",4,2,2,bagus juragan,2,2
Aplikasi ini tidak sesuai,negatif,2023-10-31,2023,aplikasi ini tidak sesuai,4,4,aplikasi ini tidak sesuai,4,4,"['aplikasi', 'ini', 'tidak', 'sesuai']","['aplikasi', 'tidak', 'sesuai']",4,3,1,aplikasi tidak sesuai,3,3
Mantap apk nya,positif,2023-03-22,2023,mantap apk nya,3,3,mantap aplikasi nya,3,3,"['mantap', 'aplikasi', 'nya']","['mantap', 'aplikasi', 'nya']",3,3,0,mantap aplikasi nya,3,3
SALDO DANA SAYA TERPOTONG DAN SAYA TIDAK MERASA BERLANGGANAN.MOHON UNTUK REFUND KE AKUN DANA SAYA.,negatif,2023-02-02,2023,saldo dana saya terpotong dan saya tidak merasa berlangganan mohon untuk refund ke akun dana saya,15,16,saldo dana saya terpotong dan saya tidak merasa berlangganan mohon untuk refund ke akun dana saya,16,16,"['saldo', 'dana', 'saya', 'terpotong', 'dan', 'saya', 'tidak', 'merasa', 'berlangganan', 'mohon', 'untuk', 'refund', 'ke', 'akun', 'dana', 'saya']","['saldo', 'dana', 'terpotong', 'tidak', 'berlangganan', 'mohon', 'refund', 'akun', 'dana']",16,9,7,saldo dana potong tidak langgan mohon refund akun dana,9,9
Banyak koneksi profesional di sini,positif,2020-06-19,2020,banyak koneksi profesional di sini,5,5,banyak koneksi profesional di sini,5,5,"['banyak', 'koneksi', 'profesional', 'di', 'sini']","['koneksi', 'profesional']",5,2,3,koneksi profesional,2,2
Bagus aja lah .. hasil nya nanti ..,positif,2020-05-08,2020,bagus aja lah hasil nya nanti,8,6,bagus saja lah hasil nya nanti,6,6,"['bagus', 'saja', 'lah', 'hasil', 'nya', 'nanti']","['bagus', 'hasil', 'nya']",6,3,3,bagus hasil nya,3,3
APLIKASI TOLOL BARU LOGIN AJA SURUH NEBAK KODOK BEGO,negatif,2022-06-02,2022,aplikasi tolol baru login aja suruh nebak kodok bego,9,9,aplikasi tolol baru login saja suruh nebak kodok bodoh,9,9,"['aplikasi', 'tolol', 'baru', 'login', 'saja', 'suruh', 'nebak', 'kodok', 'bodoh']","['aplikasi', 'tolol', 'login', 'suruh', 'nebak', 'kodok', 'bodoh']",9,7,2,aplikasi tolol login suruh nebak kodok bodoh,7,7
Sulit mencari lowongan kerja mencari usia 49 Tahun,negatif,2022-07-29,2022,sulit mencari lowongan kerja mencari usia tahun,8,7,sulit mencari lowongan kerja mencari usia tahun,7,7,"['sulit', 'mencari', 'lowongan', 'kerja', 'mencari', 'usia', 'tahun']","['sulit', 'mencari', 'lowongan', 'kerja', 'mencari', 'usia']",7,6,1,sulit cari lowong kerja cari usia,6,6
Aplikasi yang bagus,positif,2021-04-23,2021,aplikasi yang bagus,3,3,aplikasi yang bagus,3,3,"['aplikasi', 'yang', 'bagus']","['aplikasi', 'bagus']",3,2,1,aplikasi bagus,2,2
Banyak syrat nya susah,negatif,2021-09-20,2021,banyak syrat nya susah,4,4,banyak syrat nya susah,4,4,"['banyak', 'syrat', 'nya', 'susah']","['syrat', 'nya', 'susah']",4,3,1,syrat nya susah,3,3
Bagus Dan Sangat Membantu,positif,2022-01-30,2022,bagus dan sangat membantu,4,4,bagus dan sangat membantu,4,4,"['bagus', 'dan', 'sangat', 'membantu']","['bagus', 'membantu']",4,2,2,bagus bantu,2,2
Aplikasi yang bermanfaat,positif,2024-01-10,2024,aplikasi yang bermanfaat,3,3,aplikasi yang bermanfaat,3,3,"['aplikasi', 'yang', 'bermanfaat']","['aplikasi', 'bermanfaat']",3,2,1,aplikasi manfaat,2,2
Vervikasinya tolong di benarkan mana yang salah dari saya,negatif,2022-10-18,2022,vervikasinya tolong di benarkan mana yang salah dari saya,9,9,vervikasinya tolong di benarkan mana yang salah dari saya,9,9,"['vervikasinya', 'tolong', 'di', 'benarkan', 'mana', 'yang', 'salah', 'dari', 'saya']","['vervikasinya', 'tolong', 'benarkan', 'salah']",9,4,5,vervikasinya tolong benar salah,4,4
"Semoga kedepannya lebih membangun,nusa bangsa,dan agama",positif,2021-01-29,2021,semoga kedepannya lebih membangun nusa bangsa dan agama,6,8,semoga kedepannya lebih membangun nusa bangsa dan agama,8,8,"['semoga', 'kedepannya', 'lebih', 'membangun', 'nusa', 'bangsa', 'dan', 'agama']","['semoga', 'kedepannya', 'membangun', 'nusa', 'bangsa', 'agama']",8,6,2,moga depan bangun nusa bangsa agama,6,6
Aplikasi sangat membantu,positif,2022-09-02,2022,aplikasi sangat membantu,3,3,aplikasi sangat membantu,3,3,"['aplikasi', 'sangat', 'membantu']","['aplikasi', 'membantu']",3,2,1,aplikasi bantu,2,2
aplikasi menyulitkan,negatif,2021-05-20,2021,aplikasi menyulitkan,2,2,aplikasi menyulitkan,2,2,"['aplikasi', 'menyulitkan']","['aplikasi', 'menyulitkan']",2,2,0,aplikasi sulit,2,2
Keren aplikasi nya,positif,2021-09-09,2021,keren aplikasi nya,3,3,keren aplikasi nya,3,3,"['keren', 'aplikasi', 'nya']","['keren', 'aplikasi', 'nya']",3,3,0,keren aplikasi nya,3,3
"Mantab, bagus sekali",negatif,2022-01-13,2022,mantab bagus sekali,3,3,mantap bagus sekali,3,3,"['mantap', 'bagus', 'sekali']","['mantap', 'bagus']",3,2,1,mantap bagus,2,2
Semoga dpt membantu saya mencari pekerjaan sebagai Driver,positif,2021-08-03,2021,semoga dpt membantu saya mencari pekerjaan sebagai driver,8,8,semoga dapat membantu saya mencari pekerjaan sebagai pengemudi,8,8,"['semoga', 'dapat', 'membantu', 'saya', 'mencari', 'pekerjaan', 'sebagai', 'pengemudi']","['semoga', 'membantu', 'mencari', 'pekerjaan', 'pengemudi']",8,5,3,moga bantu cari kerja kemudi,5,5
"Semoga makin sukses dalam pekerjaanku,amin ya Allah 🙏",positif,2020-07-22,2020,semoga makin sukses dalam pekerjaanku amin ya allah,8,8,semoga makin sukses dalam pekerjaanku aamiin ya allah,8,8,"['semoga', 'makin', 'sukses', 'dalam', 'pekerjaanku', 'aamiin', 'ya', 'allah']","['semoga', 'sukses', 'pekerjaanku', 'aamiin', 'ya', 'allah']",8,6,2,moga sukses kerja aamiin ya allah,6,6
Bagus bisa membantu,positif,2022-06-11,2022,bagus bisa membantu,3,3,bagus bisa membantu,3,3,"['bagus', 'bisa', 'membantu']","['bagus', 'membantu']",3,2,1,bagus bantu,2,2
Aplikasi yang inovatif,positif,2022-04-28,2022,aplikasi yang inovatif,3,3,aplikasi yang inovatif,3,3,"['aplikasi', 'yang', 'inovatif']","['aplikasi', 'inovatif']",3,2,1,aplikasi inovatif,2,2
ga jelas verifikasi,negatif,2023-03-09,2023,ga jelas verifikasi,3,3,tidak jelas verifikasi,3,3,"['tidak', 'jelas', 'verifikasi']","['tidak', 'verifikasi']",3,2,1,tidak verifikasi,2,2
Sangat membantu.bagi kami,positif,2021-09-26,2021,sangat membantu bagi kami,3,4,sangat membantu bagi kami,4,4,"['sangat', 'membantu', 'bagi', 'kami']",['membantu'],4,1,3,bantu,1,1
Verifikasi bikin ribet,negatif,2023-05-23,2023,verifikasi bikin ribet,3,3,verifikasi bikin rumit,3,3,"['verifikasi', 'bikin', 'rumit']","['verifikasi', 'bikin', 'rumit']",3,3,0,verifikasi bikin rumit,3,3
APASIII MUNCUL GAJELASS IKLAN MULUUU$@##!#!$+=!,negatif,2024-06-15,2024,apasiii muncul gajelass iklan muluuu,5,5,apasiii muncul gajelass iklan muluuu,5,5,"['apasiii', 'muncul', 'gajelass', 'iklan', 'muluuu']","['apasiii', 'muncul', 'gajelass', 'iklan', 'muluuu']",5,5,0,apasiii muncul gajelass iklan muluuu,5,5
Login aja ribet banget,negatif,2022-08-30,2022,login aja ribet banget,4,4,login saja rumit banget,4,4,"['login', 'saja', 'rumit', 'banget']","['login', 'rumit', 'banget']",4,3,1,login rumit banget,3,3
Aplikasi sangat baik,positif,2021-09-01,2021,aplikasi sangat baik,3,3,aplikasi sangat baik,3,3,"['aplikasi', 'sangat', 'baik']",['aplikasi'],3,1,2,aplikasi,1,1
Aplikasi jejaring terbaik,positif,2020-08-24,2020,aplikasi jejaring terbaik,3,3,aplikasi jejaring terbaik,3,3,"['aplikasi', 'jejaring', 'terbaik']","['aplikasi', 'jejaring', 'terbaik']",3,3,0,aplikasi jejaring baik,3,3
Linkedln semakin didepan,positif,2021-06-12,2021,linkedln semakin didepan,3,3,linkedln semakin didepan,3,3,"['linkedln', 'semakin', 'didepan']","['linkedln', 'didepan']",3,2,1,linkedln depan,2,2
Sangat membantu sekali,positif,2020-10-31,2020,sangat membantu sekali,3,3,sangat membantu sekali,3,3,"['sangat', 'membantu', 'sekali']",['membantu'],3,1,2,bantu,1,1
Saya suka sekali dengan aplikasi ini,positif,2021-02-08,2021,saya suka sekali dengan aplikasi ini,6,6,saya suka sekali dengan aplikasi ini,6,6,"['saya', 'suka', 'sekali', 'dengan', 'aplikasi', 'ini']","['suka', 'aplikasi']",6,2,4,suka aplikasi,2,2
Semoga bermanfaat dan sukses,positif,2022-03-16,2022,semoga bermanfaat dan sukses,4,4,semoga bermanfaat dan sukses,4,4,"['semoga', 'bermanfaat', 'dan', 'sukses']","['semoga', 'bermanfaat', 'sukses']",4,3,1,moga manfaat sukses,3,3
Semoga dapat pekerjaan di Linkedln,positif,2020-11-28,2020,semoga dapat pekerjaan di linkedln,5,5,semoga dapat pekerjaan di linkedln,5,5,"['semoga', 'dapat', 'pekerjaan', 'di', 'linkedln']","['semoga', 'pekerjaan', 'linkedln']",5,3,2,moga kerja linkedln,3,3
Verifikasi aje ribet amat,negatif,2021-06-22,2021,verifikasi aje ribet amat,4,4,verifikasi aje rumit amat,4,4,"['verifikasi', 'aje', 'rumit', 'amat']","['verifikasi', 'aje', 'rumit']",4,3,1,verifikasi aje rumit,3,3
Good..respon cepat,positif,2020-10-03,2020,good respon cepat,2,3,bagus respons cepat,3,3,"['bagus', 'respons', 'cepat']","['bagus', 'respons', 'cepat']",3,3,0,bagus respons cepat,3,3
Sangat membantu sekali,positif,2022-09-19,2022,sangat membantu sekali,3,3,sangat membantu sekali,3,3,"['sangat', 'membantu', 'sekali']",['membantu'],3,1,2,bantu,1,1
Nyaman dipakainya,positif,2021-11-03,2021,nyaman dipakainya,2,2,nyaman dipakainya,2,2,"['nyaman', 'dipakainya']","['nyaman', 'dipakainya']",2,2,0,nyaman pakai,2,2
Jgn di donlot verifikasi nya gila,negatif,2022-06-24,2022,jgn di donlot verifikasi nya gila,6,6,jangan di download verifikasi nya gila,6,6,"['jangan', 'di', 'download', 'verifikasi', 'nya', 'gila']","['download', 'verifikasi', 'nya', 'gila']",6,4,2,download verifikasi nya gila,4,4
Sangat bermanfaat,positif,2020-06-11,2020,sangat bermanfaat,2,2,sangat bermanfaat,2,2,"['sangat', 'bermanfaat']",['bermanfaat'],2,1,1,manfaat,1,1
Bagus dan bermanfaat lhoh,positif,2020-11-10,2020,bagus dan bermanfaat lhoh,4,4,bagus dan bermanfaat loh,4,4,"['bagus', 'dan', 'bermanfaat', 'loh']","['bagus', 'bermanfaat', 'loh']",4,3,1,bagus manfaat loh,3,3
Sangat membantu sekali,positif,2022-08-07,2022,sangat membantu sekali,3,3,sangat membantu sekali,3,3,"['sangat', 'membantu', 'sekali']",['membantu'],3,1,2,bantu,1,1
Link yang bagus 👍👍👍,positif,2020-07-09,2020,link yang bagus,4,3,link yang bagus,3,3,"['link', 'yang', 'bagus']","['link', 'bagus']",3,2,1,link bagus,2,2
Bagus dan berkesan,positif,2020-07-15,2020,bagus dan berkesan,3,3,bagus dan berkesan,3,3,"['bagus', 'dan', 'berkesan']","['bagus', 'berkesan']",3,2,1,bagus kesan,2,2
Aplikasi nya kurang jelas,negatif,2020-08-06,2020,aplikasi nya kurang jelas,4,4,aplikasi nya kurang jelas,4,4,"['aplikasi', 'nya', 'kurang', 'jelas']","['aplikasi', 'nya']",4,2,2,aplikasi nya,2,2
Saya ingin coba dan belajar,positif,2020-07-10,2020,saya ingin coba dan belajar,5,5,saya ingin coba dan belajar,5,5,"['saya', 'ingin', 'coba', 'dan', 'belajar']","['coba', 'belajar']",5,2,3,coba ajar,2,2
optimal,positif,2020-09-01,2020,optimal,1,1,optimal,1,1,['optimal'],['optimal'],1,1,0,optimal,1,1
Sangat bagus sekali,positif,2022-12-22,2022,sangat bagus sekali,3,3,sangat bagus sekali,3,3,"['sangat', 'bagus', 'sekali']",['bagus'],3,1,2,bagus,1,1
Semoga bermanfaat buat kita semua....,positif,2021-11-12,2021,semoga bermanfaat buat kita semua,5,5,semoga bermanfaat buat kita semua,5,5,"['semoga', 'bermanfaat', 'buat', 'kita', 'semua']","['semoga', 'bermanfaat']",5,2,3,moga manfaat,2,2
"Ribet,ga da lowongan kerja yg di Aceh selatan",negatif,2022-08-09,2022,ribet ga da lowongan kerja yg di aceh selatan,8,9,rumit tidak ada lowongan kerja yang di aceh selatan,9,9,"['rumit', 'tidak', 'ada', 'lowongan', 'kerja', 'yang', 'di', 'aceh', 'selatan']","['rumit', 'tidak', 'lowongan', 'kerja', 'aceh', 'selatan']",9,6,3,rumit tidak lowong kerja aceh selatan,6,6
info slalu update,positif,2023-11-10,2023,info slalu update,3,3,informasi selalu diperbarui,3,3,"['informasi', 'selalu', 'diperbarui']","['informasi', 'diperbarui']",3,2,1,informasi baru,2,2
oklah... bisa membantu kita,positif,2023-12-18,2023,oklah bisa membantu kita,4,4,oklah bisa membantu kita,4,4,"['oklah', 'bisa', 'membantu', 'kita']","['oklah', 'membantu']",4,2,2,oklah bantu,2,2
"Payah, mau rubah sandi salah mulu",negatif,2024-06-13,2024,payah mau rubah sandi salah mulu,6,6,payah mau rubah sandi salah mulu,6,6,"['payah', 'mau', 'rubah', 'sandi', 'salah', 'mulu']","['payah', 'rubah', 'sandi', 'salah', 'mulu']",6,5,1,payah rubah sandi salah mulu,5,5
Sangat membantu....,positif,2020-06-18,2020,sangat membantu,2,2,sangat membantu,2,2,"['sangat', 'membantu']",['membantu'],2,1,1,bantu,1,1
Baik dan update,positif,2022-01-25,2022,baik dan update,3,3,baik dan diperbarui,3,3,"['baik', 'dan', 'diperbarui']",['diperbarui'],3,1,2,baru,1,1
Semua nya baik,positif,2021-07-06,2021,semua nya baik,3,3,semua nya baik,3,3,"['semua', 'nya', 'baik']",['nya'],3,1,2,nya,1,1
Apkh bisa cari job di sini,positif,2021-10-30,2021,apkh bisa cari job di sini,6,6,apkh bisa cari kerja di sini,6,6,"['apkh', 'bisa', 'cari', 'kerja', 'di', 'sini']","['apkh', 'cari', 'kerja']",6,3,3,apkh cari kerja,3,3
Suka sekali,positif,2024-06-07,2024,suka sekali,2,2,suka sekali,2,2,"['suka', 'sekali']",['suka'],2,1,1,suka,1,1
Bagus aplikasi nya,positif,2020-12-07,2020,bagus aplikasi nya,3,3,bagus aplikasi nya,3,3,"['bagus', 'aplikasi', 'nya']","['bagus', 'aplikasi', 'nya']",3,3,0,bagus aplikasi nya,3,3
bagus penuh lima,positif,2020-01-21,2020,bagus penuh lima,3,3,bagus penuh lima,3,3,"['bagus', 'penuh', 'lima']","['bagus', 'penuh']",3,2,1,bagus penuh,2,2
Suka dengqn gagasan yang baik,positif,2020-08-03,2020,suka dengqn gagasan yang baik,5,5,suka dengqn gagasan yang baik,5,5,"['suka', 'dengqn', 'gagasan', 'yang', 'baik']","['suka', 'dengqn', 'gagasan']",5,3,2,suka dengqn gagas,3,3
Sangat Membantu Min Makasih,positif,2020-05-07,2020,sangat membantu min makasih,4,4,sangat membantu minimal terima kasih,4,5,"['sangat', 'membantu', 'minimal', 'terima', 'kasih']","['membantu', 'minimal', 'terima', 'kasih']",5,4,1,bantu minimal terima kasih,4,4
saya suka sangat membantu,positif,2020-05-19,2020,saya suka sangat membantu,4,4,saya suka sangat membantu,4,4,"['saya', 'suka', 'sangat', 'membantu']","['suka', 'membantu']",4,2,2,suka bantu,2,2
Bertebaran kawan lama dan baru...,positif,2022-06-08,2022,bertebaran kawan lama dan baru,5,5,bertebaran kawan lama dan baru,5,5,"['bertebaran', 'kawan', 'lama', 'dan', 'baru']","['bertebaran', 'kawan']",5,2,3,tebar kawan,2,2
Keren banget buat para business owner,positif,2022-08-01,2022,keren banget buat para business owner,6,6,keren banget buat para business owner,6,6,"['keren', 'banget', 'buat', 'para', 'business', 'owner']","['keren', 'banget', 'business', 'owner']",6,4,2,keren banget business owner,4,4
susah bgt vertifikasi nya,negatif,2022-07-17,2022,susah bgt vertifikasi nya,4,4,susah banget vertifikasi nya,4,4,"['susah', 'banget', 'vertifikasi', 'nya']","['susah', 'banget', 'vertifikasi', 'nya']",4,4,0,susah banget vertifikasi nya,4,4
Sukses terus linked,positif,2024-03-06,2024,sukses terus linked,3,3,sukses terus linked,3,3,"['sukses', 'terus', 'linked']","['sukses', 'linked']",3,2,1,sukses linked,2,2
Aplikasi luar biasa,positif,2022-06-11,2022,aplikasi luar biasa,3,3,aplikasi luar biasa,3,3,"['aplikasi', 'luar', 'biasa']",['aplikasi'],3,1,2,aplikasi,1,1
sangat membantu.terimakasih,positif,2023-03-25,2023,sangat membantu terimakasih,2,3,sangat membantu terima kasih,3,4,"['sangat', 'membantu', 'terima', 'kasih']","['membantu', 'terima', 'kasih']",4,3,1,bantu terima kasih,3,3
Asyik aja....isinya para Profesional,positif,2020-07-29,2020,asyik aja isinya para profesional,4,5,asyik saja isinya para profesional,5,5,"['asyik', 'saja', 'isinya', 'para', 'profesional']","['asyik', 'isinya', 'profesional']",5,3,2,asyik isi profesional,3,3
Bagus tingkatkan developer,positif,2024-01-02,2024,bagus tingkatkan developer,3,3,bagus tingkatkan developer,3,3,"['bagus', 'tingkatkan', 'developer']","['bagus', 'tingkatkan', 'developer']",3,3,0,bagus tingkat developer,3,3
"Aplikasi bodoh, verifikasi jawaban udh bener di salahin tolol",negatif,2022-03-18,2022,aplikasi bodoh verifikasi jawaban udh bener di salahin tolol,9,9,aplikasi bodoh verifikasi jawaban sudah benar di salahin tolol,9,9,"['aplikasi', 'bodoh', 'verifikasi', 'jawaban', 'sudah', 'benar', 'di', 'salahin', 'tolol']","['aplikasi', 'bodoh', 'verifikasi', 'salahin', 'tolol']",9,5,4,aplikasi bodoh verifikasi salahin tolol,5,5
Profesional Social Media Menghubungkan lebih banyak orang dalam lintas Profesional pekerjaan,positif,2020-09-11,2020,profesional social media menghubungkan lebih banyak orang dalam lintas profesional pekerjaan,11,11,profesional social media menghubungkan lebih banyak orang dalam lintas profesional pekerjaan,11,11,"['profesional', 'social', 'media', 'menghubungkan', 'lebih', 'banyak', 'orang', 'dalam', 'lintas', 'profesional', 'pekerjaan']","['profesional', 'social', 'media', 'menghubungkan', 'orang', 'lintas', 'profesional', 'pekerjaan']",11,8,3,profesional social media hubung orang lintas profesional kerja,8,8
Saya berharap ini dapat membantu.,positif,2022-10-13,2022,saya berharap ini dapat membantu,5,5,saya berharap ini dapat membantu,5,5,"['saya', 'berharap', 'ini', 'dapat', 'membantu']","['berharap', 'membantu']",5,2,3,harap bantu,2,2
Sangat bermamfaat,positif,2022-03-09,2022,sangat bermamfaat,2,2,sangat bermamfaat,2,2,"['sangat', 'bermamfaat']",['bermamfaat'],2,1,1,bermamfaat,1,1
Pake Tes Verifikasi Keamanan gak jelas,negatif,2023-03-12,2023,pake tes verifikasi keamanan gak jelas,6,6,pakai tes verifikasi keamanan tidak jelas,6,6,"['pakai', 'tes', 'verifikasi', 'keamanan', 'tidak', 'jelas']","['pakai', 'tes', 'verifikasi', 'keamanan', 'tidak']",6,5,1,pakai tes verifikasi aman tidak,5,5
Lebih berasa profesionalnya..,positif,2020-06-20,2020,lebih berasa profesionalnya,3,3,lebih berasa profesionalnya,3,3,"['lebih', 'berasa', 'profesionalnya']","['berasa', 'profesionalnya']",3,2,1,asa profesional,2,2
Sangat membantu thanks,positif,2023-07-29,2023,sangat membantu thanks,3,3,sangat membantu terima kasih,3,4,"['sangat', 'membantu', 'terima', 'kasih']","['membantu', 'terima', 'kasih']",4,3,1,bantu terima kasih,3,3
Terima kasih sudah menanggapi keluhan saya sebelumnya,positif,2020-05-24,2020,terima kasih sudah menanggapi keluhan saya sebelumnya,7,7,terima kasih sudah menanggapi keluhan saya sebelumnya,7,7,"['terima', 'kasih', 'sudah', 'menanggapi', 'keluhan', 'saya', 'sebelumnya']","['terima', 'kasih', 'menanggapi', 'keluhan']",7,4,3,terima kasih tanggap keluh,4,4
Mudah mudahan bagus,positif,2021-06-16,2021,mudah mudahan bagus,3,3,mudah mudahan bagus,3,3,"['mudah', 'mudahan', 'bagus']","['mudah', 'mudahan', 'bagus']",3,3,0,mudah mudah bagus,3,3
ini aplikasi yang sangat penting,positif,2021-12-01,2021,ini aplikasi yang sangat penting,5,5,ini aplikasi yang sangat penting,5,5,"['ini', 'aplikasi', 'yang', 'sangat', 'penting']",['aplikasi'],5,1,4,aplikasi,1,1
"Weehh gila login gagal terus,gajelas",negatif,2023-06-09,2023,weehh gila login gagal terus gajelas,5,6,weehh gila login gagal terus tidak jelas,6,7,"['weehh', 'gila', 'login', 'gagal', 'terus', 'tidak', 'jelas']","['weehh', 'gila', 'login', 'gagal', 'tidak']",7,5,2,weehh gila login gagal tidak,5,5
Aplikasi kaga jelas!!!,negatif,2023-09-25,2023,aplikasi kaga jelas,3,3,aplikasi tidak jelas,3,3,"['aplikasi', 'tidak', 'jelas']","['aplikasi', 'tidak']",3,2,1,aplikasi tidak,2,2
Muncul terus parah,negatif,2024-06-01,2024,muncul terus parah,3,3,muncul terus parah,3,3,"['muncul', 'terus', 'parah']","['muncul', 'parah']",3,2,1,muncul parah,2,2
Semoga bermanfaat buat kita semua,positif,2021-10-03,2021,semoga bermanfaat buat kita semua,5,5,semoga bermanfaat buat kita semua,5,5,"['semoga', 'bermanfaat', 'buat', 'kita', 'semua']","['semoga', 'bermanfaat']",5,2,3,moga manfaat,2,2
Penghubung jaringan,positif,2023-05-16,2023,penghubung jaringan,2,2,penghubung jaringan,2,2,"['penghubung', 'jaringan']","['penghubung', 'jaringan']",2,2,0,hubung jaring,2,2
"Meskipun baru prtama kali make sy kasi bintang 4 dulu, Ok👍",positif,2020-11-30,2020,meskipun baru prtama kali make sy kasi bintang dulu ok,11,10,meskipun baru pertama kali make saya kasih bintang dahulu oke,10,10,"['meskipun', 'baru', 'pertama', 'kali', 'make', 'saya', 'kasih', 'bintang', 'dahulu', 'oke']","['kali', 'make', 'kasih', 'bintang', 'oke']",10,5,5,kali make kasih bintang oke,5,5
Verifikasi nya khusus orang sakit,negatif,2023-01-19,2023,verifikasi nya khusus orang sakit,5,5,verifikasi nya khusus orang sakit,5,5,"['verifikasi', 'nya', 'khusus', 'orang', 'sakit']","['verifikasi', 'nya', 'khusus', 'orang', 'sakit']",5,5,0,verifikasi nya khusus orang sakit,5,5
Semoga saya dapat kerja di luar negri amin,positif,2020-03-08,2020,semoga saya dapat kerja di luar negri amin,8,8,semoga saya dapat kerja di luar negri aamiin,8,8,"['semoga', 'saya', 'dapat', 'kerja', 'di', 'luar', 'negri', 'aamiin']","['semoga', 'kerja', 'negri', 'aamiin']",8,4,4,moga kerja negri aamiin,4,4
Membantu mencari informasi,positif,2022-04-22,2022,membantu mencari informasi,3,3,membantu mencari informasi,3,3,"['membantu', 'mencari', 'informasi']","['membantu', 'mencari', 'informasi']",3,3,0,bantu cari informasi,3,3
Saya coba kasih bintang 5.smg saya ada milik di sini. Amin,positif,2021-05-10,2021,saya coba kasih bintang smg saya ada milik di sini amin,11,11,saya coba kasih bintang semoga saya ada milik di sini aamiin,11,11,"['saya', 'coba', 'kasih', 'bintang', 'semoga', 'saya', 'ada', 'milik', 'di', 'sini', 'aamiin']","['coba', 'kasih', 'bintang', 'semoga', 'milik', 'aamiin']",11,6,5,coba kasih bintang moga milik aamiin,6,6
Baik sangat membantu,positif,2020-09-28,2020,baik sangat membantu,3,3,baik sangat membantu,3,3,"['baik', 'sangat', 'membantu']",['membantu'],3,1,2,bantu,1,1
Infomatif Dan baik,positif,2021-02-06,2021,infomatif dan baik,3,3,infomatif dan baik,3,3,"['infomatif', 'dan', 'baik']",['infomatif'],3,1,2,infomatif,1,1
Bagus banget dan canrik,positif,2024-01-09,2024,bagus banget dan canrik,4,4,bagus banget dan canrik,4,4,"['bagus', 'banget', 'dan', 'canrik']","['bagus', 'banget', 'canrik']",4,3,1,bagus banget canrik,3,3
Gagal membuat akun terus,negatif,2021-02-21,2021,gagal membuat akun terus,4,4,gagal membuat akun terus,4,4,"['gagal', 'membuat', 'akun', 'terus']","['gagal', 'akun']",4,2,2,gagal akun,2,2
Berjumpa banyak teman hebat,positif,2021-09-23,2021,berjumpa banyak teman hebat,4,4,berjumpa banyak teman hebat,4,4,"['berjumpa', 'banyak', 'teman', 'hebat']","['berjumpa', 'teman', 'hebat']",4,3,1,jumpa teman hebat,3,3
Kerja keras demi bhagiakan orang tua,positif,2020-08-22,2020,kerja keras demi bhagiakan orang tua,6,6,kerja keras demi bhagiakan orang tua,6,6,"['kerja', 'keras', 'demi', 'bhagiakan', 'orang', 'tua']","['kerja', 'keras', 'bhagiakan', 'orang', 'tua']",6,5,1,kerja keras bhagiakan orang tua,5,5
Banyak info thanks,positif,2022-07-25,2022,banyak info thanks,3,3,banyak informasi terima kasih,3,4,"['banyak', 'informasi', 'terima', 'kasih']","['informasi', 'terima', 'kasih']",4,3,1,informasi terima kasih,3,3
Sangat bermanfaat,positif,2022-07-14,2022,sangat bermanfaat,2,2,sangat bermanfaat,2,2,"['sangat', 'bermanfaat']",['bermanfaat'],2,1,1,manfaat,1,1
SEMANGAT PAGI OPTIMIS DAN JANGAN PESIMIS KELUARGA BESAR YTE TEAM BINTANG 1 INDONESIA MEMBENTUK SUATU TROBOSAN BARU DALAM PENINGKATAN FINANSIAL YANG TEPAT AKURAT PADAT TERPERCAYA DAN AMAN KAMI BOYADI DARI BANYUWANGI MENGAMBIL TROBOSAN TEPAT UNTUK MENINGKATKAN FINANSIAL DI KARENAKAN DAMPAK COVIT19 YANG SANGAT MELULUH LANTAHKAN PEREKONOMIAN RAKYAT INDONESIA MEMBERI SOLUSI 5 PROGRAM DENGAN MODAL KECIL RESIKO KECIL HASIL BESAR DAN AMAN. SILAHKAN SIMAK,positif,2022-02-12,2022,semangat pagi optimis dan jangan pesimis keluarga besar yte team bintang indonesia membentuk suatu trobosan baru dalam peningkatan finansial yang tepat akurat padat terpercaya dan aman kami boyadi dari banyuwangi mengambil trobosan tepat untuk meningkatkan finansial di karenakan dampak covit yang sangat meluluh lantahkan perekonomian rakyat indonesia memberi solusi program dengan modal kecil resiko kecil hasil besar dan aman silahkan simak,63,61,semangat pagi optimis dan jangan pesimis keluarga besar yte team bintang indonesia membentuk suatu trobosan baru dalam peningkatan finansial yang tepat akurat padat terpercaya dan aman kami boyadi dari banyuwangi mengambil trobosan tepat untuk meningkatkan finansial di karenakan dampak covit yang sangat meluluh lantahkan perekonomian rakyat indonesia memberi solusi program dengan modal kecil resiko kecil hasil besar dan aman silahkan simak,61,61,"['semangat', 'pagi', 'optimis', 'dan', 'jangan', 'pesimis', 'keluarga', 'besar', 'yte', 'team', 'bintang', 'indonesia', 'membentuk', 'suatu', 'trobosan', 'baru', 'dalam', 'peningkatan', 'finansial', 'yang', 'tepat', 'akurat', 'padat', 'terpercaya', 'dan', 'aman', 'kami', 'boyadi', 'dari', 'banyuwangi', 'mengambil', 'trobosan', 'tepat', 'untuk', 'meningkatkan', 'finansial', 'di', 'karenakan', 'dampak', 'covit', 'yang', 'sangat', 'meluluh', 'lantahkan', 'perekonomian', 'rakyat', 'indonesia', 'memberi', 'solusi', 'program', 'dengan', 'modal', 'kecil', 'resiko', 'kecil', 'hasil', 'besar', 'dan', 'aman', 'silahkan', 'simak']","['semangat', 'pagi', 'optimis', 'pesimis', 'keluarga', 'yte', 'team', 'bintang', 'indonesia', 'membentuk', 'trobosan', 'peningkatan', 'finansial', 'akurat', 'padat', 'terpercaya', 'aman', 'boyadi', 'banyuwangi', 'mengambil', 'trobosan', 'meningkatkan', 'finansial', 'karenakan', 'dampak', 'covit', 'meluluh', 'lantahkan', 'perekonomian', 'rakyat', 'indonesia', 'solusi', 'program', 'modal', 'resiko', 'hasil', 'aman', 'silahkan', 'simak']",61,39,22,semangat pagi optimis pesimis keluarga yte team bintang indonesia bentuk trobosan tingkat finansial akurat padat percaya aman boyadi banyuwangi ambil trobosan tingkat finansial karena dampak covit luluh lantah ekonomi rakyat indonesia solusi program modal resiko hasil aman silah simak,39,39
Aplìkasi ini sangat membantu,positif,2021-05-30,2021,aplìkasi ini sangat membantu,4,4,aplìkasi ini sangat membantu,4,4,"['aplìkasi', 'ini', 'sangat', 'membantu']","['aplìkasi', 'membantu']",4,2,2,apl kasi bantu,2,3
Mudah cari kerjaan,positif,2020-03-15,2020,mudah cari kerjaan,3,3,mudah cari kerjaan,3,3,"['mudah', 'cari', 'kerjaan']","['mudah', 'cari', 'kerjaan']",3,3,0,mudah cari kerja,3,3
Mencari pekerjaan,positif,2020-11-22,2020,mencari pekerjaan,2,2,mencari pekerjaan,2,2,"['mencari', 'pekerjaan']","['mencari', 'pekerjaan']",2,2,0,cari kerja,2,2
Lebih sering buka ini dari pada IG 😁,positif,2022-03-26,2022,lebih sering buka ini dari pada ig,8,7,lebih sering buka ini dari pada instagram,7,7,"['lebih', 'sering', 'buka', 'ini', 'dari', 'pada', 'instagram']","['buka', 'instagram']",7,2,5,buka instagram,2,2
Aplikasi ini mantap Yes,positif,2021-04-14,2021,aplikasi ini mantap yes,4,4,aplikasi ini mantap yes,4,4,"['aplikasi', 'ini', 'mantap', 'yes']","['aplikasi', 'mantap', 'yes']",4,3,1,aplikasi mantap yes,3,3
Aplikasi yang bagus dan bermanfaat,positif,2020-08-30,2020,aplikasi yang bagus dan bermanfaat,5,5,aplikasi yang bagus dan bermanfaat,5,5,"['aplikasi', 'yang', 'bagus', 'dan', 'bermanfaat']","['aplikasi', 'bagus', 'bermanfaat']",5,3,2,aplikasi bagus manfaat,3,3
Sumpa login nya susah bgt si chaptanya gajelas,negatif,2023-08-06,2023,sumpa login nya susah bgt si chaptanya gajelas,8,8,sumpa login nya susah banget sih chaptanya tidak jelas,8,9,"['sumpa', 'login', 'nya', 'susah', 'banget', 'sih', 'chaptanya', 'tidak', 'jelas']","['sumpa', 'login', 'nya', 'susah', 'banget', 'sih', 'chaptanya', 'tidak']",9,8,1,sumpa login nya susah banget sih chaptanya tidak,8,8
Sangat membantu bisnis saya,positif,2020-11-16,2020,sangat membantu bisnis saya,4,4,sangat membantu bisnis saya,4,4,"['sangat', 'membantu', 'bisnis', 'saya']","['membantu', 'bisnis']",4,2,2,bantu bisnis,2,2
Cukup bagus kami suka,positif,2020-01-23,2020,cukup bagus kami suka,4,4,cukup bagus kami suka,4,4,"['cukup', 'bagus', 'kami', 'suka']","['bagus', 'suka']",4,2,2,bagus suka,2,2
Jelek ni aplikasi nya,negatif,2021-07-21,2021,jelek ni aplikasi nya,4,4,jelek ini aplikasi nya,4,4,"['jelek', 'ini', 'aplikasi', 'nya']","['jelek', 'aplikasi', 'nya']",4,3,1,jelek aplikasi nya,3,3
Luar biasa membantu,positif,2020-01-16,2020,luar biasa membantu,3,3,luar biasa membantu,3,3,"['luar', 'biasa', 'membantu']",['membantu'],3,1,2,bantu,1,1
Keren menunjang bisnis,positif,2020-06-19,2020,keren menunjang bisnis,3,3,keren menunjang bisnis,3,3,"['keren', 'menunjang', 'bisnis']","['keren', 'menunjang', 'bisnis']",3,3,0,keren tunjang bisnis,3,3
Semoga lebih baik ke depannya,positif,2021-04-02,2021,semoga lebih baik ke depannya,5,5,semoga lebih baik ke depannya,5,5,"['semoga', 'lebih', 'baik', 'ke', 'depannya']","['semoga', 'depannya']",5,2,3,moga depan,2,2
Bagus dan berguna,positif,2020-04-03,2020,bagus dan berguna,3,3,bagus dan berguna,3,3,"['bagus', 'dan', 'berguna']","['bagus', 'berguna']",3,2,1,bagus guna,2,2
Aplikasi paling ribet,negatif,2022-05-24,2022,aplikasi paling ribet,3,3,aplikasi paling rumit,3,3,"['aplikasi', 'paling', 'rumit']","['aplikasi', 'rumit']",3,2,1,aplikasi rumit,2,2
Bagus sangat bagus,positif,2023-12-11,2023,bagus sangat bagus,3,3,bagus sangat bagus,3,3,"['bagus', 'sangat', 'bagus']","['bagus', 'bagus']",3,2,1,bagus bagus,2,2
Sangat Membantu...Terima kasih,positif,2020-07-16,2020,sangat membantu terima kasih,3,4,sangat membantu terima kasih,4,4,"['sangat', 'membantu', 'terima', 'kasih']","['membantu', 'terima', 'kasih']",4,3,1,bantu terima kasih,3,3
Mantap sangat membantu saya,positif,2020-10-15,2020,mantap sangat membantu saya,4,4,mantap sangat membantu saya,4,4,"['mantap', 'sangat', 'membantu', 'saya']","['mantap', 'membantu']",4,2,2,mantap bantu,2,2
Mencari pekerjaan,positif,2021-04-15,2021,mencari pekerjaan,2,2,mencari pekerjaan,2,2,"['mencari', 'pekerjaan']","['mencari', 'pekerjaan']",2,2,0,cari kerja,2,2
Verifikasi teka teki anjay susah amat,negatif,2021-04-13,2021,verifikasi teka teki anjay susah amat,6,6,verifikasi teka teki anjay susah amat,6,6,"['verifikasi', 'teka', 'teki', 'anjay', 'susah', 'amat']","['verifikasi', 'teka', 'teki', 'anjay', 'susah']",6,5,1,verifikasi teka teki anjay susah,5,5
Aplikasi sangat berguna,positif,2020-02-18,2020,aplikasi sangat berguna,3,3,aplikasi sangat berguna,3,3,"['aplikasi', 'sangat', 'berguna']","['aplikasi', 'berguna']",3,2,1,aplikasi guna,2,2
Semangat terus. Jangan menyerah,positif,2021-06-13,2021,semangat terus jangan menyerah,4,4,semangat terus jangan menyerah,4,4,"['semangat', 'terus', 'jangan', 'menyerah']","['semangat', 'menyerah']",4,2,2,semangat serah,2,2
Sangat membantu,positif,2020-06-24,2020,sangat membantu,2,2,sangat membantu,2,2,"['sangat', 'membantu']",['membantu'],2,1,1,bantu,1,1
Bagus sangat membantu,positif,2024-02-16,2024,bagus sangat membantu,3,3,bagus sangat membantu,3,3,"['bagus', 'sangat', 'membantu']","['bagus', 'membantu']",3,2,1,bagus bantu,2,2
Sangat bermanfaat bagi saya,positif,2023-05-11,2023,sangat bermanfaat bagi saya,4,4,sangat bermanfaat bagi saya,4,4,"['sangat', 'bermanfaat', 'bagi', 'saya']",['bermanfaat'],4,1,3,manfaat,1,1
Sumpah mau login doang susah banget perakara milih hewan yg madep ke atas anjir😭😭😭😭😭😭,negatif,2023-11-23,2023,sumpah mau login doang susah banget perakara milih hewan yg madep ke atas anjir,14,14,sumpah mau login saja susah banget perakara memilih hewan yang madep ke atas anjir,14,14,"['sumpah', 'mau', 'login', 'saja', 'susah', 'banget', 'perakara', 'memilih', 'hewan', 'yang', 'madep', 'ke', 'atas', 'anjir']","['sumpah', 'login', 'susah', 'banget', 'perakara', 'memilih', 'hewan', 'madep', 'anjir']",14,9,5,sumpah login susah banget perakara pilih hewan madep anjir,9,9
Bagus juga deh,positif,2020-02-14,2020,bagus juga deh,3,3,bagus juga deh,3,3,"['bagus', 'juga', 'deh']","['bagus', 'deh']",3,2,1,bagus deh,2,2
sangat bermanfaat,positif,2020-06-01,2020,sangat bermanfaat,2,2,sangat bermanfaat,2,2,"['sangat', 'bermanfaat']",['bermanfaat'],2,1,1,manfaat,1,1
Sungguh sangat bermanfaat..,positif,2020-06-09,2020,sungguh sangat bermanfaat,3,3,sungguh sangat bermanfaat,3,3,"['sungguh', 'sangat', 'bermanfaat']","['sungguh', 'bermanfaat']",3,2,1,sungguh manfaat,2,2
Sangat cocok untuk saya,positif,2023-08-22,2023,sangat cocok untuk saya,4,4,sangat cocok untuk saya,4,4,"['sangat', 'cocok', 'untuk', 'saya']",['cocok'],4,1,3,cocok,1,1
Aplikasinya bagus,positif,2023-01-12,2023,aplikasinya bagus,2,2,aplikasi nya bagus,2,3,"['aplikasi', 'nya', 'bagus']","['aplikasi', 'nya', 'bagus']",3,3,0,aplikasi nya bagus,3,3
Semogga bisa sanggat membantu,positif,2020-07-09,2020,semogga bisa sanggat membantu,4,4,semogga bisa sanggat membantu,4,4,"['semogga', 'bisa', 'sanggat', 'membantu']","['semogga', 'sanggat', 'membantu']",4,3,1,semogga sanggat bantu,3,3
Cukup menarik,positif,2022-04-24,2022,cukup menarik,2,2,cukup menarik,2,2,"['cukup', 'menarik']",['menarik'],2,1,1,tarik,1,1
Apk gak jelas verifikasi pake gambar orang Kota mana elu lahir bego,negatif,2023-05-26,2023,apk gak jelas verifikasi pake gambar orang kota mana elu lahir bego,12,12,aplikasi tidak jelas verifikasi pakai gambar orang kota mana elu lahir bodoh,12,12,"['aplikasi', 'tidak', 'jelas', 'verifikasi', 'pakai', 'gambar', 'orang', 'kota', 'mana', 'elu', 'lahir', 'bodoh']","['aplikasi', 'tidak', 'verifikasi', 'pakai', 'gambar', 'orang', 'kota', 'elu', 'lahir', 'bodoh']",12,10,2,aplikasi tidak verifikasi pakai gambar orang kota elu lahir bodoh,10,10
Semoga selalu bermanfaat,positif,2020-10-17,2020,semoga selalu bermanfaat,3,3,semoga selalu bermanfaat,3,3,"['semoga', 'selalu', 'bermanfaat']","['semoga', 'bermanfaat']",3,2,1,moga manfaat,2,2
Membantu sangat,positif,2020-01-19,2020,membantu sangat,2,2,membantu sangat,2,2,"['membantu', 'sangat']",['membantu'],2,1,1,bantu,1,1
Sangat bermanfaat,positif,2020-10-25,2020,sangat bermanfaat,2,2,sangat bermanfaat,2,2,"['sangat', 'bermanfaat']",['bermanfaat'],2,1,1,manfaat,1,1
Masih sukses sama sama disini,positif,2021-02-22,2021,masih sukses sama sama disini,5,5,masih sukses sama sama disini,5,5,"['masih', 'sukses', 'sama', 'sama', 'disini']",['sukses'],5,1,4,sukses,1,1
sangat mengesankan,positif,2022-08-29,2022,sangat mengesankan,2,2,sangat mengesankan,2,2,"['sangat', 'mengesankan']",['mengesankan'],2,1,1,kesan,1,1
Verifikasi tidak jelas,negatif,2023-05-12,2023,verifikasi tidak jelas,3,3,verifikasi tidak jelas,3,3,"['verifikasi', 'tidak', 'jelas']","['verifikasi', 'tidak']",3,2,1,verifikasi tidak,2,2
Memperluas wawasan,positif,2022-04-26,2022,memperluas wawasan,2,2,memperluas wawasan,2,2,"['memperluas', 'wawasan']","['memperluas', 'wawasan']",2,2,0,luas wawas,2,2
Terimakasih banyak atas Partisipasi nya,positif,2021-04-09,2021,terimakasih banyak atas partisipasi nya,5,5,terima kasih banyak atas partisipasi nya,5,6,"['terima', 'kasih', 'banyak', 'atas', 'partisipasi', 'nya']","['terima', 'kasih', 'partisipasi', 'nya']",6,4,2,terima kasih partisipasi nya,4,4
Verifikasi brengsek dikerjain sama gambar binatang...parahhh,negatif,2023-05-14,2023,verifikasi brengsek dikerjain sama gambar binatang parahhh,6,7,verifikasi brengsek dikerjain sama gambar binatang parahhh,7,7,"['verifikasi', 'brengsek', 'dikerjain', 'sama', 'gambar', 'binatang', 'parahhh']","['verifikasi', 'brengsek', 'dikerjain', 'gambar', 'binatang', 'parahhh']",7,6,1,verifikasi brengsek dikerjain gambar binatang parahhh,6,6
Sangat bermanfaat,positif,2022-08-22,2022,sangat bermanfaat,2,2,sangat bermanfaat,2,2,"['sangat', 'bermanfaat']",['bermanfaat'],2,1,1,manfaat,1,1
Sangat membantu,positif,2021-10-04,2021,sangat membantu,2,2,sangat membantu,2,2,"['sangat', 'membantu']",['membantu'],2,1,1,bantu,1,1
Bagus dan cermat,positif,2022-11-17,2022,bagus dan cermat,3,3,bagus dan cermat,3,3,"['bagus', 'dan', 'cermat']","['bagus', 'cermat']",3,2,1,bagus cermat,2,2
Sosial antara pengertian sesama umat,positif,2022-03-20,2022,sosial antara pengertian sesama umat,5,5,sosial antara pengertian sesama umat,5,5,"['sosial', 'antara', 'pengertian', 'sesama', 'umat']","['sosial', 'pengertian', 'umat']",5,3,2,sosial erti umat,3,3
Sangat membantu saya,positif,2023-01-22,2023,sangat membantu saya,3,3,sangat membantu saya,3,3,"['sangat', 'membantu', 'saya']",['membantu'],3,1,2,bantu,1,1
Mudah dioperasika.,positif,2020-05-20,2020,mudah dioperasika,2,2,mudah dioperasika,2,2,"['mudah', 'dioperasika']","['mudah', 'dioperasika']",2,2,0,mudah dioperasika,2,2
Verifikasi gagal terus😔,negatif,2023-08-06,2023,verifikasi gagal terus,3,3,verifikasi gagal terus,3,3,"['verifikasi', 'gagal', 'terus']","['verifikasi', 'gagal']",3,2,1,verifikasi gagal,2,2
Sangat membantu!!!,positif,2020-12-21,2020,sangat membantu,2,2,sangat membantu,2,2,"['sangat', 'membantu']",['membantu'],2,1,1,bantu,1,1
Banyak memberi informasi dan inspirasi,positif,2020-05-14,2020,banyak memberi informasi dan inspirasi,5,5,banyak memberi informasi dan inspirasi,5,5,"['banyak', 'memberi', 'informasi', 'dan', 'inspirasi']","['informasi', 'inspirasi']",5,2,3,informasi inspirasi,2,2
Verikvikasi gagal terooos,negatif,2023-07-31,2023,verikvikasi gagal terooos,3,3,verikvikasi gagal terooos,3,3,"['verikvikasi', 'gagal', 'terooos']","['verikvikasi', 'gagal', 'terooos']",3,3,0,verikvikasi gagal terooos,3,3
Sangat membantu Bagus,positif,2020-08-19,2020,sangat membantu bagus,3,3,sangat membantu bagus,3,3,"['sangat', 'membantu', 'bagus']","['membantu', 'bagus']",3,2,1,bantu bagus,2,2
Belajar menambah wawasan,positif,2021-05-09,2021,belajar menambah wawasan,3,3,belajar menambah wawasan,3,3,"['belajar', 'menambah', 'wawasan']","['belajar', 'menambah', 'wawasan']",3,3,0,ajar tambah wawas,3,3
Ga jelas verifikasinya,negatif,2022-04-13,2022,ga jelas verifikasinya,3,3,tidak jelas verifikasinya,3,3,"['tidak', 'jelas', 'verifikasinya']","['tidak', 'verifikasinya']",3,2,1,tidak verifikasi,2,2
Menambah wawasan dan ilmu,positif,2020-11-09,2020,menambah wawasan dan ilmu,4,4,menambah wawasan dan ilmu,4,4,"['menambah', 'wawasan', 'dan', 'ilmu']","['menambah', 'wawasan', 'ilmu']",4,3,1,tambah wawas ilmu,3,3
Sangat membantu saya,positif,2022-01-11,2022,sangat membantu saya,3,3,sangat membantu saya,3,3,"['sangat', 'membantu', 'saya']",['membantu'],3,1,2,bantu,1,1
Ribet masuk ny..hrs di ulang2,negatif,2022-07-17,2022,ribet masuk ny hrs di ulang,5,6,rumit masuk nya harus di ulang,6,6,"['rumit', 'masuk', 'nya', 'harus', 'di', 'ulang']","['rumit', 'masuk', 'nya', 'ulang']",6,4,2,rumit masuk nya ulang,4,4
Verifikasi terbodoh !!!!!,negatif,2022-02-22,2022,verifikasi terbodoh,3,2,verifikasi terbodoh,2,2,"['verifikasi', 'terbodoh']","['verifikasi', 'terbodoh']",2,2,0,verifikasi bodoh,2,2
Bagus banget nih bro,positif,2021-11-18,2021,bagus banget nih bro,4,4,bagus banget nih bro,4,4,"['bagus', 'banget', 'nih', 'bro']","['bagus', 'banget', 'nih', 'bro']",4,4,0,bagus banget nih bro,4,4
Lumayan bagus sih,positif,2022-08-02,2022,lumayan bagus sih,3,3,lumayan bagus sih,3,3,"['lumayan', 'bagus', 'sih']","['lumayan', 'bagus', 'sih']",3,3,0,lumayan bagus sih,3,3
Sangat bermanfaat,positif,2020-11-05,2020,sangat bermanfaat,2,2,sangat bermanfaat,2,2,"['sangat', 'bermanfaat']",['bermanfaat'],2,1,1,manfaat,1,1
Aplikasi bagus dan bermanfaat,positif,2021-12-09,2021,aplikasi bagus dan bermanfaat,4,4,aplikasi bagus dan bermanfaat,4,4,"['aplikasi', 'bagus', 'dan', 'bermanfaat']","['aplikasi', 'bagus', 'bermanfaat']",4,3,1,aplikasi bagus manfaat,3,3
Sangat membantu saya,positif,2022-01-19,2022,sangat membantu saya,3,3,sangat membantu saya,3,3,"['sangat', 'membantu', 'saya']",['membantu'],3,1,2,bantu,1,1
Ya saya suka dengan aplikasi ini,positif,2022-07-28,2022,ya saya suka dengan aplikasi ini,6,6,ya saya suka dengan aplikasi ini,6,6,"['ya', 'saya', 'suka', 'dengan', 'aplikasi', 'ini']","['ya', 'suka', 'aplikasi']",6,3,3,ya suka aplikasi,3,3
Bagus dan keren,positif,2023-02-10,2023,bagus dan keren,3,3,bagus dan keren,3,3,"['bagus', 'dan', 'keren']","['bagus', 'keren']",3,2,1,bagus keren,2,2
Lowongan kerja cool,positif,2022-02-28,2022,lowongan kerja cool,3,3,lowongan kerja cool,3,3,"['lowongan', 'kerja', 'cool']","['lowongan', 'kerja', 'cool']",3,3,0,lowong kerja cool,3,3
Sangat membantu.,positif,2021-12-06,2021,sangat membantu,2,2,sangat membantu,2,2,"['sangat', 'membantu']",['membantu'],2,1,1,bantu,1,1
Bagus kasih 4 bintang dulu yaa,positif,2021-03-12,2021,bagus kasih bintang dulu yaa,6,5,bagus kasih bintang dahulu ya,5,5,"['bagus', 'kasih', 'bintang', 'dahulu', 'ya']","['bagus', 'kasih', 'bintang', 'ya']",5,4,1,bagus kasih bintang ya,4,4
Sangat menguntungkan sekali,positif,2022-08-27,2022,sangat menguntungkan sekali,3,3,sangat menguntungkan sekali,3,3,"['sangat', 'menguntungkan', 'sekali']",['menguntungkan'],3,1,2,untung,1,1
Sangat membantu,positif,2024-04-09,2024,sangat membantu,2,2,sangat membantu,2,2,"['sangat', 'membantu']",['membantu'],2,1,1,bantu,1,1
Sangat membantu,positif,2024-07-13,2024,sangat membantu,2,2,sangat membantu,2,2,"['sangat', 'membantu']",['membantu'],2,1,1,bantu,1,1
"Susah login, bagaimana ini?",negatif,2020-01-24,2020,susah login bagaimana ini,4,4,susah login bagaimana ini,4,4,"['susah', 'login', 'bagaimana', 'ini']","['susah', 'login']",4,2,2,susah login,2,2
aplikasinya mantap,positif,2020-05-20,2020,aplikasinya mantap,2,2,aplikasi nya mantap,2,3,"['aplikasi', 'nya', 'mantap']","['aplikasi', 'nya', 'mantap']",3,3,0,aplikasi nya mantap,3,3
Sangat bermanfaat,positif,2020-05-22,2020,sangat bermanfaat,2,2,sangat bermanfaat,2,2,"['sangat', 'bermanfaat']",['bermanfaat'],2,1,1,manfaat,1,1
Terima kasih banyak atas bantuannya,positif,2021-04-08,2021,terima kasih banyak atas bantuannya,5,5,terima kasih banyak atas bantuannya,5,5,"['terima', 'kasih', 'banyak', 'atas', 'bantuannya']","['terima', 'kasih', 'bantuannya']",5,3,2,terima kasih bantu,3,3
Sangat bermanfaat 👍,positif,2021-01-19,2021,sangat bermanfaat,3,2,sangat bermanfaat,2,2,"['sangat', 'bermanfaat']",['bermanfaat'],2,1,1,manfaat,1,1
Sangat Membantu,positif,2021-09-12,2021,sangat membantu,2,2,sangat membantu,2,2,"['sangat', 'membantu']",['membantu'],2,1,1,bantu,1,1
Baik untuk pertemannan,positif,2022-08-02,2022,baik untuk pertemannan,3,3,baik untuk pertemannan,3,3,"['baik', 'untuk', 'pertemannan']",['pertemannan'],3,1,2,pertemannan,1,1
Sangat bermanfaat,positif,2020-07-12,2020,sangat bermanfaat,2,2,sangat bermanfaat,2,2,"['sangat', 'bermanfaat']",['bermanfaat'],2,1,1,manfaat,1,1
Sangat membantu,positif,2021-06-22,2021,sangat membantu,2,2,sangat membantu,2,2,"['sangat', 'membantu']",['membantu'],2,1,1,bantu,1,1
Aplikasi yg cukup baik,positif,2023-11-17,2023,aplikasi yg cukup baik,4,4,aplikasi yang cukup baik,4,4,"['aplikasi', 'yang', 'cukup', 'baik']",['aplikasi'],4,1,3,aplikasi,1,1
sangat membantu dlm mencari informasi kerja,positif,2021-06-10,2021,sangat membantu dlm mencari informasi kerja,6,6,sangat membantu dalam mencari informasi kerja,6,6,"['sangat', 'membantu', 'dalam', 'mencari', 'informasi', 'kerja']","['membantu', 'mencari', 'informasi', 'kerja']",6,4,2,bantu cari informasi kerja,4,4
Bagus untuk menambah relasi,positif,2021-03-30,2021,bagus untuk menambah relasi,4,4,bagus untuk menambah relasi,4,4,"['bagus', 'untuk', 'menambah', 'relasi']","['bagus', 'menambah', 'relasi']",4,3,1,bagus tambah relasi,3,3
Sangat membantu,positif,2023-03-25,2023,sangat membantu,2,2,sangat membantu,2,2,"['sangat', 'membantu']",['membantu'],2,1,1,bantu,1,1
Sangat membantu.,positif,2022-02-16,2022,sangat membantu,2,2,sangat membantu,2,2,"['sangat', 'membantu']",['membantu'],2,1,1,bantu,1,1
Terinspirasi dari perkerja,positif,2023-11-10,2023,terinspirasi dari perkerja,3,3,terinspirasi dari perkerja,3,3,"['terinspirasi', 'dari', 'perkerja']","['terinspirasi', 'perkerja']",3,2,1,inspirasi kerja,2,2
Saya membangun bianis saya selama 5 tahun,positif,2023-09-07,2023,saya membangun bianis saya selama tahun,7,6,saya membangun bianis saya selama tahun,6,6,"['saya', 'membangun', 'bianis', 'saya', 'selama', 'tahun']","['membangun', 'bianis']",6,2,4,bangun bianis,2,2
Mau masuk aja ribet banget,negatif,2022-05-29,2022,mau masuk aja ribet banget,5,5,mau masuk saja rumit banget,5,5,"['mau', 'masuk', 'saja', 'rumit', 'banget']","['masuk', 'rumit', 'banget']",5,3,2,masuk rumit banget,3,3
Media sosial serba apa aja,positif,2020-03-12,2020,media sosial serba apa aja,5,5,media sosial serba apa saja,5,5,"['media', 'sosial', 'serba', 'apa', 'saja']","['media', 'sosial', 'serba']",5,3,2,media sosial serba,3,3
Sangat membantu🤝🤝🤝,positif,2023-03-08,2023,sangat membantu,2,2,sangat membantu,2,2,"['sangat', 'membantu']",['membantu'],2,1,1,bantu,1,1
Sangat bermanfaat.,positif,2020-02-18,2020,sangat bermanfaat,2,2,sangat bermanfaat,2,2,"['sangat', 'bermanfaat']",['bermanfaat'],2,1,1,manfaat,1,1
Banyak info loker nya,positif,2020-03-05,2020,banyak info loker nya,4,4,banyak informasi loker nya,4,4,"['banyak', 'informasi', 'loker', 'nya']","['informasi', 'loker', 'nya']",4,3,1,informasi loker nya,3,3
Sangat mengganggu,negatif,2022-04-05,2022,sangat mengganggu,2,2,sangat mengganggu,2,2,"['sangat', 'mengganggu']",['mengganggu'],2,1,1,ganggu,1,1
Kurang yakin sy engak segàmpang itu,negatif,2022-04-01,2022,kurang yakin sy engak segàmpang itu,6,6,kurang yakin saya engak segàmpang itu,6,6,"['kurang', 'yakin', 'saya', 'engak', 'segàmpang', 'itu']","['engak', 'segàmpang']",6,2,4,engak seg mpang,2,3
Memudahkan untuk bertransaksi,positif,2021-09-14,2021,memudahkan untuk bertransaksi,3,3,memudahkan untuk bertransaksi,3,3,"['memudahkan', 'untuk', 'bertransaksi']","['memudahkan', 'bertransaksi']",3,2,1,mudah transaksi,2,2
Akurat Smart Mobile,positif,2023-11-17,2023,akurat smart mobile,3,3,akurat smart mobile,3,3,"['akurat', 'smart', 'mobile']","['akurat', 'smart', 'mobile']",3,3,0,akurat smart mobile,3,3
Sangat membantu,positif,2022-03-21,2022,sangat membantu,2,2,sangat membantu,2,2,"['sangat', 'membantu']",['membantu'],2,1,1,bantu,1,1
Sangat bermanfaat,positif,2021-10-23,2021,sangat bermanfaat,2,2,sangat bermanfaat,2,2,"['sangat', 'bermanfaat']",['bermanfaat'],2,1,1,manfaat,1,1
aplikasinya bagus👍,positif,2021-02-08,2021,aplikasinya bagus,2,2,aplikasi nya bagus,2,3,"['aplikasi', 'nya', 'bagus']","['aplikasi', 'nya', 'bagus']",3,3,0,aplikasi nya bagus,3,3
Sangat bermanfaat,positif,2021-05-20,2021,sangat bermanfaat,2,2,sangat bermanfaat,2,2,"['sangat', 'bermanfaat']",['bermanfaat'],2,1,1,manfaat,1,1
Sangat membantu,positif,2022-07-06,2022,sangat membantu,2,2,sangat membantu,2,2,"['sangat', 'membantu']",['membantu'],2,1,1,bantu,1,1
banyak informasinya,positif,2020-05-12,2020,banyak informasinya,2,2,banyak informasinya,2,2,"['banyak', 'informasinya']",['informasinya'],2,1,1,informasi,1,1
Sangat membantu,positif,2021-02-16,2021,sangat membantu,2,2,sangat membantu,2,2,"['sangat', 'membantu']",['membantu'],2,1,1,bantu,1,1
Gagal Verifikasi mulu Oyyy,negatif,2023-04-07,2023,gagal verifikasi mulu oyyy,4,4,gagal verifikasi mulu oyyy,4,4,"['gagal', 'verifikasi', 'mulu', 'oyyy']","['gagal', 'verifikasi', 'mulu', 'oyyy']",4,4,0,gagal verifikasi mulu oyyy,4,4
Bagus untuk membuka mitra usaha,positif,2020-06-02,2020,bagus untuk membuka mitra usaha,5,5,bagus untuk membuka mitra usaha,5,5,"['bagus', 'untuk', 'membuka', 'mitra', 'usaha']","['bagus', 'membuka', 'mitra', 'usaha']",5,4,1,bagus buka mitra usaha,4,4
Sangat bermanfaat,positif,2021-06-26,2021,sangat bermanfaat,2,2,sangat bermanfaat,2,2,"['sangat', 'bermanfaat']",['bermanfaat'],2,1,1,manfaat,1,1
Diperbaiki lebih lanjut,positif,2021-04-12,2021,diperbaiki lebih lanjut,3,3,di perbaiki lebih lanjut,3,4,"['di', 'perbaiki', 'lebih', 'lanjut']",['perbaiki'],4,1,3,baik,1,1
Sangat bagus buat kalin,positif,2020-07-18,2020,sangat bagus buat kalin,4,4,sangat bagus buat kalin,4,4,"['sangat', 'bagus', 'buat', 'kalin']","['bagus', 'kalin']",4,2,2,bagus kalin,2,2
Sangat membantu,positif,2021-04-13,2021,sangat membantu,2,2,sangat membantu,2,2,"['sangat', 'membantu']",['membantu'],2,1,1,bantu,1,1
Sangat bermanfaat,positif,2021-07-30,2021,sangat bermanfaat,2,2,sangat bermanfaat,2,2,"['sangat', 'bermanfaat']",['bermanfaat'],2,1,1,manfaat,1,1
Informasinya keren,positif,2024-07-30,2024,informasinya keren,2,2,informasinya keren,2,2,"['informasinya', 'keren']","['informasinya', 'keren']",2,2,0,informasi keren,2,2
mau login aja susah,negatif,2023-08-20,2023,mau login aja susah,4,4,mau login saja susah,4,4,"['mau', 'login', 'saja', 'susah']","['login', 'susah']",4,2,2,login susah,2,2
Ok gan ini baru top,positif,2020-07-16,2020,ok gan ini baru top,5,5,oke juragan ini baru top,5,5,"['oke', 'juragan', 'ini', 'baru', 'top']","['oke', 'juragan', 'top']",5,3,2,oke juragan top,3,3
Apk gak layak.,negatif,2021-07-08,2021,apk gak layak,3,3,aplikasi tidak layak,3,3,"['aplikasi', 'tidak', 'layak']","['aplikasi', 'tidak', 'layak']",3,3,0,aplikasi tidak layak,3,3
Sangat membantu,positif,2021-03-12,2021,sangat membantu,2,2,sangat membantu,2,2,"['sangat', 'membantu']",['membantu'],2,1,1,bantu,1,1
Sangat memuaskan,positif,2022-05-27,2022,sangat memuaskan,2,2,sangat memuaskan,2,2,"['sangat', 'memuaskan']",['memuaskan'],2,1,1,muas,1,1
Sangat membantu,positif,2021-06-14,2021,sangat membantu,2,2,sangat membantu,2,2,"['sangat', 'membantu']",['membantu'],2,1,1,bantu,1,1
Sangat bangus untuk menbangun relasi,positif,2020-12-20,2020,sangat bangus untuk menbangun relasi,5,5,sangat bangus untuk menbangun relasi,5,5,"['sangat', 'bangus', 'untuk', 'menbangun', 'relasi']","['bangus', 'menbangun', 'relasi']",5,3,2,bangus menbangun relasi,3,3
Sangat membantu,positif,2021-09-15,2021,sangat membantu,2,2,sangat membantu,2,2,"['sangat', 'membantu']",['membantu'],2,1,1,bantu,1,1
Muter2 diverifikasi nomer,negatif,2022-11-27,2022,muter diverifikasi nomer,3,3,memutar diverifikasi nomor,3,3,"['memutar', 'diverifikasi', 'nomor']","['memutar', 'diverifikasi', 'nomor']",3,3,0,putar verifikasi nomor,3,3
Untuk saat ini bagus.,positif,2021-01-02,2021,untuk saat ini bagus,4,4,untuk saat ini bagus,4,4,"['untuk', 'saat', 'ini', 'bagus']",['bagus'],4,1,3,bagus,1,1
Sangat membantu,positif,2020-07-30,2020,sangat membantu,2,2,sangat membantu,2,2,"['sangat', 'membantu']",['membantu'],2,1,1,bantu,1,1
Captcha lu susah banget woiiii,negatif,2023-12-04,2023,captcha lu susah banget woiiii,5,5,captcha lu susah banget woiiii,5,5,"['captcha', 'lu', 'susah', 'banget', 'woiiii']","['captcha', 'lu', 'susah', 'banget', 'woiiii']",5,5,0,captcha lu susah banget woiiii,5,5
Baik dan bagus.,positif,2020-06-02,2020,baik dan bagus,3,3,baik dan bagus,3,3,"['baik', 'dan', 'bagus']",['bagus'],3,1,2,bagus,1,1
Cukup banyak info nya,positif,2024-01-27,2024,cukup banyak info nya,4,4,cukup banyak informasi nya,4,4,"['cukup', 'banyak', 'informasi', 'nya']","['informasi', 'nya']",4,2,2,informasi nya,2,2
Sangat membantu,positif,2021-06-06,2021,sangat membantu,2,2,sangat membantu,2,2,"['sangat', 'membantu']",['membantu'],2,1,1,bantu,1,1
Bagus dan bermanfaat,positif,2021-06-15,2021,bagus dan bermanfaat,3,3,bagus dan bermanfaat,3,3,"['bagus', 'dan', 'bermanfaat']","['bagus', 'bermanfaat']",3,2,1,bagus manfaat,2,2
Sangat membantu,positif,2020-06-21,2020,sangat membantu,2,2,sangat membantu,2,2,"['sangat', 'membantu']",['membantu'],2,1,1,bantu,1,1
Sangat membantu,positif,2020-01-03,2020,sangat membantu,2,2,sangat membantu,2,2,"['sangat', 'membantu']",['membantu'],2,1,1,bantu,1,1
Sangat bermanfaat,positif,2020-10-30,2020,sangat bermanfaat,2,2,sangat bermanfaat,2,2,"['sangat', 'bermanfaat']",['bermanfaat'],2,1,1,manfaat,1,1
Sangat bermanfaat,positif,2022-11-29,2022,sangat bermanfaat,2,2,sangat bermanfaat,2,2,"['sangat', 'bermanfaat']",['bermanfaat'],2,1,1,manfaat,1,1
"Woi knp akun gw dibatasi, pdhl ga ngapa ngaapin",negatif,2023-08-20,2023,woi knp akun gw dibatasi pdhl ga ngapa ngaapin,9,9,woi kenapa akun saya dibatasi padahal tidak ngapa ngaapin,9,9,"['woi', 'kenapa', 'akun', 'saya', 'dibatasi', 'padahal', 'tidak', 'ngapa', 'ngaapin']","['woi', 'akun', 'dibatasi', 'tidak', 'ngapa', 'ngaapin']",9,6,3,woi akun batas tidak ngapa ngaapin,6,6
Sekarang Pencarian dibatasi,negatif,2021-12-07,2021,sekarang pencarian dibatasi,3,3,sekarang pencarian dibatasi,3,3,"['sekarang', 'pencarian', 'dibatasi']","['pencarian', 'dibatasi']",3,2,1,cari batas,2,2
Luar biasa aplikasinya,positif,2021-06-20,2021,luar biasa aplikasinya,3,3,luar biasa aplikasi nya,3,4,"['luar', 'biasa', 'aplikasi', 'nya']","['aplikasi', 'nya']",4,2,2,aplikasi nya,2,2
+ informasi + kawan + rezeki🤝,positif,2021-05-06,2021,informasi kawan rezeki,6,3,informasi kawan rezeki,3,3,"['informasi', 'kawan', 'rezeki']","['informasi', 'kawan', 'rezeki']",3,3,0,informasi kawan rezeki,3,3
Sangat membantu,positif,2021-02-02,2021,sangat membantu,2,2,sangat membantu,2,2,"['sangat', 'membantu']",['membantu'],2,1,1,bantu,1,1
Susah masuk ny,negatif,2024-03-18,2024,susah masuk ny,3,3,susah masuk nya,3,3,"['susah', 'masuk', 'nya']","['susah', 'masuk', 'nya']",3,3,0,susah masuk nya,3,3
Bagus sekali,positif,2024-03-18,2024,bagus sekali,2,2,bagus sekali,2,2,"['bagus', 'sekali']",['bagus'],2,1,1,bagus,1,1
Sangat membantu,positif,2021-08-21,2021,sangat membantu,2,2,sangat membantu,2,2,"['sangat', 'membantu']",['membantu'],2,1,1,bantu,1,1
Sangat membantu,positif,2021-03-09,2021,sangat membantu,2,2,sangat membantu,2,2,"['sangat', 'membantu']",['membantu'],2,1,1,bantu,1,1
Sangat bermanfaat,positif,2021-02-17,2021,sangat bermanfaat,2,2,sangat bermanfaat,2,2,"['sangat', 'bermanfaat']",['bermanfaat'],2,1,1,manfaat,1,1
Sangat membantu,positif,2024-01-05,2024,sangat membantu,2,2,sangat membantu,2,2,"['sangat', 'membantu']",['membantu'],2,1,1,bantu,1,1
Sangat membantu,positif,2022-03-03,2022,sangat membantu,2,2,sangat membantu,2,2,"['sangat', 'membantu']",['membantu'],2,1,1,bantu,1,1
Aplikasi ini bagus,positif,2021-04-14,2021,aplikasi ini bagus,3,3,aplikasi ini bagus,3,3,"['aplikasi', 'ini', 'bagus']","['aplikasi', 'bagus']",3,2,1,aplikasi bagus,2,2
aplikasi yang terbaik,positif,2021-03-14,2021,aplikasi yang terbaik,3,3,aplikasi yang terbaik,3,3,"['aplikasi', 'yang', 'terbaik']","['aplikasi', 'terbaik']",3,2,1,aplikasi baik,2,2
Sangat membantu,positif,2020-08-24,2020,sangat membantu,2,2,sangat membantu,2,2,"['sangat', 'membantu']",['membantu'],2,1,1,bantu,1,1
Ga guna buat saya app nya,negatif,2021-10-10,2021,ga guna buat saya app nya,6,6,tidak guna buat saya aplikasi nya,6,6,"['tidak', 'guna', 'buat', 'saya', 'aplikasi', 'nya']","['tidak', 'aplikasi', 'nya']",6,3,3,tidak aplikasi nya,3,3
Buat cari kerja,positif,2020-04-11,2020,buat cari kerja,3,3,buat cari kerja,3,3,"['buat', 'cari', 'kerja']","['cari', 'kerja']",3,2,1,cari kerja,2,2
Sangat membantu,positif,2021-10-11,2021,sangat membantu,2,2,sangat membantu,2,2,"['sangat', 'membantu']",['membantu'],2,1,1,bantu,1,1
Terima kasih infonya,positif,2020-07-04,2020,terima kasih infonya,3,3,terima kasih informasinya,3,3,"['terima', 'kasih', 'informasinya']","['terima', 'kasih', 'informasinya']",3,3,0,terima kasih informasi,3,3
Apk loker terbaik,positif,2023-06-21,2023,apk loker terbaik,3,3,aplikasi loker terbaik,3,3,"['aplikasi', 'loker', 'terbaik']","['aplikasi', 'loker', 'terbaik']",3,3,0,aplikasi loker baik,3,3
Banyak menyambung persahabatan..,positif,2020-11-11,2020,banyak menyambung persahabatan,3,3,banyak menyambung persahabatan,3,3,"['banyak', 'menyambung', 'persahabatan']","['menyambung', 'persahabatan']",3,2,1,sambung sahabat,2,2
Sangat membantu.,positif,2022-08-18,2022,sangat membantu,2,2,sangat membantu,2,2,"['sangat', 'membantu']",['membantu'],2,1,1,bantu,1,1
Sangat membantu,positif,2020-09-09,2020,sangat membantu,2,2,sangat membantu,2,2,"['sangat', 'membantu']",['membantu'],2,1,1,bantu,1,1
sangat membantu,positif,2020-06-08,2020,sangat membantu,2,2,sangat membantu,2,2,"['sangat', 'membantu']",['membantu'],2,1,1,bantu,1,1
Aplikasi ini sangat bagus,positif,2021-04-07,2021,aplikasi ini sangat bagus,4,4,aplikasi ini sangat bagus,4,4,"['aplikasi', 'ini', 'sangat', 'bagus']","['aplikasi', 'bagus']",4,2,2,aplikasi bagus,2,2
Saya suka aplikasi ini juga,positif,2023-01-07,2023,saya suka aplikasi ini juga,5,5,saya suka aplikasi ini juga,5,5,"['saya', 'suka', 'aplikasi', 'ini', 'juga']","['suka', 'aplikasi']",5,2,3,suka aplikasi,2,2
Sangat membantu,positif,2022-01-25,2022,sangat membantu,2,2,sangat membantu,2,2,"['sangat', 'membantu']",['membantu'],2,1,1,bantu,1,1
Captcha tidak ramah,negatif,2023-01-09,2023,captcha tidak ramah,3,3,captcha tidak ramah,3,3,"['captcha', 'tidak', 'ramah']","['captcha', 'tidak', 'ramah']",3,3,0,captcha tidak ramah,3,3
Sangat membantu,positif,2020-06-04,2020,sangat membantu,2,2,sangat membantu,2,2,"['sangat', 'membantu']",['membantu'],2,1,1,bantu,1,1
Membantu dan manfaat,positif,2023-02-26,2023,membantu dan manfaat,3,3,membantu dan manfaat,3,3,"['membantu', 'dan', 'manfaat']","['membantu', 'manfaat']",3,2,1,bantu manfaat,2,2
Gk jelas LinkedIn ini udah Berkali-kali akun Saya Di blokir,negatif,2022-10-20,2022,gk jelas linkedin ini udah berkali kali akun saya di blokir,10,11,tidak jelas linkedin ini sudah berkali kali akun saya di blokir,11,11,"['tidak', 'jelas', 'linkedin', 'ini', 'sudah', 'berkali', 'kali', 'akun', 'saya', 'di', 'blokir']","['tidak', 'linkedin', 'berkali', 'kali', 'akun', 'blokir']",11,6,5,tidak linkedin kali kali akun blokir,6,6
susah dimengerti,negatif,2021-11-17,2021,susah dimengerti,2,2,susah dimengerti,2,2,"['susah', 'dimengerti']","['susah', 'dimengerti']",2,2,0,susah erti,2,2
Daftarnya susah nian,negatif,2024-04-19,2024,daftarnya susah nian,3,3,daftarnya susah nian,3,3,"['daftarnya', 'susah', 'nian']","['daftarnya', 'susah', 'nian']",3,3,0,daftar susah nian,3,3
Sangat luar biasa,positif,2022-01-28,2022,sangat luar biasa,3,3,sangat luar biasa,3,3,"['sangat', 'luar', 'biasa']",[],3,1,2,,1,0
Sangat membantu,positif,2024-04-21,2024,sangat membantu,2,2,sangat membantu,2,2,"['sangat', 'membantu']",['membantu'],2,1,1,bantu,1,1
Login aja g bisa,negatif,2022-10-21,2022,login aja g bisa,4,4,login saja tidak bisa,4,4,"['login', 'saja', 'tidak', 'bisa']","['login', 'tidak']",4,2,2,login tidak,2,2
Aplikasi ini sangat membantu saya,positif,2020-12-13,2020,aplikasi ini sangat membantu saya,5,5,aplikasi ini sangat membantu saya,5,5,"['aplikasi', 'ini', 'sangat', 'membantu', 'saya']","['aplikasi', 'membantu']",5,2,3,aplikasi bantu,2,2
Aplikasi ini sangat membantu,positif,2020-06-24,2020,aplikasi ini sangat membantu,4,4,aplikasi ini sangat membantu,4,4,"['aplikasi', 'ini', 'sangat', 'membantu']","['aplikasi', 'membantu']",4,2,2,aplikasi bantu,2,2
"Semoga dapat kerjaan, saya nya",positif,2020-03-19,2020,semoga dapat kerjaan saya nya,5,5,semoga dapat kerjaan saya nya,5,5,"['semoga', 'dapat', 'kerjaan', 'saya', 'nya']","['semoga', 'kerjaan', 'nya']",5,3,2,moga kerja nya,3,3
Aplikasi yang keren,positif,2020-06-23,2020,aplikasi yang keren,3,3,aplikasi yang keren,3,3,"['aplikasi', 'yang', 'keren']","['aplikasi', 'keren']",3,2,1,aplikasi keren,2,2
Sangat membantu,positif,2023-02-02,2023,sangat membantu,2,2,sangat membantu,2,2,"['sangat', 'membantu']",['membantu'],2,1,1,bantu,1,1
Sangat membantu,positif,2020-11-14,2020,sangat membantu,2,2,sangat membantu,2,2,"['sangat', 'membantu']",['membantu'],2,1,1,bantu,1,1
Sangat membantu,positif,2020-04-02,2020,sangat membantu,2,2,sangat membantu,2,2,"['sangat', 'membantu']",['membantu'],2,1,1,bantu,1,1
Sangat membantu,positif,2020-08-22,2020,sangat membantu,2,2,sangat membantu,2,2,"['sangat', 'membantu']",['membantu'],2,1,1,bantu,1,1
Semoga bisa membantu mencari kerja,positif,2023-07-14,2023,semoga bisa membantu mencari kerja,5,5,semoga bisa membantu mencari kerja,5,5,"['semoga', 'bisa', 'membantu', 'mencari', 'kerja']","['semoga', 'membantu', 'mencari', 'kerja']",5,4,1,moga bantu cari kerja,4,4
Dimana ada ke mauan di situ ada jalan... Perjuangan tidak akan menghianati hasil. 😇😊😉,positif,2022-05-28,2022,dimana ada ke mauan di situ ada jalan perjuangan tidak akan menghianati hasil,14,13,dimana ada ke mauan di situ ada jalan perjuangan tidak akan menghianati hasil,13,13,"['dimana', 'ada', 'ke', 'mauan', 'di', 'situ', 'ada', 'jalan', 'perjuangan', 'tidak', 'akan', 'menghianati', 'hasil']","['dimana', 'mauan', 'situ', 'jalan', 'perjuangan', 'tidak', 'menghianati', 'hasil']",13,8,5,mana mau situ jalan juang tidak menghianati hasil,8,8
Luar biasa manfaatnya,positif,2021-09-17,2021,luar biasa manfaatnya,3,3,luar biasa manfaatnya,3,3,"['luar', 'biasa', 'manfaatnya']",['manfaatnya'],3,1,2,manfaat,1,1
verifikasi nya gajelas,negatif,2022-11-16,2022,verifikasi nya gajelas,3,3,verifikasi nya tidak jelas,3,4,"['verifikasi', 'nya', 'tidak', 'jelas']","['verifikasi', 'nya', 'tidak']",4,3,1,verifikasi nya tidak,3,3
Sangat membantu,positif,2022-07-14,2022,sangat membantu,2,2,sangat membantu,2,2,"['sangat', 'membantu']",['membantu'],2,1,1,bantu,1,1
Mau Login Di Bikin Susah Nih Aplikasi,negatif,2024-01-16,2024,mau login di bikin susah nih aplikasi,7,7,mau login di bikin susah nih aplikasi,7,7,"['mau', 'login', 'di', 'bikin', 'susah', 'nih', 'aplikasi']","['login', 'bikin', 'susah', 'nih', 'aplikasi']",7,5,2,login bikin susah nih aplikasi,5,5
Sangat membantu,positif,2022-02-01,2022,sangat membantu,2,2,sangat membantu,2,2,"['sangat', 'membantu']",['membantu'],2,1,1,bantu,1,1
Sangat bermanfaat,positif,2020-07-14,2020,sangat bermanfaat,2,2,sangat bermanfaat,2,2,"['sangat', 'bermanfaat']",['bermanfaat'],2,1,1,manfaat,1,1
Sangat memuaskan sekali...,positif,2023-05-25,2023,sangat memuaskan sekali,3,3,sangat memuaskan sekali,3,3,"['sangat', 'memuaskan', 'sekali']",['memuaskan'],3,1,2,muas,1,1
Sangat membantu,positif,2022-01-22,2022,sangat membantu,2,2,sangat membantu,2,2,"['sangat', 'membantu']",['membantu'],2,1,1,bantu,1,1
Ngak bisa verifikasi...,negatif,2021-11-11,2021,ngak bisa verifikasi,3,3,tidak bisa verifikasi,3,3,"['tidak', 'bisa', 'verifikasi']","['tidak', 'verifikasi']",3,2,1,tidak verifikasi,2,2
Bagus sngat membantu,positif,2020-10-02,2020,bagus sngat membantu,3,3,bagus sangat membantu,3,3,"['bagus', 'sangat', 'membantu']","['bagus', 'membantu']",3,2,1,bagus bantu,2,2
Sangat bermanfaat,positif,2021-08-26,2021,sangat bermanfaat,2,2,sangat bermanfaat,2,2,"['sangat', 'bermanfaat']",['bermanfaat'],2,1,1,manfaat,1,1
Sangat membantu,positif,2020-03-03,2020,sangat membantu,2,2,sangat membantu,2,2,"['sangat', 'membantu']",['membantu'],2,1,1,bantu,1,1
Sangat membantu,positif,2022-01-05,2022,sangat membantu,2,2,sangat membantu,2,2,"['sangat', 'membantu']",['membantu'],2,1,1,bantu,1,1
Mantap untuk bisnis,positif,2021-01-02,2021,mantap untuk bisnis,3,3,mantap untuk bisnis,3,3,"['mantap', 'untuk', 'bisnis']","['mantap', 'bisnis']",3,2,1,mantap bisnis,2,2
Ga bisa login,negatif,2023-11-27,2023,ga bisa login,3,3,tidak bisa login,3,3,"['tidak', 'bisa', 'login']","['tidak', 'login']",3,2,1,tidak login,2,2
Keren Utk Aplikasi Informasi Kerjannya,positif,2022-05-16,2022,keren utk aplikasi informasi kerjannya,5,5,keren untuk aplikasi informasi kerjannya,5,5,"['keren', 'untuk', 'aplikasi', 'informasi', 'kerjannya']","['keren', 'aplikasi', 'informasi', 'kerjannya']",5,4,1,keren aplikasi informasi kerjannya,4,4
Sangat bermanfaat,positif,2020-07-30,2020,sangat bermanfaat,2,2,sangat bermanfaat,2,2,"['sangat', 'bermanfaat']",['bermanfaat'],2,1,1,manfaat,1,1
Bagus banget aplikasinya. . .,positif,2021-11-23,2021,bagus banget aplikasinya,5,3,bagus banget aplikasi nya,3,4,"['bagus', 'banget', 'aplikasi', 'nya']","['bagus', 'banget', 'aplikasi', 'nya']",4,4,0,bagus banget aplikasi nya,4,4
Sangat membantu,positif,2023-02-25,2023,sangat membantu,2,2,sangat membantu,2,2,"['sangat', 'membantu']",['membantu'],2,1,1,bantu,1,1
Sangat membantu,positif,2023-01-24,2023,sangat membantu,2,2,sangat membantu,2,2,"['sangat', 'membantu']",['membantu'],2,1,1,bantu,1,1
Sangat membantu,positif,2021-08-25,2021,sangat membantu,2,2,sangat membantu,2,2,"['sangat', 'membantu']",['membantu'],2,1,1,bantu,1,1
Tetap susah cari kerja,negatif,2022-06-12,2022,tetap susah cari kerja,4,4,tetap susah cari kerja,4,4,"['tetap', 'susah', 'cari', 'kerja']","['susah', 'cari', 'kerja']",4,3,1,susah cari kerja,3,3
Cukup memuaskan,positif,2021-12-07,2021,cukup memuaskan,2,2,cukup memuaskan,2,2,"['cukup', 'memuaskan']",['memuaskan'],2,1,1,muas,1,1
Menjalin keseluruh dunia teman² bisnis melalui Linkedin 👍👍👍,positif,2021-04-23,2021,menjalin keseluruh dunia teman² bisnis melalui linkedin,8,7,menjalin keseluruh dunia teman² bisnis melalui linkedin,7,7,"['menjalin', 'keseluruh', 'dunia', 'teman²', 'bisnis', 'melalui', 'linkedin']","['menjalin', 'keseluruh', 'dunia', 'teman²', 'bisnis', 'linkedin']",7,6,1,jalin seluruh dunia teman bisnis linkedin,6,6
Ruang lingkup yg luas 👍,positif,2023-05-30,2023,ruang lingkup yg luas,5,4,ruang lingkup yang luas,4,4,"['ruang', 'lingkup', 'yang', 'luas']","['ruang', 'lingkup', 'luas']",4,3,1,ruang lingkup luas,3,3
Sangat keren banget,positif,2022-10-24,2022,sangat keren banget,3,3,sangat keren banget,3,3,"['sangat', 'keren', 'banget']","['keren', 'banget']",3,2,1,keren banget,2,2
Sangat membantu,positif,2021-03-10,2021,sangat membantu,2,2,sangat membantu,2,2,"['sangat', 'membantu']",['membantu'],2,1,1,bantu,1,1
Ado aplikasi parah sekali,negatif,2021-04-16,2021,ado aplikasi parah sekali,4,4,ado aplikasi parah sekali,4,4,"['ado', 'aplikasi', 'parah', 'sekali']","['ado', 'aplikasi', 'parah']",4,3,1,ado aplikasi parah,3,3
Sangat membantu,positif,2020-10-23,2020,sangat membantu,2,2,sangat membantu,2,2,"['sangat', 'membantu']",['membantu'],2,1,1,bantu,1,1
Aplikasi yg bagus,positif,2020-12-18,2020,aplikasi yg bagus,3,3,aplikasi yang bagus,3,3,"['aplikasi', 'yang', 'bagus']","['aplikasi', 'bagus']",3,2,1,aplikasi bagus,2,2
"ok, semoga yang terbaik ...",positif,2022-09-28,2022,ok semoga yang terbaik,5,4,oke semoga yang terbaik,4,4,"['oke', 'semoga', 'yang', 'terbaik']","['oke', 'semoga', 'terbaik']",4,3,1,oke moga baik,3,3
Bagus aplikasinya,positif,2022-08-10,2022,bagus aplikasinya,2,2,bagus aplikasi nya,2,3,"['bagus', 'aplikasi', 'nya']","['bagus', 'aplikasi', 'nya']",3,3,0,bagus aplikasi nya,3,3
Sangat menggangu saya,negatif,2024-06-14,2024,sangat menggangu saya,3,3,sangat menggangu saya,3,3,"['sangat', 'menggangu', 'saya']",['menggangu'],3,1,2,menggangu,1,1
Mantaaàp dan sangat membantu saya,positif,2021-05-24,2021,mantaaàp dan sangat membantu saya,5,5,mantaaàp dan sangat membantu saya,5,5,"['mantaaàp', 'dan', 'sangat', 'membantu', 'saya']","['mantaaàp', 'membantu']",5,2,3,mantaa p bantu,2,3
Saya suka informadi ini,positif,2020-06-15,2020,saya suka informadi ini,4,4,saya suka informadi ini,4,4,"['saya', 'suka', 'informadi', 'ini']","['suka', 'informadi']",4,2,2,suka informadi,2,2
Sangat membantu,positif,2020-05-24,2020,sangat membantu,2,2,sangat membantu,2,2,"['sangat', 'membantu']",['membantu'],2,1,1,bantu,1,1
Sangat membantu,positif,2022-08-05,2022,sangat membantu,2,2,sangat membantu,2,2,"['sangat', 'membantu']",['membantu'],2,1,1,bantu,1,1
Manfaat Menambah koneksi,positif,2021-03-14,2021,manfaat menambah koneksi,3,3,manfaat menambah koneksi,3,3,"['manfaat', 'menambah', 'koneksi']","['manfaat', 'menambah', 'koneksi']",3,3,0,manfaat tambah koneksi,3,3
Iklan lu ganggu,negatif,2024-06-14,2024,iklan lu ganggu,3,3,iklan lu ganggu,3,3,"['iklan', 'lu', 'ganggu']","['iklan', 'lu', 'ganggu']",3,3,0,iklan lu ganggu,3,3
Security check yang tidak manusiawi,negatif,2024-02-11,2024,security check yang tidak manusiawi,5,5,security cek yang tidak manusiawi,5,5,"['security', 'cek', 'yang', 'tidak', 'manusiawi']","['security', 'cek', 'tidak', 'manusiawi']",5,4,1,security cek tidak manusiawi,4,4
Sangat bermanfaat,positif,2022-05-01,2022,sangat bermanfaat,2,2,sangat bermanfaat,2,2,"['sangat', 'bermanfaat']",['bermanfaat'],2,1,1,manfaat,1,1
Sangat membantu,positif,2023-07-27,2023,sangat membantu,2,2,sangat membantu,2,2,"['sangat', 'membantu']",['membantu'],2,1,1,bantu,1,1
Semoga melalui ini bs menjawab kantong gue,positif,2020-11-12,2020,semoga melalui ini bs menjawab kantong gue,7,7,semoga melalui ini bisa menjawab kantong saya,7,7,"['semoga', 'melalui', 'ini', 'bisa', 'menjawab', 'kantong', 'saya']","['semoga', 'kantong']",7,2,5,moga kantong,2,2
Sangat membantu,positif,2021-04-21,2021,sangat membantu,2,2,sangat membantu,2,2,"['sangat', 'membantu']",['membantu'],2,1,1,bantu,1,1
Aflikasi bagus buat masyarakat,positif,2020-06-19,2020,aflikasi bagus buat masyarakat,4,4,aflikasi bagus buat masyarakat,4,4,"['aflikasi', 'bagus', 'buat', 'masyarakat']","['aflikasi', 'bagus', 'masyarakat']",4,3,1,aflikasi bagus masyarakat,3,3
Sangat membantu,positif,2023-06-20,2023,sangat membantu,2,2,sangat membantu,2,2,"['sangat', 'membantu']",['membantu'],2,1,1,bantu,1,1
Mudah dalam melamar pekerjaan,positif,2021-07-12,2021,mudah dalam melamar pekerjaan,4,4,mudah dalam melamar pekerjaan,4,4,"['mudah', 'dalam', 'melamar', 'pekerjaan']","['mudah', 'melamar', 'pekerjaan']",4,3,1,mudah lamar kerja,3,3
Sangat membantu 😊,positif,2021-03-08,2021,sangat membantu,3,2,sangat membantu,2,2,"['sangat', 'membantu']",['membantu'],2,1,1,bantu,1,1
Semoga bisa membantu kami dari segala hal.,positif,2024-02-07,2024,semoga bisa membantu kami dari segala hal,7,7,semoga bisa membantu kami dari segala hal,7,7,"['semoga', 'bisa', 'membantu', 'kami', 'dari', 'segala', 'hal']","['semoga', 'membantu']",7,2,5,moga bantu,2,2
Sangat membantu,positif,2020-09-17,2020,sangat membantu,2,2,sangat membantu,2,2,"['sangat', 'membantu']",['membantu'],2,1,1,bantu,1,1
Sangat membantu,positif,2020-03-02,2020,sangat membantu,2,2,sangat membantu,2,2,"['sangat', 'membantu']",['membantu'],2,1,1,bantu,1,1
Sangat membantu,positif,2021-06-23,2021,sangat membantu,2,2,sangat membantu,2,2,"['sangat', 'membantu']",['membantu'],2,1,1,bantu,1,1
Bagus Bagus Bagus,positif,2020-11-24,2020,bagus bagus bagus,3,3,bagus bagus bagus,3,3,"['bagus', 'bagus', 'bagus']","['bagus', 'bagus', 'bagus']",3,3,0,bagus bagus bagus,3,3
Sangat membantu🙏👍👍,positif,2022-11-09,2022,sangat membantu,2,2,sangat membantu,2,2,"['sangat', 'membantu']",['membantu'],2,1,1,bantu,1,1
Ga bisa login 🥲,negatif,2023-08-10,2023,ga bisa login,4,3,tidak bisa login,3,3,"['tidak', 'bisa', 'login']","['tidak', 'login']",3,2,1,tidak login,2,2
Sangat membantu,positif,2022-05-19,2022,sangat membantu,2,2,sangat membantu,2,2,"['sangat', 'membantu']",['membantu'],2,1,1,bantu,1,1
apk yang sangat bagus,positif,2021-03-19,2021,apk yang sangat bagus,4,4,aplikasi yang sangat bagus,4,4,"['aplikasi', 'yang', 'sangat', 'bagus']","['aplikasi', 'bagus']",4,2,2,aplikasi bagus,2,2
Sangat membantu,positif,2022-08-23,2022,sangat membantu,2,2,sangat membantu,2,2,"['sangat', 'membantu']",['membantu'],2,1,1,bantu,1,1
Siap lanjutkan good,positif,2020-06-20,2020,siap lanjutkan good,3,3,siap lanjutkan bagus,3,3,"['siap', 'lanjutkan', 'bagus']","['lanjutkan', 'bagus']",3,2,1,lanjut bagus,2,2
Situs erorrrrrr terus,negatif,2021-01-08,2021,situs erorrrrrr terus,3,3,situs erorrrrrr terus,3,3,"['situs', 'erorrrrrr', 'terus']","['situs', 'erorrrrrr']",3,2,1,situs erorrrrrr,2,2
Sangat bermanfaat,positif,2021-02-22,2021,sangat bermanfaat,2,2,sangat bermanfaat,2,2,"['sangat', 'bermanfaat']",['bermanfaat'],2,1,1,manfaat,1,1
Coba dulu yg ini siapa tau bermanfaat bagi tugas saya,positif,2022-08-23,2022,coba dulu yg ini siapa tau bermanfaat bagi tugas saya,10,10,coba dahulu yang ini siapa tahu bermanfaat bagi tugas saya,10,10,"['coba', 'dahulu', 'yang', 'ini', 'siapa', 'tahu', 'bermanfaat', 'bagi', 'tugas', 'saya']","['coba', 'bermanfaat', 'tugas']",10,3,7,coba manfaat tugas,3,3
Sangat membantu,positif,2022-04-15,2022,sangat membantu,2,2,sangat membantu,2,2,"['sangat', 'membantu']",['membantu'],2,1,1,bantu,1,1
Sangat membantu,positif,2020-06-10,2020,sangat membantu,2,2,sangat membantu,2,2,"['sangat', 'membantu']",['membantu'],2,1,1,bantu,1,1
Terima kasih banyak atas bantuannya,positif,2021-10-22,2021,terima kasih banyak atas bantuannya,5,5,terima kasih banyak atas bantuannya,5,5,"['terima', 'kasih', 'banyak', 'atas', 'bantuannya']","['terima', 'kasih', 'bantuannya']",5,3,2,terima kasih bantu,3,3
Aplikasi yg bagus,positif,2020-06-22,2020,aplikasi yg bagus,3,3,aplikasi yang bagus,3,3,"['aplikasi', 'yang', 'bagus']","['aplikasi', 'bagus']",3,2,1,aplikasi bagus,2,2
sangat membantu,positif,2020-07-12,2020,sangat membantu,2,2,sangat membantu,2,2,"['sangat', 'membantu']",['membantu'],2,1,1,bantu,1,1
Bagus buat referensi,positif,2023-11-22,2023,bagus buat referensi,3,3,bagus buat referensi,3,3,"['bagus', 'buat', 'referensi']","['bagus', 'referensi']",3,2,1,bagus referensi,2,2
Gajelas mau login malah verif muli,negatif,2022-06-15,2022,gajelas mau login malah verif muli,6,6,tidak jelas mau login bahkan verif muli,6,7,"['tidak', 'jelas', 'mau', 'login', 'bahkan', 'verif', 'muli']","['tidak', 'login', 'verif', 'muli']",7,4,3,tidak login verif muli,4,4
Semoga lelah ku menjadi nilai ibadah,positif,2020-12-02,2020,semoga lelah ku menjadi nilai ibadah,6,6,semoga lelah saya menjadi nilai ibadah,6,6,"['semoga', 'lelah', 'saya', 'menjadi', 'nilai', 'ibadah']","['semoga', 'lelah', 'nilai', 'ibadah']",6,4,2,moga lelah nilai ibadah,4,4
Keren keren keren💥💥💥💥💥💥💥,positif,2020-08-01,2020,keren keren keren,3,3,keren keren keren,3,3,"['keren', 'keren', 'keren']","['keren', 'keren', 'keren']",3,3,0,keren keren keren,3,3
Sangat bermanfaat,positif,2021-04-30,2021,sangat bermanfaat,2,2,sangat bermanfaat,2,2,"['sangat', 'bermanfaat']",['bermanfaat'],2,1,1,manfaat,1,1
Mendapatkan pengalaman yang berbeda,positif,2020-06-07,2020,mendapatkan pengalaman yang berbeda,4,4,mendapatkan pengalaman yang berbeda,4,4,"['mendapatkan', 'pengalaman', 'yang', 'berbeda']","['pengalaman', 'berbeda']",4,2,2,alam beda,2,2
Login aja dipersulit ktl,negatif,2024-08-08,2024,login aja dipersulit ktl,4,4,login saja dipersulit ktl,4,4,"['login', 'saja', 'dipersulit', 'ktl']","['login', 'dipersulit', 'ktl']",4,3,1,login sulit ktl,3,3
Sangat membantu,positif,2021-03-05,2021,sangat membantu,2,2,sangat membantu,2,2,"['sangat', 'membantu']",['membantu'],2,1,1,bantu,1,1
Sangat membantu,positif,2021-12-31,2021,sangat membantu,2,2,sangat membantu,2,2,"['sangat', 'membantu']",['membantu'],2,1,1,bantu,1,1
Sangat bermanfaat,positif,2024-01-22,2024,sangat bermanfaat,2,2,sangat bermanfaat,2,2,"['sangat', 'bermanfaat']",['bermanfaat'],2,1,1,manfaat,1,1
Sangat membantu,positif,2021-07-29,2021,sangat membantu,2,2,sangat membantu,2,2,"['sangat', 'membantu']",['membantu'],2,1,1,bantu,1,1
Sangat bermanfaat,positif,2021-08-12,2021,sangat bermanfaat,2,2,sangat bermanfaat,2,2,"['sangat', 'bermanfaat']",['bermanfaat'],2,1,1,manfaat,1,1
Sangat bermanfaat,positif,2020-04-01,2020,sangat bermanfaat,2,2,sangat bermanfaat,2,2,"['sangat', 'bermanfaat']",['bermanfaat'],2,1,1,manfaat,1,1
Sangat membantu,positif,2021-05-08,2021,sangat membantu,2,2,sangat membantu,2,2,"['sangat', 'membantu']",['membantu'],2,1,1,bantu,1,1
Kedepan semakin lebih baik,positif,2021-12-15,2021,kedepan semakin lebih baik,4,4,kedepan semakin lebih baik,4,4,"['kedepan', 'semakin', 'lebih', 'baik']",['kedepan'],4,1,3,depan,1,1
Sangat membantu,positif,2020-02-17,2020,sangat membantu,2,2,sangat membantu,2,2,"['sangat', 'membantu']",['membantu'],2,1,1,bantu,1,1
Sangat membantu,positif,2021-05-27,2021,sangat membantu,2,2,sangat membantu,2,2,"['sangat', 'membantu']",['membantu'],2,1,1,bantu,1,1
verifikasi nya gak jelas,negatif,2023-05-19,2023,verifikasi nya gak jelas,4,4,verifikasi nya tidak jelas,4,4,"['verifikasi', 'nya', 'tidak', 'jelas']","['verifikasi', 'nya', 'tidak']",4,3,1,verifikasi nya tidak,3,3
Buat menambah wawasan,positif,2021-03-12,2021,buat menambah wawasan,3,3,buat menambah wawasan,3,3,"['buat', 'menambah', 'wawasan']","['menambah', 'wawasan']",3,2,1,tambah wawas,2,2
Menjalin banyak relasi,positif,2021-09-01,2021,menjalin banyak relasi,3,3,menjalin banyak relasi,3,3,"['menjalin', 'banyak', 'relasi']","['menjalin', 'relasi']",3,2,1,jalin relasi,2,2
Sangat membantu,positif,2020-04-21,2020,sangat membantu,2,2,sangat membantu,2,2,"['sangat', 'membantu']",['membantu'],2,1,1,bantu,1,1
Aku suka aplikasi ini,positif,2021-09-07,2021,aku suka aplikasi ini,4,4,aku suka aplikasi ini,4,4,"['aku', 'suka', 'aplikasi', 'ini']","['suka', 'aplikasi']",4,2,2,suka aplikasi,2,2
Kenapa akun saya nonaktif ?,negatif,2021-11-08,2021,kenapa akun saya nonaktif,5,4,kenapa akun saya nonaktif,4,4,"['kenapa', 'akun', 'saya', 'nonaktif']","['akun', 'nonaktif']",4,2,2,akun nonaktif,2,2
Ingin blajar dari linkedln,positif,2021-05-27,2021,ingin blajar dari linkedln,4,4,ingin blajar dari linkedln,4,4,"['ingin', 'blajar', 'dari', 'linkedln']","['blajar', 'linkedln']",4,2,2,blajar linkedln,2,2
Sangat membantu,positif,2023-10-19,2023,sangat membantu,2,2,sangat membantu,2,2,"['sangat', 'membantu']",['membantu'],2,1,1,bantu,1,1
Aplikasi sangat baik,positif,2021-08-28,2021,aplikasi sangat baik,3,3,aplikasi sangat baik,3,3,"['aplikasi', 'sangat', 'baik']",['aplikasi'],3,1,2,aplikasi,1,1
Kadang susah untuk daftar nya,positif,2020-04-15,2020,kadang susah untuk daftar nya,5,5,kadang susah untuk daftar nya,5,5,"['kadang', 'susah', 'untuk', 'daftar', 'nya']","['kadang', 'susah', 'daftar', 'nya']",5,4,1,kadang susah daftar nya,4,4
Sangat membantu,positif,2022-01-20,2022,sangat membantu,2,2,sangat membantu,2,2,"['sangat', 'membantu']",['membantu'],2,1,1,bantu,1,1
Terimakasih sangat bermamfaat.,positif,2022-01-05,2022,terimakasih sangat bermamfaat,3,3,terima kasih sangat bermamfaat,3,4,"['terima', 'kasih', 'sangat', 'bermamfaat']","['terima', 'kasih', 'bermamfaat']",4,3,1,terima kasih bermamfaat,3,3
Sangat membantu,positif,2022-11-30,2022,sangat membantu,2,2,sangat membantu,2,2,"['sangat', 'membantu']",['membantu'],2,1,1,bantu,1,1
Sangat membantu,positif,2023-02-11,2023,sangat membantu,2,2,sangat membantu,2,2,"['sangat', 'membantu']",['membantu'],2,1,1,bantu,1,1
"Akun gua malah di batasi,padahal GA ngapa in2",negatif,2023-05-24,2023,akun gua malah di batasi padahal ga ngapa in,8,9,akun saya bahkan di batasi padahal tidak ngapa in,9,9,"['akun', 'saya', 'bahkan', 'di', 'batasi', 'padahal', 'tidak', 'ngapa', 'in']","['akun', 'batasi', 'tidak', 'ngapa', 'in']",9,5,4,akun batas tidak ngapa in,5,5
Sangat membantu,positif,2022-01-12,2022,sangat membantu,2,2,sangat membantu,2,2,"['sangat', 'membantu']",['membantu'],2,1,1,bantu,1,1
Bismillah semoga bis tambah bermanfat kedepannya aamiin,positif,2020-11-06,2020,bismillah semoga bis tambah bermanfat kedepannya aamiin,7,7,bismillah semoga bis tambah bermanfat kedepannya aamiin,7,7,"['bismillah', 'semoga', 'bis', 'tambah', 'bermanfat', 'kedepannya', 'aamiin']","['bismillah', 'semoga', 'bis', 'bermanfat', 'kedepannya', 'aamiin']",7,6,1,bismillah moga bis bermanfat depan aamiin,6,6
Sangat membantu,positif,2022-04-07,2022,sangat membantu,2,2,sangat membantu,2,2,"['sangat', 'membantu']",['membantu'],2,1,1,bantu,1,1
Ini sangat bagus sekali,positif,2023-05-01,2023,ini sangat bagus sekali,4,4,ini sangat bagus sekali,4,4,"['ini', 'sangat', 'bagus', 'sekali']",['bagus'],4,1,3,bagus,1,1
Susah masuk verivikasi kya apaan tau pusing gue ngasin kouta ajh,negatif,2021-11-27,2021,susah masuk verivikasi kya apaan tau pusing gue ngasin kouta ajh,11,11,susah masuk verivikasi kya apa tahu pusing saya ngasin kouta saja,11,11,"['susah', 'masuk', 'verivikasi', 'kya', 'apa', 'tahu', 'pusing', 'saya', 'ngasin', 'kouta', 'saja']","['susah', 'masuk', 'verivikasi', 'kya', 'pusing', 'ngasin', 'kouta']",11,7,4,susah masuk verivikasi kya pusing ngasin kouta,7,7
Sangat bermamfaat,positif,2020-06-07,2020,sangat bermamfaat,2,2,sangat bermamfaat,2,2,"['sangat', 'bermamfaat']",['bermamfaat'],2,1,1,bermamfaat,1,1
Tingkatkan lagi...,positif,2021-05-31,2021,tingkatkan lagi,2,2,tingkatkan lagi,2,2,"['tingkatkan', 'lagi']",['tingkatkan'],2,1,1,tingkat,1,1
Baik dan ok👍,positif,2021-03-23,2021,baik dan ok,3,3,baik dan oke,3,3,"['baik', 'dan', 'oke']",['oke'],3,1,2,oke,1,1
Sangat membantu,positif,2022-07-29,2022,sangat membantu,2,2,sangat membantu,2,2,"['sangat', 'membantu']",['membantu'],2,1,1,bantu,1,1
"App.Bagus,semoga manfaat.",positif,2021-02-27,2021,app bagus semoga manfaat,2,4,aplikasi bagus semoga manfaat,4,4,"['aplikasi', 'bagus', 'semoga', 'manfaat']","['aplikasi', 'bagus', 'semoga', 'manfaat']",4,4,0,aplikasi bagus moga manfaat,4,4
Knp sih masuk aja susah bgt,negatif,2021-04-11,2021,knp sih masuk aja susah bgt,6,6,kenapa sih masuk saja susah banget,6,6,"['kenapa', 'sih', 'masuk', 'saja', 'susah', 'banget']","['sih', 'masuk', 'susah', 'banget']",6,4,2,sih masuk susah banget,4,4
Sangat berguna.,positif,2021-11-10,2021,sangat berguna,2,2,sangat berguna,2,2,"['sangat', 'berguna']",['berguna'],2,1,1,guna,1,1
Sangat membantu ...,positif,2020-03-17,2020,sangat membantu,3,2,sangat membantu,2,2,"['sangat', 'membantu']",['membantu'],2,1,1,bantu,1,1
Sangat membantu,positif,2021-12-03,2021,sangat membantu,2,2,sangat membantu,2,2,"['sangat', 'membantu']",['membantu'],2,1,1,bantu,1,1
Sangat membantu,positif,2021-03-13,2021,sangat membantu,2,2,sangat membantu,2,2,"['sangat', 'membantu']",['membantu'],2,1,1,bantu,1,1
Cukup membantu,positif,2021-10-13,2021,cukup membantu,2,2,cukup membantu,2,2,"['cukup', 'membantu']",['membantu'],2,1,1,bantu,1,1
Sangat berguna,positif,2024-04-21,2024,sangat berguna,2,2,sangat berguna,2,2,"['sangat', 'berguna']",['berguna'],2,1,1,guna,1,1
Cara cari kerjanya bingung,negatif,2023-10-19,2023,cara cari kerjanya bingung,4,4,cara cari kerjanya bingung,4,4,"['cara', 'cari', 'kerjanya', 'bingung']","['cari', 'kerjanya', 'bingung']",4,3,1,cari kerja bingung,3,3
Terbaik malikat tak bersayap,positif,2021-12-19,2021,terbaik malikat tak bersayap,4,4,terbaik malikat tidak bersayap,4,4,"['terbaik', 'malikat', 'tidak', 'bersayap']","['terbaik', 'malikat', 'tidak', 'bersayap']",4,4,0,baik malikat tidak sayap,4,4
Sangat membantu,positif,2021-07-28,2021,sangat membantu,2,2,sangat membantu,2,2,"['sangat', 'membantu']",['membantu'],2,1,1,bantu,1,1
Sangat membantu,positif,2021-04-27,2021,sangat membantu,2,2,sangat membantu,2,2,"['sangat', 'membantu']",['membantu'],2,1,1,bantu,1,1
Sangat mendukung,positif,2022-09-10,2022,sangat mendukung,2,2,sangat mendukung,2,2,"['sangat', 'mendukung']",['mendukung'],2,1,1,dukung,1,1
Berkelas ni.. ngak semua orang masuk ke sini..,positif,2021-05-26,2021,berkelas ni ngak semua orang masuk ke sini,8,8,berkelas ini tidak semua orang masuk ke sini,8,8,"['berkelas', 'ini', 'tidak', 'semua', 'orang', 'masuk', 'ke', 'sini']","['berkelas', 'tidak', 'orang', 'masuk']",8,4,4,kelas tidak orang masuk,4,4
"Keren, Bisa mendapat teman baru",positif,2023-09-30,2023,keren bisa mendapat teman baru,5,5,keren bisa mendapat teman baru,5,5,"['keren', 'bisa', 'mendapat', 'teman', 'baru']","['keren', 'teman']",5,2,3,keren teman,2,2
"Login, SANGAT SUSAH.",negatif,2024-01-10,2024,login sangat susah,3,3,login sangat susah,3,3,"['login', 'sangat', 'susah']","['login', 'susah']",3,2,1,login susah,2,2
baik untuk pedoman hidup,positif,2020-07-14,2020,baik untuk pedoman hidup,4,4,baik untuk pedoman hidup,4,4,"['baik', 'untuk', 'pedoman', 'hidup']","['pedoman', 'hidup']",4,2,2,pedoman hidup,2,2
Selalu untuk lebih baik,positif,2021-10-11,2021,selalu untuk lebih baik,4,4,selalu untuk lebih baik,4,4,"['selalu', 'untuk', 'lebih', 'baik']",[],4,1,3,,1,0
semangat belajar,positif,2021-10-17,2021,semangat belajar,2,2,semangat belajar,2,2,"['semangat', 'belajar']","['semangat', 'belajar']",2,2,0,semangat ajar,2,2
Susah utk login,negatif,2022-02-02,2022,susah utk login,3,3,susah untuk login,3,3,"['susah', 'untuk', 'login']","['susah', 'login']",3,2,1,susah login,2,2
Cukup membantu,positif,2022-02-10,2022,cukup membantu,2,2,cukup membantu,2,2,"['cukup', 'membantu']",['membantu'],2,1,1,bantu,1,1
Data anda bisa di curi hati-hati.,negatif,2023-10-17,2023,data anda bisa di curi hati hati,6,7,data anda bisa di curi hati hati,7,7,"['data', 'anda', 'bisa', 'di', 'curi', 'hati', 'hati']","['data', 'curi', 'hati', 'hati']",7,4,3,data curi hati hati,4,4
Sangat bermamfa'at bagi saya,positif,2020-10-16,2020,sangat bermamfa at bagi saya,4,5,sangat bermamfa at bagi saya,5,5,"['sangat', 'bermamfa', 'at', 'bagi', 'saya']","['bermamfa', 'at']",5,2,3,bermamfa at,2,2
Semoga lebih berkualitas,positif,2023-01-28,2023,semoga lebih berkualitas,3,3,semoga lebih berkualitas,3,3,"['semoga', 'lebih', 'berkualitas']","['semoga', 'berkualitas']",3,2,1,moga kualitas,2,2
Sangat bermanfaat,positif,2021-08-06,2021,sangat bermanfaat,2,2,sangat bermanfaat,2,2,"['sangat', 'bermanfaat']",['bermanfaat'],2,1,1,manfaat,1,1
Sangat membantu,positif,2021-04-22,2021,sangat membantu,2,2,sangat membantu,2,2,"['sangat', 'membantu']",['membantu'],2,1,1,bantu,1,1
Semoga saja bisa digunakan,positif,2021-04-13,2021,semoga saja bisa digunakan,4,4,semoga saja bisa digunakan,4,4,"['semoga', 'saja', 'bisa', 'digunakan']",['semoga'],4,1,3,moga,1,1
Semoga bisa mendapat pekerjaan,positif,2022-04-09,2022,semoga bisa mendapat pekerjaan,4,4,semoga bisa mendapat pekerjaan,4,4,"['semoga', 'bisa', 'mendapat', 'pekerjaan']","['semoga', 'pekerjaan']",4,2,2,moga kerja,2,2
Bagus banget apl ini,positif,2020-01-06,2020,bagus banget apl ini,4,4,bagus banget aplikasi ini,4,4,"['bagus', 'banget', 'aplikasi', 'ini']","['bagus', 'banget', 'aplikasi']",4,3,1,bagus banget aplikasi,3,3
"Mengecewakan sekali,......",negatif,2022-12-08,2022,mengecewakan sekali,2,2,mengecewakan sekali,2,2,"['mengecewakan', 'sekali']",['mengecewakan'],2,1,1,kecewa,1,1
Sagat membantu.luarbiasa.tetap eksisya.ami.,positif,2021-05-08,2021,sagat membantu luarbiasa tetap eksisya ami,3,6,sagat membantu luarbiasa tetap eksisya ami,6,6,"['sagat', 'membantu', 'luarbiasa', 'tetap', 'eksisya', 'ami']","['sagat', 'membantu', 'luarbiasa', 'eksisya', 'ami']",6,5,1,sagat bantu luarbiasa eksisya ami,5,5
Keseringan verifikasi,negatif,2023-10-16,2023,keseringan verifikasi,2,2,keseringan verifikasi,2,2,"['keseringan', 'verifikasi']","['keseringan', 'verifikasi']",2,2,0,sering verifikasi,2,2
Sangat membantu,positif,2021-11-24,2021,sangat membantu,2,2,sangat membantu,2,2,"['sangat', 'membantu']",['membantu'],2,1,1,bantu,1,1
Linkedin saya susah di buka,negatif,2020-07-09,2020,linkedin saya susah di buka,5,5,linkedin saya susah di buka,5,5,"['linkedin', 'saya', 'susah', 'di', 'buka']","['linkedin', 'susah', 'buka']",5,3,2,linkedin susah buka,3,3
Senang membantu banget,positif,2024-02-18,2024,senang membantu banget,3,3,senang membantu banget,3,3,"['senang', 'membantu', 'banget']","['senang', 'membantu', 'banget']",3,3,0,senang bantu banget,3,3
Mampu bekerja dengan baik di divisi keuangan dan admin,positif,2021-09-26,2021,mampu bekerja dengan baik di divisi keuangan dan admin,9,9,mampu bekerja dengan baik di divisi keuangan dan admin,9,9,"['mampu', 'bekerja', 'dengan', 'baik', 'di', 'divisi', 'keuangan', 'dan', 'admin']","['divisi', 'keuangan', 'admin']",9,3,6,divisi uang admin,3,3
Informasi nya keren,positif,2022-06-07,2022,informasi nya keren,3,3,informasi nya keren,3,3,"['informasi', 'nya', 'keren']","['informasi', 'nya', 'keren']",3,3,0,informasi nya keren,3,3
Sangat membantu,positif,2022-02-12,2022,sangat membantu,2,2,sangat membantu,2,2,"['sangat', 'membantu']",['membantu'],2,1,1,bantu,1,1
Linkedin Sahabat Informasi yang setia & terpercaya,positif,2020-03-16,2020,linkedin sahabat informasi yang setia terpercaya,7,6,linkedin sahabat informasi yang setia terpercaya,6,6,"['linkedin', 'sahabat', 'informasi', 'yang', 'setia', 'terpercaya']","['linkedin', 'sahabat', 'informasi', 'setia', 'terpercaya']",6,5,1,linkedin sahabat informasi setia percaya,5,5
Semoga lebih ditingkatkan lg,positif,2020-02-07,2020,semoga lebih ditingkatkan lg,4,4,semoga lebih ditingkatkan lagi,4,4,"['semoga', 'lebih', 'ditingkatkan', 'lagi']","['semoga', 'ditingkatkan']",4,2,2,moga tingkat,2,2
Sangat membantu,positif,2022-03-26,2022,sangat membantu,2,2,sangat membantu,2,2,"['sangat', 'membantu']",['membantu'],2,1,1,bantu,1,1
Sangat membantu,positif,2021-06-25,2021,sangat membantu,2,2,sangat membantu,2,2,"['sangat', 'membantu']",['membantu'],2,1,1,bantu,1,1
Sulit dapat kerjaan disini,negatif,2020-10-07,2020,sulit dapat kerjaan disini,4,4,sulit dapat kerjaan disini,4,4,"['sulit', 'dapat', 'kerjaan', 'disini']","['sulit', 'kerjaan']",4,2,2,sulit kerja,2,2
Linkedln sangat bermafaat,positif,2020-01-22,2020,linkedln sangat bermafaat,3,3,linkedln sangat bermafaat,3,3,"['linkedln', 'sangat', 'bermafaat']","['linkedln', 'bermafaat']",3,2,1,linkedln bermafaat,2,2
Terlalu banyak email,negatif,2021-10-26,2021,terlalu banyak email,3,3,terlalu banyak email,3,3,"['terlalu', 'banyak', 'email']",['email'],3,1,2,email,1,1
Sangat bermanfaat,positif,2020-02-29,2020,sangat bermanfaat,2,2,sangat bermanfaat,2,2,"['sangat', 'bermanfaat']",['bermanfaat'],2,1,1,manfaat,1,1
Sangat membantu,positif,2021-11-06,2021,sangat membantu,2,2,sangat membantu,2,2,"['sangat', 'membantu']",['membantu'],2,1,1,bantu,1,1
Aplikasinya bagus aku suka,positif,2021-12-14,2021,aplikasinya bagus aku suka,4,4,aplikasi nya bagus aku suka,4,5,"['aplikasi', 'nya', 'bagus', 'aku', 'suka']","['aplikasi', 'nya', 'bagus', 'suka']",5,4,1,aplikasi nya bagus suka,4,4
Terima Kasih sangat membantu.,positif,2023-05-08,2023,terima kasih sangat membantu,4,4,terima kasih sangat membantu,4,4,"['terima', 'kasih', 'sangat', 'membantu']","['terima', 'kasih', 'membantu']",4,3,1,terima kasih bantu,3,3
Sangat membantu,positif,2020-10-02,2020,sangat membantu,2,2,sangat membantu,2,2,"['sangat', 'membantu']",['membantu'],2,1,1,bantu,1,1
Min kenapa kok gak bisa tutup akun ya?,negatif,2022-08-25,2022,min kenapa kok gak bisa tutup akun ya,8,8,minimal kenapa kok tidak bisa tutup akun ya,8,8,"['minimal', 'kenapa', 'kok', 'tidak', 'bisa', 'tutup', 'akun', 'ya']","['minimal', 'tidak', 'tutup', 'akun', 'ya']",8,5,3,minimal tidak tutup akun ya,5,5
Ya ok selalu bersama in!!!!,positif,2022-08-13,2022,ya ok selalu bersama in,5,5,ya oke selalu bersama in,5,5,"['ya', 'oke', 'selalu', 'bersama', 'in']","['ya', 'oke', 'in']",5,3,2,ya oke in,3,3
Sangat membantu,positif,2023-12-28,2023,sangat membantu,2,2,sangat membantu,2,2,"['sangat', 'membantu']",['membantu'],2,1,1,bantu,1,1
Login aja dipersulit,negatif,2023-08-04,2023,login aja dipersulit,3,3,login saja dipersulit,3,3,"['login', 'saja', 'dipersulit']","['login', 'dipersulit']",3,2,1,login sulit,2,2
Mantap dan aman,positif,2024-01-04,2024,mantap dan aman,3,3,mantap dan aman,3,3,"['mantap', 'dan', 'aman']","['mantap', 'aman']",3,2,1,mantap aman,2,2
mantap dan bermanfaat,positif,2023-07-22,2023,mantap dan bermanfaat,3,3,mantap dan bermanfaat,3,3,"['mantap', 'dan', 'bermanfaat']","['mantap', 'bermanfaat']",3,2,1,mantap manfaat,2,2
VERIFIKASI MASUK GAJELAS,negatif,2021-11-01,2021,verifikasi masuk gajelas,3,3,verifikasi masuk tidak jelas,3,4,"['verifikasi', 'masuk', 'tidak', 'jelas']","['verifikasi', 'masuk', 'tidak']",4,3,1,verifikasi masuk tidak,3,3
Keren sangat berguna,positif,2023-08-04,2023,keren sangat berguna,3,3,keren sangat berguna,3,3,"['keren', 'sangat', 'berguna']","['keren', 'berguna']",3,2,1,keren guna,2,2
Ok sangat membantu,positif,2020-04-02,2020,ok sangat membantu,3,3,oke sangat membantu,3,3,"['oke', 'sangat', 'membantu']","['oke', 'membantu']",3,2,1,oke bantu,2,2
Mantap.. sukses selaleu,positif,2021-10-31,2021,mantap sukses selaleu,3,3,mantap sukses selaleu,3,3,"['mantap', 'sukses', 'selaleu']","['mantap', 'sukses', 'selaleu']",3,3,0,mantap sukses selaleu,3,3
Mantp sangat membantu,positif,2020-01-01,2020,mantp sangat membantu,3,3,mantp sangat membantu,3,3,"['mantp', 'sangat', 'membantu']","['mantp', 'membantu']",3,2,1,mantp bantu,2,2
Untuk mecari informasi,positif,2023-11-11,2023,untuk mecari informasi,3,3,untuk mecari informasi,3,3,"['untuk', 'mecari', 'informasi']","['mecari', 'informasi']",3,2,1,mecari informasi,2,2
Mantap utk networking,positif,2020-11-05,2020,mantap utk networking,3,3,mantap untuk networking,3,3,"['mantap', 'untuk', 'networking']","['mantap', 'networking']",3,2,1,mantap networking,2,2
Lowongan bnyak yang hoax,negatif,2022-12-27,2022,lowongan bnyak yang hoax,4,4,lowongan banyak yang isu bohong,4,5,"['lowongan', 'banyak', 'yang', 'isu', 'bohong']","['lowongan', 'isu', 'bohong']",5,3,2,lowong isu bohong,3,3
Hahahahaha bagus sekali gaes,positif,2021-12-23,2021,hahahahaha bagus sekali gaes,4,4,hahahahaha bagus sekali gaes,4,4,"['hahahahaha', 'bagus', 'sekali', 'gaes']","['hahahahaha', 'bagus', 'gaes']",4,3,1,hahahahaha bagus gaes,3,3
Bagus aplikasinya,positif,2021-05-12,2021,bagus aplikasinya,2,2,bagus aplikasi nya,2,3,"['bagus', 'aplikasi', 'nya']","['bagus', 'aplikasi', 'nya']",3,3,0,bagus aplikasi nya,3,3
Sangat membantu,positif,2022-01-26,2022,sangat membantu,2,2,sangat membantu,2,2,"['sangat', 'membantu']",['membantu'],2,1,1,bantu,1,1
verifikasi gajelas su,negatif,2022-09-03,2022,verifikasi gajelas su,3,3,verifikasi tidak jelas su,3,4,"['verifikasi', 'tidak', 'jelas', 'su']","['verifikasi', 'tidak', 'su']",4,3,1,verifikasi tidak su,3,3
Job terbaru semoga ada di sini,positif,2021-01-25,2021,job terbaru semoga ada di sini,6,6,kerja terbaru semoga ada di sini,6,6,"['kerja', 'terbaru', 'semoga', 'ada', 'di', 'sini']","['kerja', 'terbaru', 'semoga']",6,3,3,kerja baru moga,3,3
Oke juga mantap,positif,2023-10-27,2023,oke juga mantap,3,3,oke juga mantap,3,3,"['oke', 'juga', 'mantap']","['oke', 'mantap']",3,2,1,oke mantap,2,2
Kami banyak memperoleh pengalaman,positif,2022-04-21,2022,kami banyak memperoleh pengalaman,4,4,kami banyak memperoleh pengalaman,4,4,"['kami', 'banyak', 'memperoleh', 'pengalaman']","['memperoleh', 'pengalaman']",4,2,2,oleh alam,2,2
Sangat bermanfaat... 👍👍👍👍👍,positif,2022-01-03,2022,sangat bermanfaat,3,2,sangat bermanfaat,2,2,"['sangat', 'bermanfaat']",['bermanfaat'],2,1,1,manfaat,1,1
Tolong Di permudah untuk login Ya Allah,positif,2023-05-25,2023,tolong di permudah untuk login ya allah,7,7,tolong di permudah untuk login ya allah,7,7,"['tolong', 'di', 'permudah', 'untuk', 'login', 'ya', 'allah']","['tolong', 'permudah', 'login', 'ya', 'allah']",7,5,2,tolong mudah login ya allah,5,5
Terima kasih LinkedIn 🎭,positif,2022-10-11,2022,terima kasih linkedin,4,3,terima kasih linkedin,3,3,"['terima', 'kasih', 'linkedin']","['terima', 'kasih', 'linkedin']",3,3,0,terima kasih linkedin,3,3
Sangat bermanfaat buat saya,positif,2021-11-15,2021,sangat bermanfaat buat saya,4,4,sangat bermanfaat buat saya,4,4,"['sangat', 'bermanfaat', 'buat', 'saya']",['bermanfaat'],4,1,3,manfaat,1,1
Apk ini luar biasa,positif,2021-01-05,2021,apk ini luar biasa,4,4,aplikasi ini luar biasa,4,4,"['aplikasi', 'ini', 'luar', 'biasa']",['aplikasi'],4,1,3,aplikasi,1,1
Mengapa akun saya di banned tanpa alasan yang jelas,negatif,2021-01-30,2021,mengapa akun saya di banned tanpa alasan yang jelas,9,9,mengapa akun saya di banned tanpa alasan yang jelas,9,9,"['mengapa', 'akun', 'saya', 'di', 'banned', 'tanpa', 'alasan', 'yang', 'jelas']","['akun', 'banned', 'alasan']",9,3,6,akun banned alas,3,3
"SUSAH UNTUK MASUK NYA, RIBET",negatif,2024-06-02,2024,susah untuk masuk nya ribet,5,5,susah untuk masuk nya rumit,5,5,"['susah', 'untuk', 'masuk', 'nya', 'rumit']","['susah', 'masuk', 'nya', 'rumit']",5,4,1,susah masuk nya rumit,4,4
Berperan penting dlm diskusi dngn orang orang perusahaan,positif,2020-05-22,2020,berperan penting dlm diskusi dngn orang orang perusahaan,8,8,berperan penting dalam diskusi dengan orang orang perusahaan,8,8,"['berperan', 'penting', 'dalam', 'diskusi', 'dengan', 'orang', 'orang', 'perusahaan']","['berperan', 'diskusi', 'orang', 'orang', 'perusahaan']",8,5,3,peran diskusi orang orang usaha,5,5
Sangat bermanfaat,positif,2020-10-20,2020,sangat bermanfaat,2,2,sangat bermanfaat,2,2,"['sangat', 'bermanfaat']",['bermanfaat'],2,1,1,manfaat,1,1
Proses melamar susah ribet,negatif,2023-04-17,2023,proses melamar susah ribet,4,4,proses melamar susah rumit,4,4,"['proses', 'melamar', 'susah', 'rumit']","['proses', 'melamar', 'susah', 'rumit']",4,4,0,proses lamar susah rumit,4,4
Banyak manfaatnya,positif,2020-07-21,2020,banyak manfaatnya,2,2,banyak manfaatnya,2,2,"['banyak', 'manfaatnya']",['manfaatnya'],2,1,1,manfaat,1,1
Sangat membantu,positif,2020-09-16,2020,sangat membantu,2,2,sangat membantu,2,2,"['sangat', 'membantu']",['membantu'],2,1,1,bantu,1,1
Masih ada Loker Palsu,negatif,2023-11-15,2023,masih ada loker palsu,4,4,masih ada loker palsu,4,4,"['masih', 'ada', 'loker', 'palsu']","['loker', 'palsu']",4,2,2,loker palsu,2,2
Sangat memudahkan,positif,2021-09-17,2021,sangat memudahkan,2,2,sangat memudahkan,2,2,"['sangat', 'memudahkan']",['memudahkan'],2,1,1,mudah,1,1
Sangat Membantu,positif,2022-08-07,2022,sangat membantu,2,2,sangat membantu,2,2,"['sangat', 'membantu']",['membantu'],2,1,1,bantu,1,1
Sangat membantu,positif,2022-07-21,2022,sangat membantu,2,2,sangat membantu,2,2,"['sangat', 'membantu']",['membantu'],2,1,1,bantu,1,1
Informasi SDH menjadi bagian dari gaya hdpku titik,positif,2023-01-07,2023,informasi sdh menjadi bagian dari gaya hdpku titik,8,8,informasi sudah menjadi bagian dari gaya hdpku titik,8,8,"['informasi', 'sudah', 'menjadi', 'bagian', 'dari', 'gaya', 'hdpku', 'titik']","['informasi', 'gaya', 'hdpku', 'titik']",8,4,4,informasi gaya hdpku titik,4,4
Nyari kerjaan,positif,2020-08-21,2020,nyari kerjaan,2,2,mencari kerjaan,2,2,"['mencari', 'kerjaan']","['mencari', 'kerjaan']",2,2,0,cari kerja,2,2
Sangat membantu,positif,2024-05-16,2024,sangat membantu,2,2,sangat membantu,2,2,"['sangat', 'membantu']",['membantu'],2,1,1,bantu,1,1
Terimakasih atas bantuannya.,positif,2020-05-11,2020,terimakasih atas bantuannya,3,3,terima kasih atas bantuannya,3,4,"['terima', 'kasih', 'atas', 'bantuannya']","['terima', 'kasih', 'bantuannya']",4,3,1,terima kasih bantu,3,3
Sangat membantu👍.,positif,2021-01-17,2021,sangat membantu,2,2,sangat membantu,2,2,"['sangat', 'membantu']",['membantu'],2,1,1,bantu,1,1
Terima kasih sudah bisa,positif,2020-03-26,2020,terima kasih sudah bisa,4,4,terima kasih sudah bisa,4,4,"['terima', 'kasih', 'sudah', 'bisa']","['terima', 'kasih']",4,2,2,terima kasih,2,2
Sangat berguna banget,positif,2022-02-07,2022,sangat berguna banget,3,3,sangat berguna banget,3,3,"['sangat', 'berguna', 'banget']","['berguna', 'banget']",3,2,1,guna banget,2,2
Mendekatkan yang jauh,positif,2023-02-21,2023,mendekatkan yang jauh,3,3,mendekatkan yang jauh,3,3,"['mendekatkan', 'yang', 'jauh']",['mendekatkan'],3,1,2,dekat,1,1
Bagus aplikasi ini,positif,2023-01-09,2023,bagus aplikasi ini,3,3,bagus aplikasi ini,3,3,"['bagus', 'aplikasi', 'ini']","['bagus', 'aplikasi']",3,2,1,bagus aplikasi,2,2
Mengatsi masalah tanpa masalahh,positif,2021-11-24,2021,mengatsi masalah tanpa masalahh,4,4,mengatsi masalah tanpa masalahh,4,4,"['mengatsi', 'masalah', 'tanpa', 'masalahh']","['mengatsi', 'masalahh']",4,2,2,mengatsi masalahh,2,2
App ni bagus,positif,2020-06-02,2020,app ni bagus,3,3,aplikasi ini bagus,3,3,"['aplikasi', 'ini', 'bagus']","['aplikasi', 'bagus']",3,2,1,aplikasi bagus,2,2
Sangat bermanfaat,positif,2020-09-06,2020,sangat bermanfaat,2,2,sangat bermanfaat,2,2,"['sangat', 'bermanfaat']",['bermanfaat'],2,1,1,manfaat,1,1
Sangat memuaskan,positif,2022-07-06,2022,sangat memuaskan,2,2,sangat memuaskan,2,2,"['sangat', 'memuaskan']",['memuaskan'],2,1,1,muas,1,1
Sangat membantu,positif,2020-01-23,2020,sangat membantu,2,2,sangat membantu,2,2,"['sangat', 'membantu']",['membantu'],2,1,1,bantu,1,1
Sangat memuaskan,positif,2021-09-27,2021,sangat memuaskan,2,2,sangat memuaskan,2,2,"['sangat', 'memuaskan']",['memuaskan'],2,1,1,muas,1,1
Aplikasinya bagus,positif,2023-07-17,2023,aplikasinya bagus,2,2,aplikasi nya bagus,2,3,"['aplikasi', 'nya', 'bagus']","['aplikasi', 'nya', 'bagus']",3,3,0,aplikasi nya bagus,3,3
Sangat membantu,positif,2020-01-09,2020,sangat membantu,2,2,sangat membantu,2,2,"['sangat', 'membantu']",['membantu'],2,1,1,bantu,1,1
Selalu yg terbaik,positif,2024-04-02,2024,selalu yg terbaik,3,3,selalu yang terbaik,3,3,"['selalu', 'yang', 'terbaik']",['terbaik'],3,1,2,baik,1,1
"Terlalu banyak CALO. buat para penipu, lu anjing semua.",negatif,2020-01-25,2020,terlalu banyak calo buat para penipu lu anjing semua,9,9,terlalu banyak calo buat para penipu lu anjing semua,9,9,"['terlalu', 'banyak', 'calo', 'buat', 'para', 'penipu', 'lu', 'anjing', 'semua']","['calo', 'penipu', 'lu', 'anjing']",9,4,5,calo tipu lu anjing,4,4
Verifikasinya gmna si mempusingkan,negatif,2021-12-20,2021,verifikasinya gmna si mempusingkan,4,4,verifikasinya bagaimana sih mempusingkan,4,4,"['verifikasinya', 'bagaimana', 'sih', 'mempusingkan']","['verifikasinya', 'sih', 'mempusingkan']",4,3,1,verifikasi sih pusing,3,3
luar biasa Elegan,positif,2022-06-26,2022,luar biasa elegan,3,3,luar biasa elegan,3,3,"['luar', 'biasa', 'elegan']",['elegan'],3,1,2,elegan,1,1
Aplikasi nya bagus,positif,2022-04-17,2022,aplikasi nya bagus,3,3,aplikasi nya bagus,3,3,"['aplikasi', 'nya', 'bagus']","['aplikasi', 'nya', 'bagus']",3,3,0,aplikasi nya bagus,3,3
Baik dan bagus,positif,2024-02-14,2024,baik dan bagus,3,3,baik dan bagus,3,3,"['baik', 'dan', 'bagus']",['bagus'],3,1,2,bagus,1,1
Sudah cukup Baik,positif,2020-11-02,2020,sudah cukup baik,3,3,sudah cukup baik,3,3,"['sudah', 'cukup', 'baik']",[],3,1,2,,1,0
Kek babi mau daftar akun aja susah kali.,negatif,2022-03-03,2022,kek babi mau daftar akun aja susah kali,8,8,seperti babi mau daftar akun saja susah kali,8,8,"['seperti', 'babi', 'mau', 'daftar', 'akun', 'saja', 'susah', 'kali']","['babi', 'daftar', 'akun', 'susah', 'kali']",8,5,3,babi daftar akun susah kali,5,5
Semoga jadi jalan rejeki yg berkah dari Allah,positif,2021-12-22,2021,semoga jadi jalan rejeki yg berkah dari allah,8,8,semoga jadi jalan rejeki yang berkah dari allah,8,8,"['semoga', 'jadi', 'jalan', 'rejeki', 'yang', 'berkah', 'dari', 'allah']","['semoga', 'jalan', 'rejeki', 'berkah', 'allah']",8,5,3,moga jalan rejeki berkah allah,5,5
Aplikasi ini su suka,positif,2021-03-23,2021,aplikasi ini su suka,4,4,aplikasi ini su suka,4,4,"['aplikasi', 'ini', 'su', 'suka']","['aplikasi', 'su', 'suka']",4,3,1,aplikasi su suka,3,3
Sangat membntu,positif,2021-01-22,2021,sangat membntu,2,2,sangat membntu,2,2,"['sangat', 'membntu']",['membntu'],2,1,1,membntu,1,1
Bagus bikin kami yambah wawasan,positif,2020-10-14,2020,bagus bikin kami yambah wawasan,5,5,bagus bikin kami yambah wawasan,5,5,"['bagus', 'bikin', 'kami', 'yambah', 'wawasan']","['bagus', 'bikin', 'yambah', 'wawasan']",5,4,1,bagus bikin yambah wawas,4,4
Ok banget aplikasinya,positif,2022-01-24,2022,ok banget aplikasinya,3,3,oke banget aplikasi nya,3,4,"['oke', 'banget', 'aplikasi', 'nya']","['oke', 'banget', 'aplikasi', 'nya']",4,4,0,oke banget aplikasi nya,4,4
Baik dan bagus,positif,2021-05-27,2021,baik dan bagus,3,3,baik dan bagus,3,3,"['baik', 'dan', 'bagus']",['bagus'],3,1,2,bagus,1,1
Aplikasinya lemot,negatif,2023-11-18,2023,aplikasinya lemot,2,2,aplikasi nya lambat,2,3,"['aplikasi', 'nya', 'lambat']","['aplikasi', 'nya', 'lambat']",3,3,0,aplikasi nya lambat,3,3
Sering mati sendiri,negatif,2021-08-20,2021,sering mati sendiri,3,3,sering mati sendiri,3,3,"['sering', 'mati', 'sendiri']",['mati'],3,1,2,mati,1,1
Bintang lima karna terhubung singacir.,positif,2020-09-24,2020,bintang lima karna terhubung singacir,5,5,bintang lima karena terhubung singacir,5,5,"['bintang', 'lima', 'karena', 'terhubung', 'singacir']","['bintang', 'terhubung', 'singacir']",5,3,2,bintang hubung singacir,3,3
saya sangat cinta lindkein,positif,2020-12-24,2020,saya sangat cinta lindkein,4,4,saya sangat cinta lindkein,4,4,"['saya', 'sangat', 'cinta', 'lindkein']","['cinta', 'lindkein']",4,2,2,cinta lindkein,2,2
Tes kemanusiaan nya bikin gw puyeng mo muntah Itu tes apakah anda manusia atau bukan gak masuk akal 🤢,negatif,2022-02-04,2022,tes kemanusiaan nya bikin gw puyeng mo muntah itu tes apakah anda manusia atau bukan gak masuk akal,19,18,tes kemanusiaan nya bikin saya puyeng mau muntah itu tes apakah anda manusia atau bukan tidak masuk akal,18,18,"['tes', 'kemanusiaan', 'nya', 'bikin', 'saya', 'puyeng', 'mau', 'muntah', 'itu', 'tes', 'apakah', 'anda', 'manusia', 'atau', 'bukan', 'tidak', 'masuk', 'akal']","['tes', 'kemanusiaan', 'nya', 'bikin', 'puyeng', 'muntah', 'tes', 'manusia', 'tidak', 'masuk', 'akal']",18,11,7,tes manusia nya bikin puyeng muntah tes manusia tidak masuk akal,11,11
LinkedIn memang bagus,positif,2022-01-20,2022,linkedin memang bagus,3,3,linkedin memang bagus,3,3,"['linkedin', 'memang', 'bagus']","['linkedin', 'bagus']",3,2,1,linkedin bagus,2,2
Aman dan cepat,positif,2022-02-24,2022,aman dan cepat,3,3,aman dan cepat,3,3,"['aman', 'dan', 'cepat']","['aman', 'cepat']",3,2,1,aman cepat,2,2
Bergerak di bidang perdagangan dan pertanian,positif,2021-07-24,2021,bergerak di bidang perdagangan dan pertanian,6,6,bergerak di bidang perdagangan dan pertanian,6,6,"['bergerak', 'di', 'bidang', 'perdagangan', 'dan', 'pertanian']","['bergerak', 'bidang', 'perdagangan', 'pertanian']",6,4,2,gerak bidang dagang tani,4,4
Pembuatan akun aja di persulit,negatif,2023-10-20,2023,pembuatan akun aja di persulit,5,5,pembuatan akun saja di persulit,5,5,"['pembuatan', 'akun', 'saja', 'di', 'persulit']","['pembuatan', 'akun', 'persulit']",5,3,2,buat akun sulit,3,3
Semakin bagus,positif,2021-12-28,2021,semakin bagus,2,2,semakin bagus,2,2,"['semakin', 'bagus']",['bagus'],2,1,1,bagus,1,1
Semoga ada kabar baik,positif,2024-07-09,2024,semoga ada kabar baik,4,4,semoga ada kabar baik,4,4,"['semoga', 'ada', 'kabar', 'baik']","['semoga', 'kabar']",4,2,2,moga kabar,2,2
mantaff.silaturahmi nya..,positif,2020-12-15,2020,mantaff silaturahmi nya,2,3,mantap silaturahmi nya,3,3,"['mantap', 'silaturahmi', 'nya']","['mantap', 'silaturahmi', 'nya']",3,3,0,mantap silaturahmi nya,3,3
Busuk. Semua akun direstricted. Gak jelas,negatif,2022-07-29,2022,busuk semua akun direstricted gak jelas,6,6,busuk semua akun direstricted tidak jelas,6,6,"['busuk', 'semua', 'akun', 'direstricted', 'tidak', 'jelas']","['busuk', 'akun', 'direstricted', 'tidak']",6,4,2,busuk akun direstricted tidak,4,4
Dunia sangat luas,positif,2020-10-11,2020,dunia sangat luas,3,3,dunia sangat luas,3,3,"['dunia', 'sangat', 'luas']","['dunia', 'luas']",3,2,1,dunia luas,2,2
BAGUS BAIK DAN TERBAIK,positif,2020-09-19,2020,bagus baik dan terbaik,4,4,bagus baik dan terbaik,4,4,"['bagus', 'baik', 'dan', 'terbaik']","['bagus', 'terbaik']",4,2,2,bagus baik,2,2
Sangat bermanfaat,positif,2021-12-24,2021,sangat bermanfaat,2,2,sangat bermanfaat,2,2,"['sangat', 'bermanfaat']",['bermanfaat'],2,1,1,manfaat,1,1
Sangat membantu,positif,2020-04-24,2020,sangat membantu,2,2,sangat membantu,2,2,"['sangat', 'membantu']",['membantu'],2,1,1,bantu,1,1
Iklannya mengandung LGBT,negatif,2024-06-09,2024,iklannya mengandung lgbt,3,3,iklannya mengandung lgbt,3,3,"['iklannya', 'mengandung', 'lgbt']","['iklannya', 'mengandung', 'lgbt']",3,3,0,iklan kandung lgbt,3,3
Ciee aplikasinya,positif,2020-02-21,2020,ciee aplikasinya,2,2,ciee aplikasi nya,2,3,"['ciee', 'aplikasi', 'nya']","['ciee', 'aplikasi', 'nya']",3,3,0,ciee aplikasi nya,3,3
Sangat bermanfaat👍,positif,2022-07-11,2022,sangat bermanfaat,2,2,sangat bermanfaat,2,2,"['sangat', 'bermanfaat']",['bermanfaat'],2,1,1,manfaat,1,1
Sangat bermanfaat,positif,2020-11-13,2020,sangat bermanfaat,2,2,sangat bermanfaat,2,2,"['sangat', 'bermanfaat']",['bermanfaat'],2,1,1,manfaat,1,1
Sangat bermanfaat,positif,2021-02-09,2021,sangat bermanfaat,2,2,sangat bermanfaat,2,2,"['sangat', 'bermanfaat']",['bermanfaat'],2,1,1,manfaat,1,1
Sangat bermanfaat,positif,2020-03-04,2020,sangat bermanfaat,2,2,sangat bermanfaat,2,2,"['sangat', 'bermanfaat']",['bermanfaat'],2,1,1,manfaat,1,1
Cara daftarnya ribet,negatif,2022-08-16,2022,cara daftarnya ribet,3,3,cara daftarnya rumit,3,3,"['cara', 'daftarnya', 'rumit']","['daftarnya', 'rumit']",3,2,1,daftar rumit,2,2
Lumayan mantap sich,positif,2021-08-21,2021,lumayan mantap sich,3,3,lumayan mantap sih,3,3,"['lumayan', 'mantap', 'sih']","['lumayan', 'mantap', 'sih']",3,3,0,lumayan mantap sih,3,3
Sangat Membantu,positif,2020-08-30,2020,sangat membantu,2,2,sangat membantu,2,2,"['sangat', 'membantu']",['membantu'],2,1,1,bantu,1,1
Aplikasi yg bagus,positif,2020-11-02,2020,aplikasi yg bagus,3,3,aplikasi yang bagus,3,3,"['aplikasi', 'yang', 'bagus']","['aplikasi', 'bagus']",3,2,1,aplikasi bagus,2,2
Sangat membantu,positif,2022-01-31,2022,sangat membantu,2,2,sangat membantu,2,2,"['sangat', 'membantu']",['membantu'],2,1,1,bantu,1,1
Oke banget linkedin,positif,2022-05-17,2022,oke banget linkedin,3,3,oke banget linkedin,3,3,"['oke', 'banget', 'linkedin']","['oke', 'banget', 'linkedin']",3,3,0,oke banget linkedin,3,3
Sukses selalu Linkedln,positif,2023-06-28,2023,sukses selalu linkedln,3,3,sukses selalu linkedln,3,3,"['sukses', 'selalu', 'linkedln']","['sukses', 'linkedln']",3,2,1,sukses linkedln,2,2
Relog Mulu semenjak update.,negatif,2024-07-10,2024,relog mulu semenjak update,4,4,relog mulu semenjak diperbarui,4,4,"['relog', 'mulu', 'semenjak', 'diperbarui']","['relog', 'mulu', 'semenjak', 'diperbarui']",4,4,0,relog mulu semenjak baru,4,4
Aplikasi jelek macam kontol,negatif,2020-04-24,2020,aplikasi jelek macam kontol,4,4,aplikasi jelek macam kontol,4,4,"['aplikasi', 'jelek', 'macam', 'kontol']","['aplikasi', 'jelek', 'kontol']",4,3,1,aplikasi jelek kontol,3,3
Sangat membantu,positif,2021-09-11,2021,sangat membantu,2,2,sangat membantu,2,2,"['sangat', 'membantu']",['membantu'],2,1,1,bantu,1,1
Sudah sangat membantu,positif,2020-09-09,2020,sudah sangat membantu,3,3,sudah sangat membantu,3,3,"['sudah', 'sangat', 'membantu']",['membantu'],3,1,2,bantu,1,1
Aplikasi ga guna,negatif,2023-10-19,2023,aplikasi ga guna,3,3,aplikasi tidak guna,3,3,"['aplikasi', 'tidak', 'guna']","['aplikasi', 'tidak']",3,2,1,aplikasi tidak,2,2
Sangat membantu,positif,2020-12-02,2020,sangat membantu,2,2,sangat membantu,2,2,"['sangat', 'membantu']",['membantu'],2,1,1,bantu,1,1
Sangat membantu,positif,2023-12-12,2023,sangat membantu,2,2,sangat membantu,2,2,"['sangat', 'membantu']",['membantu'],2,1,1,bantu,1,1
Smoga saya dapat pekerjaan di sini.,positif,2023-12-22,2023,smoga saya dapat pekerjaan di sini,6,6,semoga saya dapat pekerjaan di sini,6,6,"['semoga', 'saya', 'dapat', 'pekerjaan', 'di', 'sini']","['semoga', 'pekerjaan']",6,2,4,moga kerja,2,2
Saya baru coba semoga bagus,positif,2022-06-14,2022,saya baru coba semoga bagus,5,5,saya baru coba semoga bagus,5,5,"['saya', 'baru', 'coba', 'semoga', 'bagus']","['coba', 'semoga', 'bagus']",5,3,2,coba moga bagus,3,3
Sangat bermanfaat,positif,2022-10-04,2022,sangat bermanfaat,2,2,sangat bermanfaat,2,2,"['sangat', 'bermanfaat']",['bermanfaat'],2,1,1,manfaat,1,1
Mantap aplikasinya,positif,2023-12-08,2023,mantap aplikasinya,2,2,mantap aplikasi nya,2,3,"['mantap', 'aplikasi', 'nya']","['mantap', 'aplikasi', 'nya']",3,3,0,mantap aplikasi nya,3,3
Terima kasih aplikasi,positif,2022-06-22,2022,terima kasih aplikasi,3,3,terima kasih aplikasi,3,3,"['terima', 'kasih', 'aplikasi']","['terima', 'kasih', 'aplikasi']",3,3,0,terima kasih aplikasi,3,3
sangat membantu,positif,2020-02-10,2020,sangat membantu,2,2,sangat membantu,2,2,"['sangat', 'membantu']",['membantu'],2,1,1,bantu,1,1
Verifikasi manusia apa alien?,negatif,2023-04-26,2023,verifikasi manusia apa alien,4,4,verifikasi manusia apa alien,4,4,"['verifikasi', 'manusia', 'apa', 'alien']","['verifikasi', 'manusia', 'alien']",4,3,1,verifikasi manusia alien,3,3
Sangat membatu,positif,2024-06-15,2024,sangat membatu,2,2,sangat membantu,2,2,"['sangat', 'membantu']",['membantu'],2,1,1,bantu,1,1
Aplikasinya bagus👍,positif,2022-12-11,2022,aplikasinya bagus,2,2,aplikasi nya bagus,2,3,"['aplikasi', 'nya', 'bagus']","['aplikasi', 'nya', 'bagus']",3,3,0,aplikasi nya bagus,3,3
Sangat membantu,positif,2020-01-15,2020,sangat membantu,2,2,sangat membantu,2,2,"['sangat', 'membantu']",['membantu'],2,1,1,bantu,1,1
Semoga kedepannya makin LBH baik Amin,positif,2021-03-22,2021,semoga kedepannya makin lbh baik amin,6,6,semoga kedepannya makin lebih baik aamiin,6,6,"['semoga', 'kedepannya', 'makin', 'lebih', 'baik', 'aamiin']","['semoga', 'kedepannya', 'aamiin']",6,3,3,moga depan aamiin,3,3
Sangat bermanfaat,positif,2022-05-11,2022,sangat bermanfaat,2,2,sangat bermanfaat,2,2,"['sangat', 'bermanfaat']",['bermanfaat'],2,1,1,manfaat,1,1
Sangat bermanfaat,positif,2022-02-28,2022,sangat bermanfaat,2,2,sangat bermanfaat,2,2,"['sangat', 'bermanfaat']",['bermanfaat'],2,1,1,manfaat,1,1
Saya coba dulu ya....semoga sesuai harapan saya...thank you!!!,positif,2021-10-19,2021,saya coba dulu ya semoga sesuai harapan saya thank you,8,10,saya coba dahulu ya semoga sesuai harapan saya terima kasih you,10,11,"['saya', 'coba', 'dahulu', 'ya', 'semoga', 'sesuai', 'harapan', 'saya', 'terima', 'kasih', 'you']","['coba', 'ya', 'semoga', 'sesuai', 'harapan', 'terima', 'kasih', 'you']",11,8,3,coba ya moga sesuai harap terima kasih you,8,8
Sangat membantu,positif,2021-05-14,2021,sangat membantu,2,2,sangat membantu,2,2,"['sangat', 'membantu']",['membantu'],2,1,1,bantu,1,1
Sangat membantu,positif,2021-03-27,2021,sangat membantu,2,2,sangat membantu,2,2,"['sangat', 'membantu']",['membantu'],2,1,1,bantu,1,1
Akun gw tiba tiba ilang woyyyyyyyyy,negatif,2023-10-14,2023,akun gw tiba tiba ilang woyyyyyyyyy,6,6,akun saya tiba tiba hilang woyyyyyyyyy,6,6,"['akun', 'saya', 'tiba', 'tiba', 'hilang', 'woyyyyyyyyy']","['akun', 'hilang', 'woyyyyyyyyy']",6,3,3,akun hilang woyyyyyyyyy,3,3
Berbagai wawasan,positif,2020-07-26,2020,berbagai wawasan,2,2,berbagai wawasan,2,2,"['berbagai', 'wawasan']",['wawasan'],2,1,1,wawas,1,1
Bagusnya di coba dulu,positif,2022-08-24,2022,bagusnya di coba dulu,4,4,bagusnya di coba dahulu,4,4,"['bagusnya', 'di', 'coba', 'dahulu']","['bagusnya', 'coba']",4,2,2,bagus coba,2,2
Sangat membantu,positif,2022-01-08,2022,sangat membantu,2,2,sangat membantu,2,2,"['sangat', 'membantu']",['membantu'],2,1,1,bantu,1,1
Sangat membantu,positif,2022-08-17,2022,sangat membantu,2,2,sangat membantu,2,2,"['sangat', 'membantu']",['membantu'],2,1,1,bantu,1,1
Semoga LinkedIn bermanfaat...,positif,2020-11-03,2020,semoga linkedin bermanfaat,3,3,semoga linkedin bermanfaat,3,3,"['semoga', 'linkedin', 'bermanfaat']","['semoga', 'linkedin', 'bermanfaat']",3,3,0,moga linkedin manfaat,3,3
Tolong selamatkan akun saya dr penipu yg mencoba masuk membajak akun saya,positif,2023-11-30,2023,tolong selamatkan akun saya dr penipu yg mencoba masuk membajak akun saya,12,12,tolong selamatkan akun saya dari penipu yang mencoba masuk membajak akun saya,12,12,"['tolong', 'selamatkan', 'akun', 'saya', 'dari', 'penipu', 'yang', 'mencoba', 'masuk', 'membajak', 'akun', 'saya']","['tolong', 'selamatkan', 'akun', 'penipu', 'mencoba', 'masuk', 'membajak', 'akun']",12,8,4,tolong selamat akun tipu coba masuk bajak akun,8,8
selalu sukses aja,positif,2024-03-08,2024,selalu sukses aja,3,3,selalu sukses saja,3,3,"['selalu', 'sukses', 'saja']",['sukses'],3,1,2,sukses,1,1
Gak jelas teka teki e!!!!!!!,negatif,2023-01-28,2023,gak jelas teka teki e,5,5,tidak jelas teka teki e,5,5,"['tidak', 'jelas', 'teka', 'teki', 'e']","['tidak', 'teka', 'teki', 'e']",5,4,1,tidak teka teki e,4,4
Sangat membantu,positif,2020-10-25,2020,sangat membantu,2,2,sangat membantu,2,2,"['sangat', 'membantu']",['membantu'],2,1,1,bantu,1,1
Sangat membantu,positif,2023-01-27,2023,sangat membantu,2,2,sangat membantu,2,2,"['sangat', 'membantu']",['membantu'],2,1,1,bantu,1,1
Sangat membantu,positif,2022-06-07,2022,sangat membantu,2,2,sangat membantu,2,2,"['sangat', 'membantu']",['membantu'],2,1,1,bantu,1,1
Sangat membantu,positif,2020-01-21,2020,sangat membantu,2,2,sangat membantu,2,2,"['sangat', 'membantu']",['membantu'],2,1,1,bantu,1,1
Sangat membantu,positif,2020-10-29,2020,sangat membantu,2,2,sangat membantu,2,2,"['sangat', 'membantu']",['membantu'],2,1,1,bantu,1,1
Sangat membantu,positif,2020-07-26,2020,sangat membantu,2,2,sangat membantu,2,2,"['sangat', 'membantu']",['membantu'],2,1,1,bantu,1,1
Sangat membantu,positif,2023-01-05,2023,sangat membantu,2,2,sangat membantu,2,2,"['sangat', 'membantu']",['membantu'],2,1,1,bantu,1,1
Sangat membantu,positif,2020-07-17,2020,sangat membantu,2,2,sangat membantu,2,2,"['sangat', 'membantu']",['membantu'],2,1,1,bantu,1,1
Sangat membantu,positif,2022-02-15,2022,sangat membantu,2,2,sangat membantu,2,2,"['sangat', 'membantu']",['membantu'],2,1,1,bantu,1,1
Sangat membantu,positif,2020-06-25,2020,sangat membantu,2,2,sangat membantu,2,2,"['sangat', 'membantu']",['membantu'],2,1,1,bantu,1,1
Sangat membantu,positif,2022-07-26,2022,sangat membantu,2,2,sangat membantu,2,2,"['sangat', 'membantu']",['membantu'],2,1,1,bantu,1,1
Sangat membantu,positif,2021-02-19,2021,sangat membantu,2,2,sangat membantu,2,2,"['sangat', 'membantu']",['membantu'],2,1,1,bantu,1,1
Sangat membantu,positif,2022-09-24,2022,sangat membantu,2,2,sangat membantu,2,2,"['sangat', 'membantu']",['membantu'],2,1,1,bantu,1,1
Sangat membantu,positif,2020-03-06,2020,sangat membantu,2,2,sangat membantu,2,2,"['sangat', 'membantu']",['membantu'],2,1,1,bantu,1,1
Sangat membantu,positif,2020-09-11,2020,sangat membantu,2,2,sangat membantu,2,2,"['sangat', 'membantu']",['membantu'],2,1,1,bantu,1,1
Cukup membantu,positif,2020-10-16,2020,cukup membantu,2,2,cukup membantu,2,2,"['cukup', 'membantu']",['membantu'],2,1,1,bantu,1,1
Bener bener profesional,positif,2022-02-19,2022,bener bener profesional,3,3,benar benar profesional,3,3,"['benar', 'benar', 'profesional']",['profesional'],3,1,2,profesional,1,1
Sangat membantu,positif,2020-10-08,2020,sangat membantu,2,2,sangat membantu,2,2,"['sangat', 'membantu']",['membantu'],2,1,1,bantu,1,1
Menambah jaringan,positif,2022-11-07,2022,menambah jaringan,2,2,menambah jaringan,2,2,"['menambah', 'jaringan']","['menambah', 'jaringan']",2,2,0,tambah jaring,2,2
Tingkatakan fitur,positif,2024-02-25,2024,tingkatakan fitur,2,2,tingkatakan fitur,2,2,"['tingkatakan', 'fitur']","['tingkatakan', 'fitur']",2,2,0,tingkatakan fitur,2,2
Menjadi lebih mudah,positif,2021-02-20,2021,menjadi lebih mudah,3,3,menjadi lebih mudah,3,3,"['menjadi', 'lebih', 'mudah']",['mudah'],3,1,2,mudah,1,1
Bermanfaat sekali,positif,2021-01-15,2021,bermanfaat sekali,2,2,bermanfaat sekali,2,2,"['bermanfaat', 'sekali']",['bermanfaat'],2,1,1,manfaat,1,1
Sangat membantu,positif,2021-01-26,2021,sangat membantu,2,2,sangat membantu,2,2,"['sangat', 'membantu']",['membantu'],2,1,1,bantu,1,1
mantap utk keuang,positif,2023-04-23,2023,mantap utk keuang,3,3,mantap untuk keuang,3,3,"['mantap', 'untuk', 'keuang']","['mantap', 'keuang']",3,2,1,mantap uang,2,2
Keren apk ini,positif,2024-04-05,2024,keren apk ini,3,3,keren aplikasi ini,3,3,"['keren', 'aplikasi', 'ini']","['keren', 'aplikasi']",3,2,1,keren aplikasi,2,2
bagus sekali,positif,2020-10-20,2020,bagus sekali,2,2,bagus sekali,2,2,"['bagus', 'sekali']",['bagus'],2,1,1,bagus,1,1
Sangat membantu,positif,2021-09-10,2021,sangat membantu,2,2,sangat membantu,2,2,"['sangat', 'membantu']",['membantu'],2,1,1,bantu,1,1
Sangat membantu,positif,2020-10-16,2020,sangat membantu,2,2,sangat membantu,2,2,"['sangat', 'membantu']",['membantu'],2,1,1,bantu,1,1
Bermanfaat bagi saya,positif,2022-12-13,2022,bermanfaat bagi saya,3,3,bermanfaat bagi saya,3,3,"['bermanfaat', 'bagi', 'saya']",['bermanfaat'],3,1,2,manfaat,1,1
Nyusahin. Teka teki gambarnya bikir ribet.,negatif,2022-06-13,2022,nyusahin teka teki gambarnya bikir ribet,6,6,nyusahin teka teki gambarnya bikir rumit,6,6,"['nyusahin', 'teka', 'teki', 'gambarnya', 'bikir', 'rumit']","['nyusahin', 'teka', 'teki', 'gambarnya', 'bikir', 'rumit']",6,6,0,nyusahin teka teki gambar bikir rumit,6,6
Sangat berguna 🙏🏼🙏🏼😇,positif,2020-07-22,2020,sangat berguna,3,2,sangat berguna,2,2,"['sangat', 'berguna']",['berguna'],2,1,1,guna,1,1
sangat membantu,positif,2021-01-04,2021,sangat membantu,2,2,sangat membantu,2,2,"['sangat', 'membantu']",['membantu'],2,1,1,bantu,1,1
Sangat membantu,positif,2023-11-18,2023,sangat membantu,2,2,sangat membantu,2,2,"['sangat', 'membantu']",['membantu'],2,1,1,bantu,1,1
Akun saya tiba2 hilang...,negatif,2020-01-25,2020,akun saya tiba hilang,4,4,akun saya tiba hilang,4,4,"['akun', 'saya', 'tiba', 'hilang']","['akun', 'hilang']",4,2,2,akun hilang,2,2
Sangat membantu,positif,2021-01-27,2021,sangat membantu,2,2,sangat membantu,2,2,"['sangat', 'membantu']",['membantu'],2,1,1,bantu,1,1
Sangat bermanfaat..,positif,2020-11-09,2020,sangat bermanfaat,2,2,sangat bermanfaat,2,2,"['sangat', 'bermanfaat']",['bermanfaat'],2,1,1,manfaat,1,1
Ribet orang pakai tebak gambar segala,negatif,2022-05-29,2022,ribet orang pakai tebak gambar segala,6,6,rumit orang pakai tebak gambar segala,6,6,"['rumit', 'orang', 'pakai', 'tebak', 'gambar', 'segala']","['rumit', 'orang', 'pakai', 'tebak', 'gambar']",6,5,1,rumit orang pakai tebak gambar,5,5
Verifikasinya ribet,negatif,2024-03-05,2024,verifikasinya ribet,2,2,verifikasinya rumit,2,2,"['verifikasinya', 'rumit']","['verifikasinya', 'rumit']",2,2,0,verifikasi rumit,2,2
Mantap dan insfiratip,positif,2020-07-03,2020,mantap dan insfiratip,3,3,mantap dan insfiratip,3,3,"['mantap', 'dan', 'insfiratip']","['mantap', 'insfiratip']",3,2,1,mantap insfiratip,2,2
Ashu kagak pernah di lihat lamaran gua,negatif,2022-08-18,2022,ashu kagak pernah di lihat lamaran gua,7,7,ashu tidak pernah di lihat lamaran saya,7,7,"['ashu', 'tidak', 'pernah', 'di', 'lihat', 'lamaran', 'saya']","['ashu', 'tidak', 'lihat', 'lamaran']",7,4,3,ashu tidak lihat lamar,4,4
Di perumit dengan test teka-teki di.awal masuk,negatif,2021-04-20,2021,di perumit dengan test teka teki di awal masuk,7,9,di perumit dengan test teka teki di awal masuk,9,9,"['di', 'perumit', 'dengan', 'test', 'teka', 'teki', 'di', 'awal', 'masuk']","['perumit', 'test', 'teka', 'teki', 'masuk']",9,5,4,rumit test teka teki masuk,5,5
Cukup membantu,positif,2023-02-21,2023,cukup membantu,2,2,cukup membantu,2,2,"['cukup', 'membantu']",['membantu'],2,1,1,bantu,1,1
Susahnya lpgin bikin bete,negatif,2023-11-24,2023,susahnya lpgin bikin bete,4,4,susahnya lpgin bikin bosan,4,4,"['susahnya', 'lpgin', 'bikin', 'bosan']","['susahnya', 'lpgin', 'bikin', 'bosan']",4,4,0,susah lpgin bikin bosan,4,4
Sangat sangat bagus,positif,2021-12-30,2021,sangat sangat bagus,3,3,sangat sangat bagus,3,3,"['sangat', 'sangat', 'bagus']",['bagus'],3,1,2,bagus,1,1
Saya suka aplikasi ini,positif,2023-04-24,2023,saya suka aplikasi ini,4,4,saya suka aplikasi ini,4,4,"['saya', 'suka', 'aplikasi', 'ini']","['suka', 'aplikasi']",4,2,2,suka aplikasi,2,2
Sangat membantu 😉,positif,2020-11-05,2020,sangat membantu,3,2,sangat membantu,2,2,"['sangat', 'membantu']",['membantu'],2,1,1,bantu,1,1
Pertahankan Pelayanan dan Perketat pengawasan Produk Abal Abal,positif,2020-08-23,2020,pertahankan pelayanan dan perketat pengawasan produk abal abal,8,8,pertahankan pelayanan dan perketat pengawasan produk abal abal,8,8,"['pertahankan', 'pelayanan', 'dan', 'perketat', 'pengawasan', 'produk', 'abal', 'abal']","['pertahankan', 'pelayanan', 'perketat', 'pengawasan', 'produk', 'abal', 'abal']",8,7,1,tahan layan ketat awas produk abal abal,7,7
Terimakasih atas bantuannya,positif,2021-07-05,2021,terimakasih atas bantuannya,3,3,terima kasih atas bantuannya,3,4,"['terima', 'kasih', 'atas', 'bantuannya']","['terima', 'kasih', 'bantuannya']",4,3,1,terima kasih bantu,3,3
Bagus buat semua,positif,2023-02-23,2023,bagus buat semua,3,3,bagus buat semua,3,3,"['bagus', 'buat', 'semua']",['bagus'],3,1,2,bagus,1,1
Senang bisa bergabung di LinkedIn,positif,2023-02-17,2023,senang bisa bergabung di linkedin,5,5,senang bisa bergabung di linkedin,5,5,"['senang', 'bisa', 'bergabung', 'di', 'linkedin']","['senang', 'bergabung', 'linkedin']",5,3,2,senang gabung linkedin,3,3
Aplikasi yang bagus,positif,2021-02-25,2021,aplikasi yang bagus,3,3,aplikasi yang bagus,3,3,"['aplikasi', 'yang', 'bagus']","['aplikasi', 'bagus']",3,2,1,aplikasi bagus,2,2
Saya bangga aplikasi ini.,positif,2021-02-03,2021,saya bangga aplikasi ini,4,4,saya bangga aplikasi ini,4,4,"['saya', 'bangga', 'aplikasi', 'ini']","['bangga', 'aplikasi']",4,2,2,bangga aplikasi,2,2
Sangat membatu good,positif,2021-12-17,2021,sangat membatu good,3,3,sangat membantu bagus,3,3,"['sangat', 'membantu', 'bagus']","['membantu', 'bagus']",3,2,1,bantu bagus,2,2
Bismillahirrahmanirrahim Assalamualaikum warahmatullahi wabarakatuh,positif,2021-09-05,2021,bismillahirrahmanirrahim assalamualaikum warahmatullahi wabarakatuh,4,4,bismillahirrahmanirrahim assalamualaikum warahmatullahi wabarakatuh,4,4,"['bismillahirrahmanirrahim', 'assalamualaikum', 'warahmatullahi', 'wabarakatuh']","['bismillahirrahmanirrahim', 'assalamualaikum', 'warahmatullahi', 'wabarakatuh']",4,4,0,bismillahirrahmanirrahim assalamualaikum warahmatullahi wabarakatuh,4,4
Kenapa sekarang sering eror,negatif,2021-10-26,2021,kenapa sekarang sering eror,4,4,kenapa sekarang sering error,4,4,"['kenapa', 'sekarang', 'sering', 'error']",['error'],4,1,3,error,1,1
Apknya mantap dah,positif,2020-11-12,2020,apknya mantap dah,3,3,aplikasinya mantap sudah,3,3,"['aplikasinya', 'mantap', 'sudah']","['aplikasinya', 'mantap']",3,2,1,aplikasi mantap,2,2
Sangat membantu,positif,2020-04-11,2020,sangat membantu,2,2,sangat membantu,2,2,"['sangat', 'membantu']",['membantu'],2,1,1,bantu,1,1
Sangat membantu,positif,2022-05-24,2022,sangat membantu,2,2,sangat membantu,2,2,"['sangat', 'membantu']",['membantu'],2,1,1,bantu,1,1
verifikasi salah mulu. sampah,negatif,2023-05-17,2023,verifikasi salah mulu sampah,4,4,verifikasi salah mulu sampah,4,4,"['verifikasi', 'salah', 'mulu', 'sampah']","['verifikasi', 'salah', 'mulu', 'sampah']",4,4,0,verifikasi salah mulu sampah,4,4
Sangat membantu,positif,2022-12-30,2022,sangat membantu,2,2,sangat membantu,2,2,"['sangat', 'membantu']",['membantu'],2,1,1,bantu,1,1
Sangat membantu,positif,2020-10-20,2020,sangat membantu,2,2,sangat membantu,2,2,"['sangat', 'membantu']",['membantu'],2,1,1,bantu,1,1
Sangat membantu,positif,2022-07-02,2022,sangat membantu,2,2,sangat membantu,2,2,"['sangat', 'membantu']",['membantu'],2,1,1,bantu,1,1
Sangat membantu,positif,2020-04-06,2020,sangat membantu,2,2,sangat membantu,2,2,"['sangat', 'membantu']",['membantu'],2,1,1,bantu,1,1
Bagus dan berguna,positif,2020-10-30,2020,bagus dan berguna,3,3,bagus dan berguna,3,3,"['bagus', 'dan', 'berguna']","['bagus', 'berguna']",3,2,1,bagus guna,2,2
Aplikasi sangat buruk,negatif,2023-09-25,2023,aplikasi sangat buruk,3,3,aplikasi sangat buruk,3,3,"['aplikasi', 'sangat', 'buruk']","['aplikasi', 'buruk']",3,2,1,aplikasi buruk,2,2
Sangat membantu,positif,2022-05-26,2022,sangat membantu,2,2,sangat membantu,2,2,"['sangat', 'membantu']",['membantu'],2,1,1,bantu,1,1
Sangat membantu,positif,2023-09-27,2023,sangat membantu,2,2,sangat membantu,2,2,"['sangat', 'membantu']",['membantu'],2,1,1,bantu,1,1
sangat membantu,positif,2021-09-01,2021,sangat membantu,2,2,sangat membantu,2,2,"['sangat', 'membantu']",['membantu'],2,1,1,bantu,1,1
Baguslah pokoknya,positif,2022-11-14,2022,baguslah pokoknya,2,2,baguslah pokoknya,2,2,"['baguslah', 'pokoknya']","['baguslah', 'pokoknya']",2,2,0,bagus pokok,2,2
Semoga dapat pekerjaan,positif,2023-07-01,2023,semoga dapat pekerjaan,3,3,semoga dapat pekerjaan,3,3,"['semoga', 'dapat', 'pekerjaan']","['semoga', 'pekerjaan']",3,2,1,moga kerja,2,2
Sangat membantu,positif,2022-02-26,2022,sangat membantu,2,2,sangat membantu,2,2,"['sangat', 'membantu']",['membantu'],2,1,1,bantu,1,1
Terima kasih Linkedln,positif,2020-01-14,2020,terima kasih linkedln,3,3,terima kasih linkedln,3,3,"['terima', 'kasih', 'linkedln']","['terima', 'kasih', 'linkedln']",3,3,0,terima kasih linkedln,3,3
Aku ketagihan makanya aku kasih bintah 5,positif,2020-04-14,2020,aku ketagihan makanya aku kasih bintah,7,6,aku ketagihan makanya aku kasih bintah,6,6,"['aku', 'ketagihan', 'makanya', 'aku', 'kasih', 'bintah']","['ketagihan', 'kasih', 'bintah']",6,3,3,tagih kasih bin,3,3
Sangat bermanfaat,positif,2022-03-05,2022,sangat bermanfaat,2,2,sangat bermanfaat,2,2,"['sangat', 'bermanfaat']",['bermanfaat'],2,1,1,manfaat,1,1
Verif captha gak jelas..,negatif,2024-08-03,2024,verif captha gak jelas,4,4,verif captha tidak jelas,4,4,"['verif', 'captha', 'tidak', 'jelas']","['verif', 'captha', 'tidak']",4,3,1,verif captha tidak,3,3
Membatntu untuk mememukan jenjang karir,positif,2021-12-10,2021,membatntu untuk mememukan jenjang karir,5,5,membatntu untuk mememukan jenjang karir,5,5,"['membatntu', 'untuk', 'mememukan', 'jenjang', 'karir']","['membatntu', 'mememukan', 'jenjang', 'karir']",5,4,1,membatntu mu jenjang karir,4,4
Mantap dan mak yus.,positif,2022-02-06,2022,mantap dan mak yus,4,4,mantap dan ibu yus,4,4,"['mantap', 'dan', 'ibu', 'yus']","['mantap', 'yus']",4,2,2,mantap yus,2,2
Aplikasi kontolll gk jelas babi verifikasi bikin emosi hapus aja babi,negatif,2024-02-17,2024,aplikasi kontolll gk jelas babi verifikasi bikin emosi hapus aja babi,11,11,aplikasi kontolll tidak jelas babi verifikasi bikin emosi hapus saja babi,11,11,"['aplikasi', 'kontolll', 'tidak', 'jelas', 'babi', 'verifikasi', 'bikin', 'emosi', 'hapus', 'saja', 'babi']","['aplikasi', 'kontolll', 'tidak', 'babi', 'verifikasi', 'bikin', 'emosi', 'hapus', 'babi']",11,9,2,aplikasi kontolll tidak babi verifikasi bikin emosi hapus babi,9,9
Sangat bermanfaat,positif,2020-02-18,2020,sangat bermanfaat,2,2,sangat bermanfaat,2,2,"['sangat', 'bermanfaat']",['bermanfaat'],2,1,1,manfaat,1,1
Keren dan membantu,positif,2020-11-04,2020,keren dan membantu,3,3,keren dan membantu,3,3,"['keren', 'dan', 'membantu']","['keren', 'membantu']",3,2,1,keren bantu,2,2
Sangat membantu,positif,2021-09-25,2021,sangat membantu,2,2,sangat membantu,2,2,"['sangat', 'membantu']",['membantu'],2,1,1,bantu,1,1
Susah untuk membuat akun,negatif,2023-04-15,2023,susah untuk membuat akun,4,4,susah untuk membuat akun,4,4,"['susah', 'untuk', 'membuat', 'akun']","['susah', 'akun']",4,2,2,susah akun,2,2
Terbaik. Terimakasih,positif,2020-10-12,2020,terbaik terimakasih,2,2,terbaik terima kasih,2,3,"['terbaik', 'terima', 'kasih']","['terbaik', 'terima', 'kasih']",3,3,0,baik terima kasih,3,3
semoga dapat kerjaan,positif,2020-07-07,2020,semoga dapat kerjaan,3,3,semoga dapat kerjaan,3,3,"['semoga', 'dapat', 'kerjaan']","['semoga', 'kerjaan']",3,2,1,moga kerja,2,2
Rada ribet caranya,negatif,2022-12-08,2022,rada ribet caranya,3,3,rada rumit caranya,3,3,"['rada', 'rumit', 'caranya']","['rada', 'rumit']",3,2,1,rada rumit,2,2
Sangat berguna,positif,2022-04-19,2022,sangat berguna,2,2,sangat berguna,2,2,"['sangat', 'berguna']",['berguna'],2,1,1,guna,1,1
CAPTHA CAPTHA GAK JELAS !!!!,negatif,2023-08-07,2023,captha captha gak jelas,5,4,captha captha tidak jelas,4,4,"['captha', 'captha', 'tidak', 'jelas']","['captha', 'captha', 'tidak']",4,3,1,captha captha tidak,3,3
Ga bisa verifikasi,negatif,2022-07-06,2022,ga bisa verifikasi,3,3,tidak bisa verifikasi,3,3,"['tidak', 'bisa', 'verifikasi']","['tidak', 'verifikasi']",3,2,1,tidak verifikasi,2,2
Sangat membantu,positif,2020-08-02,2020,sangat membantu,2,2,sangat membantu,2,2,"['sangat', 'membantu']",['membantu'],2,1,1,bantu,1,1
Sangat² membantu,positif,2022-02-22,2022,sangat² membantu,2,2,sangat² membantu,2,2,"['sangat²', 'membantu']","['sangat²', 'membantu']",2,2,0,sangat bantu,2,2
Sip. Salam kenal dari SUDUT DESA,positif,2020-08-12,2020,sip salam kenal dari sudut desa,6,6,sip salam kenal dari sudut desa,6,6,"['sip', 'salam', 'kenal', 'dari', 'sudut', 'desa']","['sip', 'salam', 'kenal', 'sudut', 'desa']",6,5,1,sip salam kenal sudut desa,5,5
Cepat responya,positif,2023-10-17,2023,cepat responya,2,2,cepat responya,2,2,"['cepat', 'responya']","['cepat', 'responya']",2,2,0,cepat responya,2,2
Apl nya paling ok.,positif,2022-03-12,2022,apl nya paling ok,4,4,aplikasi nya paling oke,4,4,"['aplikasi', 'nya', 'paling', 'oke']","['aplikasi', 'nya', 'oke']",4,3,1,aplikasi nya oke,3,3
Akun saya kena hack bro gimana ini?,negatif,2024-02-18,2024,akun saya kena hack bro gimana ini,7,7,akun saya kena hack bro bagaimana ini,7,7,"['akun', 'saya', 'kena', 'hack', 'bro', 'bagaimana', 'ini']","['akun', 'kena', 'hack', 'bro']",7,4,3,akun kena hack bro,4,4
Sangan memberi informasi tentang loker,positif,2023-08-26,2023,sangan memberi informasi tentang loker,5,5,sangat memberi informasi tentang loker,5,5,"['sangat', 'memberi', 'informasi', 'tentang', 'loker']","['informasi', 'loker']",5,2,3,informasi loker,2,2
Sangat membantu👍,positif,2020-08-04,2020,sangat membantu,2,2,sangat membantu,2,2,"['sangat', 'membantu']",['membantu'],2,1,1,bantu,1,1
Semoga linkedin membawaku kepada pekerjaan impianku 😇,positif,2022-09-21,2022,semoga linkedin membawaku kepada pekerjaan impianku,7,6,semoga linkedin membawaku kepada pekerjaan impianku,6,6,"['semoga', 'linkedin', 'membawaku', 'kepada', 'pekerjaan', 'impianku']","['semoga', 'linkedin', 'membawaku', 'pekerjaan', 'impianku']",6,5,1,moga linkedin bawa kerja impi,5,5
Mudah-mudahan ada cintanya,positif,2022-05-31,2022,mudah mudahan ada cintanya,3,4,mudah mudahan ada cintanya,4,4,"['mudah', 'mudahan', 'ada', 'cintanya']","['mudah', 'mudahan', 'cintanya']",4,3,1,mudah mudah cinta,3,3
Sangat terhibur,positif,2021-01-04,2021,sangat terhibur,2,2,sangat terhibur,2,2,"['sangat', 'terhibur']",['terhibur'],2,1,1,hibur,1,1
Aplikasi gak jelas,negatif,2024-02-09,2024,aplikasi gak jelas,3,3,aplikasi tidak jelas,3,3,"['aplikasi', 'tidak', 'jelas']","['aplikasi', 'tidak']",3,2,1,aplikasi tidak,2,2
Verifikasi gk jelas,negatif,2023-05-11,2023,verifikasi gk jelas,3,3,verifikasi tidak jelas,3,3,"['verifikasi', 'tidak', 'jelas']","['verifikasi', 'tidak']",3,2,1,verifikasi tidak,2,2
Tolong kirim email saya mau komplain,negatif,2023-07-03,2023,tolong kirim email saya mau komplain,6,6,tolong kirim email saya mau komplain,6,6,"['tolong', 'kirim', 'email', 'saya', 'mau', 'komplain']","['tolong', 'kirim', 'email', 'komplain']",6,4,2,tolong kirim email komplain,4,4
Bagus pokok nya,positif,2021-09-17,2021,bagus pokok nya,3,3,bagus pokok nya,3,3,"['bagus', 'pokok', 'nya']","['bagus', 'pokok', 'nya']",3,3,0,bagus pokok nya,3,3
Aplikasi memudahkan,positif,2021-07-04,2021,aplikasi memudahkan,2,2,aplikasi memudahkan,2,2,"['aplikasi', 'memudahkan']","['aplikasi', 'memudahkan']",2,2,0,aplikasi mudah,2,2
Masuk akun sendiri aja susah kali,negatif,2022-11-01,2022,masuk akun sendiri aja susah kali,6,6,masuk akun sendiri saja susah kali,6,6,"['masuk', 'akun', 'sendiri', 'saja', 'susah', 'kali']","['masuk', 'akun', 'susah', 'kali']",6,4,2,masuk akun susah kali,4,4
Akun tidak bermanfaat,negatif,2022-04-11,2022,akun tidak bermanfaat,3,3,akun tidak bermanfaat,3,3,"['akun', 'tidak', 'bermanfaat']","['akun', 'tidak', 'bermanfaat']",3,3,0,akun tidak manfaat,3,3
Sangat membantu,positif,2021-12-06,2021,sangat membantu,2,2,sangat membantu,2,2,"['sangat', 'membantu']",['membantu'],2,1,1,bantu,1,1
Kita coba dulu apliksinya,positif,2023-03-12,2023,kita coba dulu apliksinya,4,4,kita coba dahulu apliksinya,4,4,"['kita', 'coba', 'dahulu', 'apliksinya']","['coba', 'apliksinya']",4,2,2,coba apliksinya,2,2
bagus sekali,positif,2022-06-12,2022,bagus sekali,2,2,bagus sekali,2,2,"['bagus', 'sekali']",['bagus'],2,1,1,bagus,1,1
Sukses kan dengan baik,positif,2023-10-27,2023,sukses kan dengan baik,4,4,sukses akan dengan baik,4,4,"['sukses', 'akan', 'dengan', 'baik']",['sukses'],4,1,3,sukses,1,1
Jadilah pejuang jangan jadi pahlawan,positif,2020-08-09,2020,jadilah pejuang jangan jadi pahlawan,5,5,jadilah pejuang jangan jadi pahlawan,5,5,"['jadilah', 'pejuang', 'jangan', 'jadi', 'pahlawan']","['pejuang', 'pahlawan']",5,2,3,juang pahlawan,2,2
"Gak bisa masuk, gara² capca",negatif,2023-08-09,2023,gak bisa masuk gara² capca,5,5,tidak bisa masuk gara² capca,5,5,"['tidak', 'bisa', 'masuk', 'gara²', 'capca']","['tidak', 'masuk', 'gara²', 'capca']",5,4,1,tidak masuk gara capca,4,4
sangat membantu,positif,2021-03-29,2021,sangat membantu,2,2,sangat membantu,2,2,"['sangat', 'membantu']",['membantu'],2,1,1,bantu,1,1
Maaf saya tidak tertarik,negatif,2021-08-30,2021,maaf saya tidak tertarik,4,4,maaf saya tidak tertarik,4,4,"['maaf', 'saya', 'tidak', 'tertarik']","['maaf', 'tidak', 'tertarik']",4,3,1,maaf tidak tarik,3,3
Sangat membantu,positif,2023-10-11,2023,sangat membantu,2,2,sangat membantu,2,2,"['sangat', 'membantu']",['membantu'],2,1,1,bantu,1,1
sangat bermanfaat,positif,2020-07-02,2020,sangat bermanfaat,2,2,sangat bermanfaat,2,2,"['sangat', 'bermanfaat']",['bermanfaat'],2,1,1,manfaat,1,1
Cepat terhubung,positif,2023-06-20,2023,cepat terhubung,2,2,cepat terhubung,2,2,"['cepat', 'terhubung']","['cepat', 'terhubung']",2,2,0,cepat hubung,2,2
Sangat membantu,positif,2021-10-02,2021,sangat membantu,2,2,sangat membantu,2,2,"['sangat', 'membantu']",['membantu'],2,1,1,bantu,1,1
Sangat membantu,positif,2021-11-18,2021,sangat membantu,2,2,sangat membantu,2,2,"['sangat', 'membantu']",['membantu'],2,1,1,bantu,1,1
Tidak bisa membuat akun,negatif,2022-02-05,2022,tidak bisa membuat akun,4,4,tidak bisa membuat akun,4,4,"['tidak', 'bisa', 'membuat', 'akun']","['tidak', 'akun']",4,2,2,tidak akun,2,2
Sangat membantu,positif,2020-05-09,2020,sangat membantu,2,2,sangat membantu,2,2,"['sangat', 'membantu']",['membantu'],2,1,1,bantu,1,1
Sangat membantu,positif,2021-08-28,2021,sangat membantu,2,2,sangat membantu,2,2,"['sangat', 'membantu']",['membantu'],2,1,1,bantu,1,1
RIBET AMAT VERIFIKASI LOGIN NYA,negatif,2022-12-16,2022,ribet amat verifikasi login nya,5,5,rumit amat verifikasi login nya,5,5,"['rumit', 'amat', 'verifikasi', 'login', 'nya']","['rumit', 'verifikasi', 'login', 'nya']",5,4,1,rumit verifikasi login nya,4,4
ingin mencoba..dan mulai💪,positif,2024-08-07,2024,ingin mencoba dan mulai,3,4,ingin mencoba dan mulai,4,4,"['ingin', 'mencoba', 'dan', 'mulai']",['mencoba'],4,1,3,coba,1,1
Sangat membantu,positif,2021-03-07,2021,sangat membantu,2,2,sangat membantu,2,2,"['sangat', 'membantu']",['membantu'],2,1,1,bantu,1,1
Sangat membantu,positif,2022-01-01,2022,sangat membantu,2,2,sangat membantu,2,2,"['sangat', 'membantu']",['membantu'],2,1,1,bantu,1,1
Sangat membantu,positif,2021-09-16,2021,sangat membantu,2,2,sangat membantu,2,2,"['sangat', 'membantu']",['membantu'],2,1,1,bantu,1,1
Sangat bermanfaat,positif,2020-04-02,2020,sangat bermanfaat,2,2,sangat bermanfaat,2,2,"['sangat', 'bermanfaat']",['bermanfaat'],2,1,1,manfaat,1,1
Sangat membantu saya,positif,2023-11-24,2023,sangat membantu saya,3,3,sangat membantu saya,3,3,"['sangat', 'membantu', 'saya']",['membantu'],3,1,2,bantu,1,1
Akurat dan Relevan👍,positif,2024-01-08,2024,akurat dan relevan,3,3,akurat dan relevan,3,3,"['akurat', 'dan', 'relevan']","['akurat', 'relevan']",3,2,1,akurat relevan,2,2
moga bermanfaat dg linkedIn,positif,2020-10-28,2020,moga bermanfaat dg linkedin,4,4,semoga bermanfaat dengan linkedin,4,4,"['semoga', 'bermanfaat', 'dengan', 'linkedin']","['semoga', 'bermanfaat', 'linkedin']",4,3,1,moga manfaat linkedin,3,3
Sangat membantu saya,positif,2021-09-13,2021,sangat membantu saya,3,3,sangat membantu saya,3,3,"['sangat', 'membantu', 'saya']",['membantu'],3,1,2,bantu,1,1
Sangat membatu,positif,2020-03-13,2020,sangat membatu,2,2,sangat membantu,2,2,"['sangat', 'membantu']",['membantu'],2,1,1,bantu,1,1
Membantu selalu,positif,2023-09-10,2023,membantu selalu,2,2,membantu selalu,2,2,"['membantu', 'selalu']",['membantu'],2,1,1,bantu,1,1
Ribet bgt mau login doang,negatif,2023-10-03,2023,ribet bgt mau login doang,5,5,rumit banget mau login saja,5,5,"['rumit', 'banget', 'mau', 'login', 'saja']","['rumit', 'banget', 'login']",5,3,2,rumit banget login,3,3
Ya saya sangat suka,positif,2022-04-08,2022,ya saya sangat suka,4,4,ya saya sangat suka,4,4,"['ya', 'saya', 'sangat', 'suka']","['ya', 'suka']",4,2,2,ya suka,2,2
Saya suka Masi di Linkedln in,positif,2022-06-13,2022,saya suka masi di linkedln in,6,6,saya suka masih di linkedln in,6,6,"['saya', 'suka', 'masih', 'di', 'linkedln', 'in']","['suka', 'linkedln', 'in']",6,3,3,suka linkedln in,3,3
Aplikasi gk jelas,negatif,2022-03-12,2022,aplikasi gk jelas,3,3,aplikasi tidak jelas,3,3,"['aplikasi', 'tidak', 'jelas']","['aplikasi', 'tidak']",3,2,1,aplikasi tidak,2,2
Mantap aplikasinya,positif,2024-06-11,2024,mantap aplikasinya,2,2,mantap aplikasi nya,2,3,"['mantap', 'aplikasi', 'nya']","['mantap', 'aplikasi', 'nya']",3,3,0,mantap aplikasi nya,3,3
Taik bolak balik verifikasi katak setannnnnn apk nya,negatif,2023-01-20,2023,taik bolak balik verifikasi katak setannnnnn apk nya,8,8,taik bolak balik verifikasi katak setannnnnn aplikasi nya,8,8,"['taik', 'bolak', 'balik', 'verifikasi', 'katak', 'setannnnnn', 'aplikasi', 'nya']","['taik', 'bolak', 'verifikasi', 'katak', 'setannnnnn', 'aplikasi', 'nya']",8,7,1,taik bolak verifikasi katak setannnnnn aplikasi nya,7,7
Mudah2 bisa membantu,positif,2020-03-04,2020,mudah bisa membantu,3,3,mudah bisa membantu,3,3,"['mudah', 'bisa', 'membantu']","['mudah', 'membantu']",3,2,1,mudah bantu,2,2
Cukup membantu,positif,2020-02-14,2020,cukup membantu,2,2,cukup membantu,2,2,"['cukup', 'membantu']",['membantu'],2,1,1,bantu,1,1
Aplikasi abal abal,negatif,2024-01-31,2024,aplikasi abal abal,3,3,aplikasi abal abal,3,3,"['aplikasi', 'abal', 'abal']","['aplikasi', 'abal', 'abal']",3,3,0,aplikasi abal abal,3,3
Ini sangat membantu,positif,2021-10-06,2021,ini sangat membantu,3,3,ini sangat membantu,3,3,"['ini', 'sangat', 'membantu']",['membantu'],3,1,2,bantu,1,1
Aplikasi yg bagus,positif,2020-06-05,2020,aplikasi yg bagus,3,3,aplikasi yang bagus,3,3,"['aplikasi', 'yang', 'bagus']","['aplikasi', 'bagus']",3,2,1,aplikasi bagus,2,2
Sangat bermanfaat,positif,2022-01-24,2022,sangat bermanfaat,2,2,sangat bermanfaat,2,2,"['sangat', 'bermanfaat']",['bermanfaat'],2,1,1,manfaat,1,1
Cukup memuaskan,positif,2020-06-03,2020,cukup memuaskan,2,2,cukup memuaskan,2,2,"['cukup', 'memuaskan']",['memuaskan'],2,1,1,muas,1,1
"Bagus, bermanfaat",positif,2020-08-01,2020,bagus bermanfaat,2,2,bagus bermanfaat,2,2,"['bagus', 'bermanfaat']","['bagus', 'bermanfaat']",2,2,0,bagus manfaat,2,2
Bismillah semoga dapat pekerjaan yang layak,positif,2022-01-16,2022,bismillah semoga dapat pekerjaan yang layak,6,6,bismillah semoga dapat pekerjaan yang layak,6,6,"['bismillah', 'semoga', 'dapat', 'pekerjaan', 'yang', 'layak']","['bismillah', 'semoga', 'pekerjaan', 'layak']",6,4,2,bismillah moga kerja layak,4,4
Yaa sangat membantu sih,positif,2021-04-21,2021,yaa sangat membantu sih,4,4,ya sangat membantu sih,4,4,"['ya', 'sangat', 'membantu', 'sih']","['ya', 'membantu', 'sih']",4,3,1,ya bantu sih,3,3
sangat bermanfaat,positif,2022-12-15,2022,sangat bermanfaat,2,2,sangat bermanfaat,2,2,"['sangat', 'bermanfaat']",['bermanfaat'],2,1,1,manfaat,1,1
Semoga bermanfaat.. saya kasi bintang 5 sekalian,positif,2022-06-25,2022,semoga bermanfaat saya kasi bintang sekalian,7,6,semoga bermanfaat saya kasih bintang sekalian,6,6,"['semoga', 'bermanfaat', 'saya', 'kasih', 'bintang', 'sekalian']","['semoga', 'bermanfaat', 'kasih', 'bintang']",6,4,2,moga manfaat kasih bintang,4,4
Semoga baik di pertama kali nyoba,positif,2021-12-06,2021,semoga baik di pertama kali nyoba,6,6,semoga baik di pertama kali mencoba,6,6,"['semoga', 'baik', 'di', 'pertama', 'kali', 'mencoba']","['semoga', 'kali', 'mencoba']",6,3,3,moga kali coba,3,3
Keren banget deh,positif,2020-11-18,2020,keren banget deh,3,3,keren banget deh,3,3,"['keren', 'banget', 'deh']","['keren', 'banget', 'deh']",3,3,0,keren banget deh,3,3
informasi yg Bagus,positif,2020-07-16,2020,informasi yg bagus,3,3,informasi yang bagus,3,3,"['informasi', 'yang', 'bagus']","['informasi', 'bagus']",3,2,1,informasi bagus,2,2
Kumpulan Orang-orang Sukses !!!,positif,2021-02-11,2021,kumpulan orang orang sukses,4,4,kumpulan orang orang sukses,4,4,"['kumpulan', 'orang', 'orang', 'sukses']","['kumpulan', 'orang', 'orang', 'sukses']",4,4,0,kumpul orang orang sukses,4,4
Keren banget deh,positif,2020-11-08,2020,keren banget deh,3,3,keren banget deh,3,3,"['keren', 'banget', 'deh']","['keren', 'banget', 'deh']",3,3,0,keren banget deh,3,3
Top markotop aja dulu...,positif,2022-01-20,2022,top markotop aja dulu,4,4,top sekali saja dahulu,4,4,"['top', 'sekali', 'saja', 'dahulu']",['top'],4,1,3,top,1,1
Aplikasi nya Buruk,negatif,2024-01-21,2024,aplikasi nya buruk,3,3,aplikasi nya buruk,3,3,"['aplikasi', 'nya', 'buruk']","['aplikasi', 'nya', 'buruk']",3,3,0,aplikasi nya buruk,3,3
Sulit menggunakannya,negatif,2021-11-01,2021,sulit menggunakannya,2,2,sulit menggunakannya,2,2,"['sulit', 'menggunakannya']","['sulit', 'menggunakannya']",2,2,0,sulit guna,2,2
"jika bagi anda relasi itu penting, anda akan temukan mereka disini.",positif,2023-11-26,2023,jika bagi anda relasi itu penting anda akan temukan mereka disini,11,11,jika bagi anda relasi itu penting anda akan temukan mereka disini,11,11,"['jika', 'bagi', 'anda', 'relasi', 'itu', 'penting', 'anda', 'akan', 'temukan', 'mereka', 'disini']","['relasi', 'temukan']",11,2,9,relasi temu,2,2
Semoga saya dpt perkerjaan,positif,2022-08-21,2022,semoga saya dpt perkerjaan,4,4,semoga saya dapat perkerjaan,4,4,"['semoga', 'saya', 'dapat', 'perkerjaan']","['semoga', 'perkerjaan']",4,2,2,moga kerja,2,2
Sangat memuaskan,positif,2022-11-19,2022,sangat memuaskan,2,2,sangat memuaskan,2,2,"['sangat', 'memuaskan']",['memuaskan'],2,1,1,muas,1,1
Sangat bermanfaat,positif,2021-05-10,2021,sangat bermanfaat,2,2,sangat bermanfaat,2,2,"['sangat', 'bermanfaat']",['bermanfaat'],2,1,1,manfaat,1,1
Sangat bermanfaat,positif,2022-05-29,2022,sangat bermanfaat,2,2,sangat bermanfaat,2,2,"['sangat', 'bermanfaat']",['bermanfaat'],2,1,1,manfaat,1,1
Sangat memuaskan,positif,2022-09-06,2022,sangat memuaskan,2,2,sangat memuaskan,2,2,"['sangat', 'memuaskan']",['memuaskan'],2,1,1,muas,1,1
Siap bekerja,positif,2021-09-25,2021,siap bekerja,2,2,siap bekerja,2,2,"['siap', 'bekerja']",[],2,1,1,,1,0
Good...mantap!,positif,2022-02-11,2022,good mantap,1,2,bagus mantap,2,2,"['bagus', 'mantap']","['bagus', 'mantap']",2,2,0,bagus mantap,2,2
Login jadi ribet,negatif,2023-08-16,2023,login jadi ribet,3,3,login jadi rumit,3,3,"['login', 'jadi', 'rumit']","['login', 'rumit']",3,2,1,login rumit,2,2
Gak sesuai harapan,negatif,2024-04-04,2024,gak sesuai harapan,3,3,tidak sesuai harapan,3,3,"['tidak', 'sesuai', 'harapan']","['tidak', 'sesuai', 'harapan']",3,3,0,tidak sesuai harap,3,3
Selalu siap sedia semangat 45,positif,2022-04-05,2022,selalu siap sedia semangat,5,4,selalu siap sedia semangat,4,4,"['selalu', 'siap', 'sedia', 'semangat']","['sedia', 'semangat']",4,2,2,sedia semangat,2,2
Mendapat informasi terkait profesi saya.,positif,2020-07-29,2020,mendapat informasi terkait profesi saya,5,5,mendapat informasi terkait profesi saya,5,5,"['mendapat', 'informasi', 'terkait', 'profesi', 'saya']","['informasi', 'terkait', 'profesi']",5,3,2,informasi kait profesi,3,3
Insha Allah bisa membantu,positif,2023-09-03,2023,insha allah bisa membantu,4,4,insha allah bisa membantu,4,4,"['insha', 'allah', 'bisa', 'membantu']","['insha', 'allah', 'membantu']",4,3,1,insha allah bantu,3,3
Mau buat akunpun ribet,negatif,2022-08-02,2022,mau buat akunpun ribet,4,4,mau buat akunpun rumit,4,4,"['mau', 'buat', 'akunpun', 'rumit']","['akunpun', 'rumit']",4,2,2,akun rumit,2,2
"Bergabunglah dg group in, inshaa Allah bermanfaat.",positif,2021-04-06,2021,bergabunglah dg group in inshaa allah bermanfaat,7,7,bergabunglah dengan group in inshaa allah bermanfaat,7,7,"['bergabunglah', 'dengan', 'group', 'in', 'inshaa', 'allah', 'bermanfaat']","['bergabunglah', 'group', 'in', 'inshaa', 'allah', 'bermanfaat']",7,6,1,gabung group in inshaa allah manfaat,6,6
Terima kasih perkenalan saya di Linkedin,positif,2020-03-21,2020,terima kasih perkenalan saya di linkedin,6,6,terima kasih perkenalan saya di linkedin,6,6,"['terima', 'kasih', 'perkenalan', 'saya', 'di', 'linkedin']","['terima', 'kasih', 'perkenalan', 'linkedin']",6,4,2,terima kasih kenal linkedin,4,4
Sangat membantu,positif,2023-11-07,2023,sangat membantu,2,2,sangat membantu,2,2,"['sangat', 'membantu']",['membantu'],2,1,1,bantu,1,1
verifikasi nya aneh,negatif,2023-10-04,2023,verifikasi nya aneh,3,3,verifikasi nya aneh,3,3,"['verifikasi', 'nya', 'aneh']","['verifikasi', 'nya', 'aneh']",3,3,0,verifikasi nya aneh,3,3
Sangat membantù,positif,2023-10-31,2023,sangat membantù,2,2,sangat membantù,2,2,"['sangat', 'membantù']",['membantù'],2,1,1,membant,1,1
Banyak orang-orang hebat di sini,positif,2021-01-22,2021,banyak orang orang hebat di sini,5,6,banyak orang orang hebat di sini,6,6,"['banyak', 'orang', 'orang', 'hebat', 'di', 'sini']","['orang', 'orang', 'hebat']",6,3,3,orang orang hebat,3,3
sangat membantu,positif,2022-09-03,2022,sangat membantu,2,2,sangat membantu,2,2,"['sangat', 'membantu']",['membantu'],2,1,1,bantu,1,1
Sangat membantu 👍👍👍,positif,2020-02-07,2020,sangat membantu,3,2,sangat membantu,2,2,"['sangat', 'membantu']",['membantu'],2,1,1,bantu,1,1
Cukup membantu..,positif,2020-06-04,2020,cukup membantu,2,2,cukup membantu,2,2,"['cukup', 'membantu']",['membantu'],2,1,1,bantu,1,1
Sangat membantu,positif,2021-06-27,2021,sangat membantu,2,2,sangat membantu,2,2,"['sangat', 'membantu']",['membantu'],2,1,1,bantu,1,1
Banyak teman saya ternyata.. Hehe,positif,2021-03-18,2021,banyak teman saya ternyata hehe,5,5,banyak teman saya ternyata hehe,5,5,"['banyak', 'teman', 'saya', 'ternyata', 'hehe']","['teman', 'hehe']",5,2,3,teman hehe,2,2
Sangat membantu,positif,2020-02-20,2020,sangat membantu,2,2,sangat membantu,2,2,"['sangat', 'membantu']",['membantu'],2,1,1,bantu,1,1
Sangat bermanfaat,positif,2024-02-25,2024,sangat bermanfaat,2,2,sangat bermanfaat,2,2,"['sangat', 'bermanfaat']",['bermanfaat'],2,1,1,manfaat,1,1
Oke menjadi lebih baik,positif,2024-05-29,2024,oke menjadi lebih baik,4,4,oke menjadi lebih baik,4,4,"['oke', 'menjadi', 'lebih', 'baik']",['oke'],4,1,3,oke,1,1
Alhamdulillah membantu,positif,2020-02-23,2020,alhamdulillah membantu,2,2,alhamdulillah membantu,2,2,"['alhamdulillah', 'membantu']","['alhamdulillah', 'membantu']",2,2,0,alhamdulillah bantu,2,2
Apa sih verifikasi tolol,negatif,2023-08-13,2023,apa sih verifikasi tolol,4,4,apa sih verifikasi tolol,4,4,"['apa', 'sih', 'verifikasi', 'tolol']","['sih', 'verifikasi', 'tolol']",4,3,1,sih verifikasi tolol,3,3
Buat lamar kerja,positif,2021-05-28,2021,buat lamar kerja,3,3,buat lamar kerja,3,3,"['buat', 'lamar', 'kerja']","['lamar', 'kerja']",3,2,1,lamar kerja,2,2
Sangat membantu,positif,2021-04-28,2021,sangat membantu,2,2,sangat membantu,2,2,"['sangat', 'membantu']",['membantu'],2,1,1,bantu,1,1
Sangat membantu,positif,2020-02-08,2020,sangat membantu,2,2,sangat membantu,2,2,"['sangat', 'membantu']",['membantu'],2,1,1,bantu,1,1
Sangat membantu,positif,2020-07-14,2020,sangat membantu,2,2,sangat membantu,2,2,"['sangat', 'membantu']",['membantu'],2,1,1,bantu,1,1
Makasih semuanya,positif,2022-08-18,2022,makasih semuanya,2,2,terima kasih semuanya,2,3,"['terima', 'kasih', 'semuanya']","['terima', 'kasih']",3,2,1,terima kasih,2,2
Bagus n keren,positif,2021-11-06,2021,bagus n keren,3,3,bagus dan keren,3,3,"['bagus', 'dan', 'keren']","['bagus', 'keren']",3,2,1,bagus keren,2,2
Sangat membantu,positif,2020-05-15,2020,sangat membantu,2,2,sangat membantu,2,2,"['sangat', 'membantu']",['membantu'],2,1,1,bantu,1,1
Sangat membantu,positif,2022-05-08,2022,sangat membantu,2,2,sangat membantu,2,2,"['sangat', 'membantu']",['membantu'],2,1,1,bantu,1,1
Sangat membantu,positif,2022-05-30,2022,sangat membantu,2,2,sangat membantu,2,2,"['sangat', 'membantu']",['membantu'],2,1,1,bantu,1,1
Sangat membantu🆘,positif,2020-01-14,2020,sangat membantu,2,2,sangat membantu,2,2,"['sangat', 'membantu']",['membantu'],2,1,1,bantu,1,1
Sangat membantu,positif,2021-01-01,2021,sangat membantu,2,2,sangat membantu,2,2,"['sangat', 'membantu']",['membantu'],2,1,1,bantu,1,1
Sangat membantu,positif,2022-02-13,2022,sangat membantu,2,2,sangat membantu,2,2,"['sangat', 'membantu']",['membantu'],2,1,1,bantu,1,1
Sangat membantu,positif,2021-03-30,2021,sangat membantu,2,2,sangat membantu,2,2,"['sangat', 'membantu']",['membantu'],2,1,1,bantu,1,1
Sangat membantu,positif,2020-04-17,2020,sangat membantu,2,2,sangat membantu,2,2,"['sangat', 'membantu']",['membantu'],2,1,1,bantu,1,1
Sangat membantu,positif,2022-08-01,2022,sangat membantu,2,2,sangat membantu,2,2,"['sangat', 'membantu']",['membantu'],2,1,1,bantu,1,1
Sangat membantu,positif,2021-12-18,2021,sangat membantu,2,2,sangat membantu,2,2,"['sangat', 'membantu']",['membantu'],2,1,1,bantu,1,1
Sangat membantu,positif,2020-09-28,2020,sangat membantu,2,2,sangat membantu,2,2,"['sangat', 'membantu']",['membantu'],2,1,1,bantu,1,1
Sangat membantu,positif,2020-06-06,2020,sangat membantu,2,2,sangat membantu,2,2,"['sangat', 'membantu']",['membantu'],2,1,1,bantu,1,1
Sangat membantu,positif,2022-01-17,2022,sangat membantu,2,2,sangat membantu,2,2,"['sangat', 'membantu']",['membantu'],2,1,1,bantu,1,1
Sangat membantu,positif,2021-02-03,2021,sangat membantu,2,2,sangat membantu,2,2,"['sangat', 'membantu']",['membantu'],2,1,1,bantu,1,1
Sangat membantu,positif,2021-02-15,2021,sangat membantu,2,2,sangat membantu,2,2,"['sangat', 'membantu']",['membantu'],2,1,1,bantu,1,1
Sekarang susah login,negatif,2023-12-28,2023,sekarang susah login,3,3,sekarang susah login,3,3,"['sekarang', 'susah', 'login']","['susah', 'login']",3,2,1,susah login,2,2
Ini busuk kali aplikasinya,negatif,2021-04-19,2021,ini busuk kali aplikasinya,4,4,ini busuk kali aplikasi nya,4,5,"['ini', 'busuk', 'kali', 'aplikasi', 'nya']","['busuk', 'kali', 'aplikasi', 'nya']",5,4,1,busuk kali aplikasi nya,4,4
Mantab n sukses slalu,positif,2024-05-22,2024,mantab n sukses slalu,4,4,mantap dan sukses selalu,4,4,"['mantap', 'dan', 'sukses', 'selalu']","['mantap', 'sukses']",4,2,2,mantap sukses,2,2
Akun tiba tiba hilang,negatif,2023-08-17,2023,akun tiba tiba hilang,4,4,akun tiba tiba hilang,4,4,"['akun', 'tiba', 'tiba', 'hilang']","['akun', 'hilang']",4,2,2,akun hilang,2,2
Mau bergabung aja susah bgt,negatif,2021-11-22,2021,mau bergabung aja susah bgt,5,5,mau bergabung saja susah banget,5,5,"['mau', 'bergabung', 'saja', 'susah', 'banget']","['bergabung', 'susah', 'banget']",5,3,2,gabung susah banget,3,3
bagus sekali,negatif,2020-11-08,2020,bagus sekali,2,2,bagus sekali,2,2,"['bagus', 'sekali']",['bagus'],2,1,1,bagus,1,1
Buktikan anda adalah manusia 🤬 nggak bener2 😁,negatif,2022-04-09,2022,buktikan anda adalah manusia nggak bener,8,6,buktikan anda adalah manusia tidak benar,6,6,"['buktikan', 'anda', 'adalah', 'manusia', 'tidak', 'benar']","['buktikan', 'manusia', 'tidak']",6,3,3,bukti manusia tidak,3,3
Bagus aplikasinya,positif,2023-01-10,2023,bagus aplikasinya,2,2,bagus aplikasi nya,2,3,"['bagus', 'aplikasi', 'nya']","['bagus', 'aplikasi', 'nya']",3,3,0,bagus aplikasi nya,3,3
Semoga bermanfaat bg pengguna,positif,2020-04-04,2020,semoga bermanfaat bg pengguna,4,4,semoga bermanfaat bg pengguna,4,4,"['semoga', 'bermanfaat', 'bg', 'pengguna']","['semoga', 'bermanfaat', 'bg', 'pengguna']",4,4,0,moga manfaat bg guna,4,4
Gak jelas verifikasinya,positif,2022-06-15,2022,gak jelas verifikasinya,3,3,tidak jelas verifikasinya,3,3,"['tidak', 'jelas', 'verifikasinya']","['tidak', 'verifikasinya']",3,2,1,tidak verifikasi,2,2
Cukup membantu,positif,2021-01-15,2021,cukup membantu,2,2,cukup membantu,2,2,"['cukup', 'membantu']",['membantu'],2,1,1,bantu,1,1
Cukup membantu,positif,2022-03-28,2022,cukup membantu,2,2,cukup membantu,2,2,"['cukup', 'membantu']",['membantu'],2,1,1,bantu,1,1
Cukup membantu,positif,2024-02-06,2024,cukup membantu,2,2,cukup membantu,2,2,"['cukup', 'membantu']",['membantu'],2,1,1,bantu,1,1
Mantab saya kasih bintang lima,positif,2021-12-13,2021,mantab saya kasih bintang lima,5,5,mantap saya kasih bintang lima,5,5,"['mantap', 'saya', 'kasih', 'bintang', 'lima']","['mantap', 'kasih', 'bintang']",5,3,2,mantap kasih bintang,3,3
Pokok nya ...ok banget deh,positif,2021-03-12,2021,pokok nya ok banget deh,5,5,pokok nya oke banget deh,5,5,"['pokok', 'nya', 'oke', 'banget', 'deh']","['pokok', 'nya', 'oke', 'banget', 'deh']",5,5,0,pokok nya oke banget deh,5,5
Sangat membantu,positif,2021-09-28,2021,sangat membantu,2,2,sangat membantu,2,2,"['sangat', 'membantu']",['membantu'],2,1,1,bantu,1,1
Membantu yg jauh mendekat,positif,2021-05-12,2021,membantu yg jauh mendekat,4,4,membantu yang jauh mendekat,4,4,"['membantu', 'yang', 'jauh', 'mendekat']","['membantu', 'mendekat']",4,2,2,bantu dekat,2,2
sangat berguna,positif,2021-01-10,2021,sangat berguna,2,2,sangat berguna,2,2,"['sangat', 'berguna']",['berguna'],2,1,1,guna,1,1
Aplikasi menambah ilmu,positif,2020-12-18,2020,aplikasi menambah ilmu,3,3,aplikasi menambah ilmu,3,3,"['aplikasi', 'menambah', 'ilmu']","['aplikasi', 'menambah', 'ilmu']",3,3,0,aplikasi tambah ilmu,3,3
Tidak bisa bergabung,negatif,2023-09-05,2023,tidak bisa bergabung,3,3,tidak bisa bergabung,3,3,"['tidak', 'bisa', 'bergabung']","['tidak', 'bergabung']",3,2,1,tidak gabung,2,2
Sangat membantu saya,positif,2021-08-16,2021,sangat membantu saya,3,3,sangat membantu saya,3,3,"['sangat', 'membantu', 'saya']",['membantu'],3,1,2,bantu,1,1
Sangat membantu,positif,2020-10-09,2020,sangat membantu,2,2,sangat membantu,2,2,"['sangat', 'membantu']",['membantu'],2,1,1,bantu,1,1
Sangat membantu,positif,2022-06-13,2022,sangat membantu,2,2,sangat membantu,2,2,"['sangat', 'membantu']",['membantu'],2,1,1,bantu,1,1
Sangat membantu,positif,2020-11-02,2020,sangat membantu,2,2,sangat membantu,2,2,"['sangat', 'membantu']",['membantu'],2,1,1,bantu,1,1
Sangat membantu,positif,2023-08-15,2023,sangat membantu,2,2,sangat membantu,2,2,"['sangat', 'membantu']",['membantu'],2,1,1,bantu,1,1
Sangat membantu,positif,2022-09-02,2022,sangat membantu,2,2,sangat membantu,2,2,"['sangat', 'membantu']",['membantu'],2,1,1,bantu,1,1
Sangat membantu,positif,2020-03-14,2020,sangat membantu,2,2,sangat membantu,2,2,"['sangat', 'membantu']",['membantu'],2,1,1,bantu,1,1
Wkwk verifikasi terkonyol,negatif,2023-08-11,2023,wkwk verifikasi terkonyol,3,3,wkwk verifikasi terkonyol,3,3,"['wkwk', 'verifikasi', 'terkonyol']","['wkwk', 'verifikasi', 'terkonyol']",3,3,0,wkwk verifikasi konyol,3,3
Medsos pro terbaik,positif,2020-08-30,2020,medsos pro terbaik,3,3,media sosial pro terbaik,3,4,"['media', 'sosial', 'pro', 'terbaik']","['media', 'sosial', 'pro', 'terbaik']",4,4,0,media sosial pro baik,4,4
Ga banyak loker,negatif,2021-12-01,2021,ga banyak loker,3,3,tidak banyak loker,3,3,"['tidak', 'banyak', 'loker']","['tidak', 'loker']",3,2,1,tidak loker,2,2
Semoga bermanfaat,positif,2024-08-25,2024,semoga bermanfaat,2,2,semoga bermanfaat,2,2,"['semoga', 'bermanfaat']","['semoga', 'bermanfaat']",2,2,0,moga manfaat,2,2
Ini medsos berkelas banget,positif,2021-10-26,2021,ini medsos berkelas banget,4,4,ini media sosial berkelas banget,4,5,"['ini', 'media', 'sosial', 'berkelas', 'banget']","['media', 'sosial', 'berkelas', 'banget']",5,4,1,media sosial kelas banget,4,4
Bikin verifikasi yg bener goblok,negatif,2022-02-19,2022,bikin verifikasi yg bener goblok,5,5,bikin verifikasi yang benar goblok,5,5,"['bikin', 'verifikasi', 'yang', 'benar', 'goblok']","['bikin', 'verifikasi', 'goblok']",5,3,2,bikin verifikasi goblok,3,3
APLIKASI NGENTOT TIDAK BISA LOGIN,negatif,2020-09-25,2020,aplikasi ngentot tidak bisa login,5,5,aplikasi ngentot tidak bisa login,5,5,"['aplikasi', 'ngentot', 'tidak', 'bisa', 'login']","['aplikasi', 'ngentot', 'tidak', 'login']",5,4,1,aplikasi ngentot tidak login,4,4
sangat membantu,positif,2021-07-17,2021,sangat membantu,2,2,sangat membantu,2,2,"['sangat', 'membantu']",['membantu'],2,1,1,bantu,1,1
sangat membantu,positif,2020-11-15,2020,sangat membantu,2,2,sangat membantu,2,2,"['sangat', 'membantu']",['membantu'],2,1,1,bantu,1,1
sangat membantu,positif,2021-04-18,2021,sangat membantu,2,2,sangat membantu,2,2,"['sangat', 'membantu']",['membantu'],2,1,1,bantu,1,1
Aplikasi gk jelas,negatif,2023-06-28,2023,aplikasi gk jelas,3,3,aplikasi tidak jelas,3,3,"['aplikasi', 'tidak', 'jelas']","['aplikasi', 'tidak']",3,2,1,aplikasi tidak,2,2
Ok bagus banget,positif,2023-06-12,2023,ok bagus banget,3,3,oke bagus banget,3,3,"['oke', 'bagus', 'banget']","['oke', 'bagus', 'banget']",3,3,0,oke bagus banget,3,3
Sangat Membantu,positif,2021-07-08,2021,sangat membantu,2,2,sangat membantu,2,2,"['sangat', 'membantu']",['membantu'],2,1,1,bantu,1,1
Mau login aja susah,negatif,2023-10-17,2023,mau login aja susah,4,4,mau login saja susah,4,4,"['mau', 'login', 'saja', 'susah']","['login', 'susah']",4,2,2,login susah,2,2
"Mau masuk aja susah najis,",negatif,2022-06-02,2022,mau masuk aja susah najis,5,5,mau masuk saja susah najis,5,5,"['mau', 'masuk', 'saja', 'susah', 'najis']","['masuk', 'susah', 'najis']",5,3,2,masuk susah najis,3,3
Semoga ini mnyenangkan,positif,2023-01-08,2023,semoga ini mnyenangkan,3,3,semoga ini mnyenangkan,3,3,"['semoga', 'ini', 'mnyenangkan']","['semoga', 'mnyenangkan']",3,2,1,moga mnyenangkan,2,2
Teka teki kayak tai...,negatif,2024-02-19,2024,teka teki kayak tai,4,4,teka teki kayak tai,4,4,"['teka', 'teki', 'kayak', 'tai']","['teka', 'teki', 'kayak', 'tai']",4,4,0,teka teki kayak tai,4,4
Kurang memuaskan,negatif,2023-04-24,2023,kurang memuaskan,2,2,kurang memuaskan,2,2,"['kurang', 'memuaskan']",['memuaskan'],2,1,1,muas,1,1
Bagus.. bermanfaat,positif,2021-07-06,2021,bagus bermanfaat,2,2,bagus bermanfaat,2,2,"['bagus', 'bermanfaat']","['bagus', 'bermanfaat']",2,2,0,bagus manfaat,2,2
Selalu terpakai,positif,2024-07-21,2024,selalu terpakai,2,2,selalu terpakai,2,2,"['selalu', 'terpakai']",['terpakai'],2,1,1,pakai,1,1
Luar biasa banget,positif,2023-01-14,2023,luar biasa banget,3,3,luar biasa banget,3,3,"['luar', 'biasa', 'banget']",['banget'],3,1,2,banget,1,1
Sangat membantu,positif,2021-05-09,2021,sangat membantu,2,2,sangat membantu,2,2,"['sangat', 'membantu']",['membantu'],2,1,1,bantu,1,1
Sangat membantu,positif,2022-02-04,2022,sangat membantu,2,2,sangat membantu,2,2,"['sangat', 'membantu']",['membantu'],2,1,1,bantu,1,1
Pokoknya recomended,positif,2020-11-09,2020,pokoknya recomended,2,2,pokoknya rekomendasi,2,2,"['pokoknya', 'rekomendasi']","['pokoknya', 'rekomendasi']",2,2,0,pokok rekomendasi,2,2
Susah betul mau bikin akun. Dipersulit,negatif,2021-12-15,2021,susah betul mau bikin akun dipersulit,6,6,susah betul mau bikin akun dipersulit,6,6,"['susah', 'betul', 'mau', 'bikin', 'akun', 'dipersulit']","['susah', 'bikin', 'akun', 'dipersulit']",6,4,2,susah bikin akun sulit,4,4
Bertemu dengan orang-orang penting,positif,2023-10-03,2023,bertemu dengan orang orang penting,4,5,bertemu dengan orang orang penting,5,5,"['bertemu', 'dengan', 'orang', 'orang', 'penting']","['bertemu', 'orang', 'orang']",5,3,2,temu orang orang,3,3
Luar biasa mantap,positif,2021-11-27,2021,luar biasa mantap,3,3,luar biasa mantap,3,3,"['luar', 'biasa', 'mantap']",['mantap'],3,1,2,mantap,1,1
Mantap. Membantu,positif,2020-06-04,2020,mantap membantu,2,2,mantap membantu,2,2,"['mantap', 'membantu']","['mantap', 'membantu']",2,2,0,mantap bantu,2,2
Semoga dapat membantu saya 🙏🙏🙏,positif,2022-03-17,2022,semoga dapat membantu saya,5,4,semoga dapat membantu saya,4,4,"['semoga', 'dapat', 'membantu', 'saya']","['semoga', 'membantu']",4,2,2,moga bantu,2,2
Susah untuk masuk,negatif,2023-07-26,2023,susah untuk masuk,3,3,susah untuk masuk,3,3,"['susah', 'untuk', 'masuk']","['susah', 'masuk']",3,2,1,susah masuk,2,2
Ngelag gak bisa dibuka,negatif,2023-10-19,2023,ngelag gak bisa dibuka,4,4,lambat tidak bisa dibuka,4,4,"['lambat', 'tidak', 'bisa', 'dibuka']","['lambat', 'tidak', 'dibuka']",4,3,1,lambat tidak buka,3,3
Tolong di perbaiki.,negatif,2020-04-13,2020,tolong di perbaiki,3,3,tolong di perbaikan,3,3,"['tolong', 'di', 'perbaikan']","['tolong', 'perbaikan']",3,2,1,tolong baik,2,2
Membantu dlm pencarian loker,positif,2022-04-22,2022,membantu dlm pencarian loker,4,4,membantu dalam pencarian loker,4,4,"['membantu', 'dalam', 'pencarian', 'loker']","['membantu', 'pencarian', 'loker']",4,3,1,bantu cari loker,3,3
Membantu sekali,positif,2021-10-03,2021,membantu sekali,2,2,membantu sekali,2,2,"['membantu', 'sekali']",['membantu'],2,1,1,bantu,1,1
Sy suka aplikasinya,positif,2020-05-20,2020,sy suka aplikasinya,3,3,saya suka aplikasi nya,3,4,"['saya', 'suka', 'aplikasi', 'nya']","['suka', 'aplikasi', 'nya']",4,3,1,suka aplikasi nya,3,3
Aplikasi yg bagus,positif,2021-04-24,2021,aplikasi yg bagus,3,3,aplikasi yang bagus,3,3,"['aplikasi', 'yang', 'bagus']","['aplikasi', 'bagus']",3,2,1,aplikasi bagus,2,2
Semoga dapet job dari LinkedIn.,positif,2024-01-05,2024,semoga dapet job dari linkedin,5,5,semoga dapat kerja dari linkedin,5,5,"['semoga', 'dapat', 'kerja', 'dari', 'linkedin']","['semoga', 'kerja', 'linkedin']",5,3,2,moga kerja linkedin,3,3
Apk sampah Verivikasi kemanan bodoh,negatif,2024-08-18,2024,apk sampah verivikasi kemanan bodoh,5,5,aplikasi sampah verivikasi kemanan bodoh,5,5,"['aplikasi', 'sampah', 'verivikasi', 'kemanan', 'bodoh']","['aplikasi', 'sampah', 'verivikasi', 'kemanan', 'bodoh']",5,5,0,aplikasi sampah verivikasi keman bodoh,5,5
Terhubung dg teman,positif,2021-01-26,2021,terhubung dg teman,3,3,terhubung dengan teman,3,3,"['terhubung', 'dengan', 'teman']","['terhubung', 'teman']",3,2,1,hubung teman,2,2
Apikasinya berjaringan,positif,2022-07-28,2022,apikasinya berjaringan,2,2,apikasinya berjaringan,2,2,"['apikasinya', 'berjaringan']","['apikasinya', 'berjaringan']",2,2,0,apikasinya jaring,2,2
Luar Biasa Membantu,positif,2021-05-18,2021,luar biasa membantu,3,3,luar biasa membantu,3,3,"['luar', 'biasa', 'membantu']",['membantu'],3,1,2,bantu,1,1
Sangat berguna,positif,2021-02-11,2021,sangat berguna,2,2,sangat berguna,2,2,"['sangat', 'berguna']",['berguna'],2,1,1,guna,1,1
Wow jelek banget,negatif,2021-05-01,2021,wow jelek banget,3,3,wow jelek banget,3,3,"['wow', 'jelek', 'banget']","['wow', 'jelek', 'banget']",3,3,0,wow jelek banget,3,3
Bagus...sangat membantu,positif,2022-02-04,2022,bagus sangat membantu,2,3,bagus sangat membantu,3,3,"['bagus', 'sangat', 'membantu']","['bagus', 'membantu']",3,2,1,bagus bantu,2,2
"Insya Allah bermanfaat, Aamiin,",positif,2020-03-27,2020,insya allah bermanfaat aamiin,4,4,insya allah bermanfaat aamiin,4,4,"['insya', 'allah', 'bermanfaat', 'aamiin']","['insya', 'allah', 'bermanfaat', 'aamiin']",4,4,0,insya allah manfaat aamiin,4,4
Kurang memuaskan,negatif,2020-02-17,2020,kurang memuaskan,2,2,kurang memuaskan,2,2,"['kurang', 'memuaskan']",['memuaskan'],2,1,1,muas,1,1
Mudah digunakan dimana saja .,positif,2021-05-20,2021,mudah digunakan dimana saja,5,4,mudah digunakan dimana saja,4,4,"['mudah', 'digunakan', 'dimana', 'saja']","['mudah', 'dimana']",4,2,2,mudah mana,2,2
Saya sangat suka,positif,2020-09-22,2020,saya sangat suka,3,3,saya sangat suka,3,3,"['saya', 'sangat', 'suka']",['suka'],3,1,2,suka,1,1
Cukup membantu,positif,2020-06-19,2020,cukup membantu,2,2,cukup membantu,2,2,"['cukup', 'membantu']",['membantu'],2,1,1,bantu,1,1
Sulit di pahami,negatif,2020-05-21,2020,sulit di pahami,3,3,sulit di pahami,3,3,"['sulit', 'di', 'pahami']","['sulit', 'pahami']",3,2,1,sulit paham,2,2
Aplikasi ga jelas,negatif,2024-03-03,2024,aplikasi ga jelas,3,3,aplikasi tidak jelas,3,3,"['aplikasi', 'tidak', 'jelas']","['aplikasi', 'tidak']",3,2,1,aplikasi tidak,2,2
Baik sekali,positif,2024-06-08,2024,baik sekali,2,2,baik sekali,2,2,"['baik', 'sekali']",[],2,1,1,,1,0
Saya kasi bintang 5,positif,2022-02-20,2022,saya kasi bintang,4,3,saya kasih bintang,3,3,"['saya', 'kasih', 'bintang']","['kasih', 'bintang']",3,2,1,kasih bintang,2,2
Terlalu banyak ikaln,negatif,2022-10-17,2022,terlalu banyak ikaln,3,3,terlalu banyak ikaln,3,3,"['terlalu', 'banyak', 'ikaln']",['ikaln'],3,1,2,ikaln,1,1
"Gak guna,,,asuu",negatif,2023-11-12,2023,gak guna asuu,2,3,tidak guna asuu,3,3,"['tidak', 'guna', 'asuu']","['tidak', 'asuu']",3,2,1,tidak asuu,2,2
Merasa nyaman,positif,2020-04-04,2020,merasa nyaman,2,2,merasa nyaman,2,2,"['merasa', 'nyaman']",['nyaman'],2,1,1,nyaman,1,1
Terimakasih tlh bergabung dg Grup Ayah Guru Syaiful Karim,positif,2023-09-19,2023,terimakasih tlh bergabung dg grup ayah guru syaiful karim,9,9,terima kasih tlh bergabung dengan grup ayah guru syaiful karim,9,10,"['terima', 'kasih', 'tlh', 'bergabung', 'dengan', 'grup', 'ayah', 'guru', 'syaiful', 'karim']","['terima', 'kasih', 'tlh', 'bergabung', 'grup', 'ayah', 'guru', 'syaiful', 'karim']",10,9,1,terima kasih tlh gabung grup ayah guru syaiful karim,9,9
Mantap Jiwa. Jiwa Kentu,positif,2020-02-17,2020,mantap jiwa jiwa kentu,4,4,mantap jiwa jiwa kentu,4,4,"['mantap', 'jiwa', 'jiwa', 'kentu']","['mantap', 'jiwa', 'jiwa', 'kentu']",4,4,0,mantap jiwa jiwa kentu,4,4
Apk gak guna sumpah,negatif,2023-04-07,2023,apk gak guna sumpah,4,4,aplikasi tidak guna sumpah,4,4,"['aplikasi', 'tidak', 'guna', 'sumpah']","['aplikasi', 'tidak', 'sumpah']",4,3,1,aplikasi tidak sumpah,3,3
Info lowonganya banyak penipu,negatif,2021-10-29,2021,info lowonganya banyak penipu,4,4,informasi lowonganya banyak penipu,4,4,"['informasi', 'lowonganya', 'banyak', 'penipu']","['informasi', 'lowonganya', 'penipu']",4,3,1,informasi lowonganya tipu,3,3
Aplikasi tai,negatif,2023-02-24,2023,aplikasi tai,2,2,aplikasi tai,2,2,"['aplikasi', 'tai']","['aplikasi', 'tai']",2,2,0,aplikasi tai,2,2
Tidak bisa di buka,negatif,2021-11-05,2021,tidak bisa di buka,4,4,tidak bisa di buka,4,4,"['tidak', 'bisa', 'di', 'buka']","['tidak', 'buka']",4,2,2,tidak buka,2,2
"Bagus, saya senang...",positif,2020-06-25,2020,bagus saya senang,3,3,bagus saya senang,3,3,"['bagus', 'saya', 'senang']","['bagus', 'senang']",3,2,1,bagus senang,2,2
Bagus banget nih,positif,2020-06-14,2020,bagus banget nih,3,3,bagus banget nih,3,3,"['bagus', 'banget', 'nih']","['bagus', 'banget', 'nih']",3,3,0,bagus banget nih,3,3
Akun di retas,negatif,2023-11-09,2023,akun di retas,3,3,akun di retas,3,3,"['akun', 'di', 'retas']","['akun', 'retas']",3,2,1,akun retas,2,2
Bagus smoga sukses trusssss,positif,2020-11-09,2020,bagus smoga sukses trusssss,4,4,bagus semoga sukses trusssss,4,4,"['bagus', 'semoga', 'sukses', 'trusssss']","['bagus', 'semoga', 'sukses', 'trusssss']",4,4,0,bagus moga sukses trusssss,4,4
Ga berfungsi,negatif,2023-01-09,2023,ga berfungsi,2,2,tidak berfungsi,2,2,"['tidak', 'berfungsi']","['tidak', 'berfungsi']",2,2,0,tidak fungsi,2,2
Ribet bgt daftarnya,negatif,2023-09-10,2023,ribet bgt daftarnya,3,3,rumit banget daftarnya,3,3,"['rumit', 'banget', 'daftarnya']","['rumit', 'banget', 'daftarnya']",3,3,0,rumit banget daftar,3,3
Gak ada gunanya,negatif,2024-06-03,2024,gak ada gunanya,3,3,tidak ada gunanya,3,3,"['tidak', 'ada', 'gunanya']","['tidak', 'gunanya']",3,2,1,tidak guna,2,2
Aplikasi yang bermutu coyy,positif,2020-07-14,2020,aplikasi yang bermutu coyy,4,4,aplikasi yang bermutu coyy,4,4,"['aplikasi', 'yang', 'bermutu', 'coyy']","['aplikasi', 'bermutu', 'coyy']",4,3,1,aplikasi mutu coyy,3,3
Oke mantap jiwa sekali,positif,2022-02-01,2022,oke mantap jiwa sekali,4,4,oke mantap jiwa sekali,4,4,"['oke', 'mantap', 'jiwa', 'sekali']","['oke', 'mantap', 'jiwa']",4,3,1,oke mantap jiwa,3,3
Semoga makin sukses,positif,2024-06-27,2024,semoga makin sukses,3,3,semoga makin sukses,3,3,"['semoga', 'makin', 'sukses']","['semoga', 'sukses']",3,2,1,moga sukses,2,2
cukup membantu,positif,2020-03-24,2020,cukup membantu,2,2,cukup membantu,2,2,"['cukup', 'membantu']",['membantu'],2,1,1,bantu,1,1
Semoga dapat membantu,positif,2020-09-09,2020,semoga dapat membantu,3,3,semoga dapat membantu,3,3,"['semoga', 'dapat', 'membantu']","['semoga', 'membantu']",3,2,1,moga bantu,2,2
membantu pekerjaan aku,positif,2023-01-14,2023,membantu pekerjaan aku,3,3,membantu pekerjaan aku,3,3,"['membantu', 'pekerjaan', 'aku']","['membantu', 'pekerjaan']",3,2,1,bantu kerja,2,2
Semogah cita2 menjadi sukses 🙏,positif,2020-03-22,2020,semogah cita menjadi sukses,5,4,semogah cita menjadi sukses,4,4,"['semogah', 'cita', 'menjadi', 'sukses']","['semogah', 'cita', 'sukses']",4,3,1,semogah cita sukses,3,3
Login mentok di kodok,negatif,2024-01-30,2024,login mentok di kodok,4,4,login mentok di kodok,4,4,"['login', 'mentok', 'di', 'kodok']","['login', 'mentok', 'kodok']",4,3,1,login mentok kodok,3,3
Saya kasi bintang 5,positif,2024-08-30,2024,saya kasi bintang,4,3,saya kasih bintang,3,3,"['saya', 'kasih', 'bintang']","['kasih', 'bintang']",3,2,1,kasih bintang,2,2
Mantapp .. Kasih bintang 5,positif,2020-08-05,2020,mantapp kasih bintang,5,3,mantap kasih bintang,3,3,"['mantap', 'kasih', 'bintang']","['mantap', 'kasih', 'bintang']",3,3,0,mantap kasih bintang,3,3
Bagus untuk loker,positif,2020-12-26,2020,bagus untuk loker,3,3,bagus untuk loker,3,3,"['bagus', 'untuk', 'loker']","['bagus', 'loker']",3,2,1,bagus loker,2,2
Memudahkan segalanya,positif,2022-01-07,2022,memudahkan segalanya,2,2,memudahkan segalanya,2,2,"['memudahkan', 'segalanya']",['memudahkan'],2,1,1,mudah,1,1
teka teki sesat,negatif,2022-06-09,2022,teka teki sesat,3,3,teka teki sesat,3,3,"['teka', 'teki', 'sesat']","['teka', 'teki', 'sesat']",3,3,0,teka teki sesat,3,3
bermanfaat bgt,positif,2020-01-06,2020,bermanfaat bgt,2,2,bermanfaat banget,2,2,"['bermanfaat', 'banget']","['bermanfaat', 'banget']",2,2,0,manfaat banget,2,2
Mantap....smoga dapat,positif,2021-12-20,2021,mantap smoga dapat,2,3,mantap semoga dapat,3,3,"['mantap', 'semoga', 'dapat']","['mantap', 'semoga']",3,2,1,mantap moga,2,2
"Bertemu teman, dan karir",positif,2021-05-18,2021,bertemu teman dan karir,4,4,bertemu teman dan karir,4,4,"['bertemu', 'teman', 'dan', 'karir']","['bertemu', 'teman', 'karir']",4,3,1,temu teman karir,3,3
banyak memberikan inspirasi,positif,2020-11-29,2020,banyak memberikan inspirasi,3,3,banyak memberikan inspirasi,3,3,"['banyak', 'memberikan', 'inspirasi']",['inspirasi'],3,1,2,inspirasi,1,1
Baik dan bagus,positif,2020-08-16,2020,baik dan bagus,3,3,baik dan bagus,3,3,"['baik', 'dan', 'bagus']",['bagus'],3,1,2,bagus,1,1
Semoga Bermanfaat...☺️,positif,2021-03-04,2021,semoga bermanfaat,2,2,semoga bermanfaat,2,2,"['semoga', 'bermanfaat']","['semoga', 'bermanfaat']",2,2,0,moga manfaat,2,2
Banyak manfaatnya,positif,2021-11-11,2021,banyak manfaatnya,2,2,banyak manfaatnya,2,2,"['banyak', 'manfaatnya']",['manfaatnya'],2,1,1,manfaat,1,1
Bagus bermutu,positif,2024-08-17,2024,bagus bermutu,2,2,bagus bermutu,2,2,"['bagus', 'bermutu']","['bagus', 'bermutu']",2,2,0,bagus mutu,2,2
Susah bikin akun baru,negatif,2024-08-20,2024,susah bikin akun baru,4,4,susah bikin akun baru,4,4,"['susah', 'bikin', 'akun', 'baru']","['susah', 'bikin', 'akun']",4,3,1,susah bikin akun,3,3
"Bagus,semoga bermanfaat",positif,2020-03-22,2020,bagus semoga bermanfaat,2,3,bagus semoga bermanfaat,3,3,"['bagus', 'semoga', 'bermanfaat']","['bagus', 'semoga', 'bermanfaat']",3,3,0,bagus moga manfaat,3,3
Mudah opsinya,negatif,2022-08-12,2022,mudah opsinya,2,2,mudah opsinya,2,2,"['mudah', 'opsinya']","['mudah', 'opsinya']",2,2,0,mudah opsi,2,2
Sangat berguna,positif,2022-09-26,2022,sangat berguna,2,2,sangat berguna,2,2,"['sangat', 'berguna']",['berguna'],2,1,1,guna,1,1
Membantu sekali,positif,2021-04-27,2021,membantu sekali,2,2,membantu sekali,2,2,"['membantu', 'sekali']",['membantu'],2,1,1,bantu,1,1
"Oke, Terima kasih.",positif,2020-08-06,2020,oke terima kasih,3,3,oke terima kasih,3,3,"['oke', 'terima', 'kasih']","['oke', 'terima', 'kasih']",3,3,0,oke terima kasih,3,3
Aplikasi ini membantu saya,positif,2020-08-03,2020,aplikasi ini membantu saya,4,4,aplikasi ini membantu saya,4,4,"['aplikasi', 'ini', 'membantu', 'saya']","['aplikasi', 'membantu']",4,2,2,aplikasi bantu,2,2
Good. Saya suka,positif,2021-06-04,2021,good saya suka,3,3,bagus saya suka,3,3,"['bagus', 'saya', 'suka']","['bagus', 'suka']",3,2,1,bagus suka,2,2
Tidak ada manfaatnya,negatif,2021-07-02,2021,tidak ada manfaatnya,3,3,tidak ada manfaatnya,3,3,"['tidak', 'ada', 'manfaatnya']","['tidak', 'manfaatnya']",3,2,1,tidak manfaat,2,2
Kereeeen luar biasa,positif,2023-10-18,2023,kereeeen luar biasa,3,3,kereeeen luar biasa,3,3,"['kereeeen', 'luar', 'biasa']",['kereeeen'],3,1,2,kereeeen,1,1
Sangat berguna,positif,2023-01-24,2023,sangat berguna,2,2,sangat berguna,2,2,"['sangat', 'berguna']",['berguna'],2,1,1,guna,1,1
Mudah2an manfaat,positif,2020-11-18,2020,mudah an manfaat,2,3,mudah an manfaat,3,3,"['mudah', 'an', 'manfaat']","['mudah', 'an', 'manfaat']",3,3,0,mudah an manfaat,3,3
Sangat berguna,positif,2020-09-15,2020,sangat berguna,2,2,sangat berguna,2,2,"['sangat', 'berguna']",['berguna'],2,1,1,guna,1,1
Sangat berguna,positif,2020-10-24,2020,sangat berguna,2,2,sangat berguna,2,2,"['sangat', 'berguna']",['berguna'],2,1,1,guna,1,1
Linkedin memang mantaaaap,positif,2023-04-12,2023,linkedin memang mantaaaap,3,3,linkedin memang mantaaaap,3,3,"['linkedin', 'memang', 'mantaaaap']","['linkedin', 'mantaaaap']",3,2,1,linkedin mantaaaap,2,2
"Verifikasi aja ga bisa""",negatif,2022-03-30,2022,verifikasi aja ga bisa,4,4,verifikasi saja tidak bisa,4,4,"['verifikasi', 'saja', 'tidak', 'bisa']","['verifikasi', 'tidak']",4,2,2,verifikasi tidak,2,2
Yang terbaik lagi,positif,2023-09-14,2023,yang terbaik lagi,3,3,yang terbaik lagi,3,3,"['yang', 'terbaik', 'lagi']",['terbaik'],3,1,2,baik,1,1
Verifikasi tertolol,negatif,2022-06-13,2022,verifikasi tertolol,2,2,verifikasi tertolol,2,2,"['verifikasi', 'tertolol']","['verifikasi', 'tertolol']",2,2,0,verifikasi tolol,2,2
DANA SAYA TIBA TIBA HILANG,negatif,2024-06-05,2024,dana saya tiba tiba hilang,5,5,dana saya tiba tiba hilang,5,5,"['dana', 'saya', 'tiba', 'tiba', 'hilang']","['dana', 'hilang']",5,2,3,dana hilang,2,2
Jaya terus Linkedln,positif,2021-04-02,2021,jaya terus linkedln,3,3,jaya terus linkedln,3,3,"['jaya', 'terus', 'linkedln']","['jaya', 'linkedln']",3,2,1,jaya linkedln,2,2
Mantap sekali,positif,2021-08-04,2021,mantap sekali,2,2,mantap sekali,2,2,"['mantap', 'sekali']",['mantap'],2,1,1,mantap,1,1
Info loker akurat..,positif,2022-04-10,2022,info loker akurat,3,3,informasi loker akurat,3,3,"['informasi', 'loker', 'akurat']","['informasi', 'loker', 'akurat']",3,3,0,informasi loker akurat,3,3
Aplikasi nya ok,positif,2020-06-10,2020,aplikasi nya ok,3,3,aplikasi nya oke,3,3,"['aplikasi', 'nya', 'oke']","['aplikasi', 'nya', 'oke']",3,3,0,aplikasi nya oke,3,3
Sangat membantu,positif,2021-05-02,2021,sangat membantu,2,2,sangat membantu,2,2,"['sangat', 'membantu']",['membantu'],2,1,1,bantu,1,1
Saya menikmati,positif,2020-05-06,2020,saya menikmati,2,2,saya menikmati,2,2,"['saya', 'menikmati']",['menikmati'],2,1,1,nikmat,1,1
Semoga dpt pekerjaan,positif,2023-01-01,2023,semoga dpt pekerjaan,3,3,semoga dapat pekerjaan,3,3,"['semoga', 'dapat', 'pekerjaan']","['semoga', 'pekerjaan']",3,2,1,moga kerja,2,2
Ter blokir tanpa alasan,negatif,2024-01-05,2024,ter blokir tanpa alasan,4,4,ter blokir tanpa alasan,4,4,"['ter', 'blokir', 'tanpa', 'alasan']","['ter', 'blokir', 'alasan']",4,3,1,ter blokir alas,3,3
Nggak bisa di buka,negatif,2020-05-14,2020,nggak bisa di buka,4,4,tidak bisa di buka,4,4,"['tidak', 'bisa', 'di', 'buka']","['tidak', 'buka']",4,2,2,tidak buka,2,2
Sangat berguna,positif,2020-11-09,2020,sangat berguna,2,2,sangat berguna,2,2,"['sangat', 'berguna']",['berguna'],2,1,1,guna,1,1
Ribet verifikasinya!!,negatif,2022-06-15,2022,ribet verifikasinya,2,2,rumit verifikasinya,2,2,"['rumit', 'verifikasinya']","['rumit', 'verifikasinya']",2,2,0,rumit verifikasi,2,2
Bagus kumpulan orang orang hebat,positif,2023-03-14,2023,bagus kumpulan orang orang hebat,5,5,bagus kumpulan orang orang hebat,5,5,"['bagus', 'kumpulan', 'orang', 'orang', 'hebat']","['bagus', 'kumpulan', 'orang', 'orang', 'hebat']",5,5,0,bagus kumpul orang orang hebat,5,5
semoga baik buat saya.,positif,2022-04-05,2022,semoga baik buat saya,4,4,semoga baik buat saya,4,4,"['semoga', 'baik', 'buat', 'saya']",['semoga'],4,1,3,moga,1,1
Menambah relasi,positif,2021-09-27,2021,menambah relasi,2,2,menambah relasi,2,2,"['menambah', 'relasi']","['menambah', 'relasi']",2,2,0,tambah relasi,2,2
Semoga menghasilkan sesuatu,positif,2021-04-28,2021,semoga menghasilkan sesuatu,3,3,semoga menghasilkan sesuatu,3,3,"['semoga', 'menghasilkan', 'sesuatu']","['semoga', 'menghasilkan']",3,2,1,moga hasil,2,2
Apk tidak jelas,negatif,2022-06-17,2022,apk tidak jelas,3,3,aplikasi tidak jelas,3,3,"['aplikasi', 'tidak', 'jelas']","['aplikasi', 'tidak']",3,2,1,aplikasi tidak,2,2
Ih bagus banget,positif,2022-05-31,2022,ih bagus banget,3,3,ih bagus banget,3,3,"['ih', 'bagus', 'banget']","['ih', 'bagus', 'banget']",3,3,0,ih bagus banget,3,3
Mantap sekali,positif,2022-09-02,2022,mantap sekali,2,2,mantap sekali,2,2,"['mantap', 'sekali']",['mantap'],2,1,1,mantap,1,1
Mantap aplikasinya,positif,2020-06-10,2020,mantap aplikasinya,2,2,mantap aplikasi nya,2,3,"['mantap', 'aplikasi', 'nya']","['mantap', 'aplikasi', 'nya']",3,3,0,mantap aplikasi nya,3,3
Mantap sekali,positif,2022-05-25,2022,mantap sekali,2,2,mantap sekali,2,2,"['mantap', 'sekali']",['mantap'],2,1,1,mantap,1,1
Sangat berguna,positif,2022-12-17,2022,sangat berguna,2,2,sangat berguna,2,2,"['sangat', 'berguna']",['berguna'],2,1,1,guna,1,1
Linkedln mantap lha.,positif,2022-09-14,2022,linkedln mantap lha,3,3,linkedln mantap lah,3,3,"['linkedln', 'mantap', 'lah']","['linkedln', 'mantap']",3,2,1,linkedln mantap,2,2
Apk gak guna,negatif,2024-06-20,2024,apk gak guna,3,3,aplikasi tidak guna,3,3,"['aplikasi', 'tidak', 'guna']","['aplikasi', 'tidak']",3,2,1,aplikasi tidak,2,2
iklan dimana mana,negatif,2024-06-17,2024,iklan dimana mana,3,3,iklan dimana mana,3,3,"['iklan', 'dimana', 'mana']","['iklan', 'dimana']",3,2,1,iklan mana,2,2
Menyusahkan,negatif,2024-06-10,2024,menyusahkan,1,1,menyusahkan,1,1,['menyusahkan'],['menyusahkan'],1,1,0,susah,1,1
Smoga aja dapet kerja dari sini,positif,2021-08-02,2021,smoga aja dapet kerja dari sini,6,6,semoga saja dapat kerja dari sini,6,6,"['semoga', 'saja', 'dapat', 'kerja', 'dari', 'sini']","['semoga', 'kerja']",6,2,4,moga kerja,2,2
Mantul bisa berbagi Bisnis,positif,2020-09-12,2020,mantul bisa berbagi bisnis,4,4,mantap betul bisa berbagi bisnis,4,5,"['mantap', 'betul', 'bisa', 'berbagi', 'bisnis']","['mantap', 'berbagi', 'bisnis']",5,3,2,mantap bagi bisnis,3,3
Membantu sekali,positif,2021-03-17,2021,membantu sekali,2,2,membantu sekali,2,2,"['membantu', 'sekali']",['membantu'],2,1,1,bantu,1,1
Masih mencoba app,positif,2020-09-22,2020,masih mencoba app,3,3,masih mencoba aplikasi,3,3,"['masih', 'mencoba', 'aplikasi']","['mencoba', 'aplikasi']",3,2,1,coba aplikasi,2,2
Kumpulan orang rajin,positif,2022-05-15,2022,kumpulan orang rajin,3,3,kumpulan orang rajin,3,3,"['kumpulan', 'orang', 'rajin']","['kumpulan', 'orang', 'rajin']",3,3,0,kumpul orang rajin,3,3
Mantap sekali,positif,2022-01-29,2022,mantap sekali,2,2,mantap sekali,2,2,"['mantap', 'sekali']",['mantap'],2,1,1,mantap,1,1
semoga ada jalan,positif,2022-07-21,2022,semoga ada jalan,3,3,semoga ada jalan,3,3,"['semoga', 'ada', 'jalan']","['semoga', 'jalan']",3,2,1,moga jalan,2,2
Jelas dan terpercaya,positif,2020-11-18,2020,jelas dan terpercaya,3,3,jelas dan terpercaya,3,3,"['jelas', 'dan', 'terpercaya']",['terpercaya'],3,1,2,percaya,1,1
Bisa kenal dengan orang-orang hebat ....,positif,2020-02-13,2020,bisa kenal dengan orang orang hebat,6,6,bisa kenal dengan orang orang hebat,6,6,"['bisa', 'kenal', 'dengan', 'orang', 'orang', 'hebat']","['kenal', 'orang', 'orang', 'hebat']",6,4,2,kenal orang orang hebat,4,4
super bintang lima dah,positif,2022-10-26,2022,super bintang lima dah,4,4,sangat bintang lima sudah,4,4,"['sangat', 'bintang', 'lima', 'sudah']",['bintang'],4,1,3,bintang,1,1
Lamar kerja nya RIBET,negatif,2021-07-05,2021,lamar kerja nya ribet,4,4,lamar kerja nya rumit,4,4,"['lamar', 'kerja', 'nya', 'rumit']","['lamar', 'kerja', 'nya', 'rumit']",4,4,0,lamar kerja nya rumit,4,4
Membatu kami dalam bersosialisasi,positif,2021-10-07,2021,membatu kami dalam bersosialisasi,4,4,membantu kami dalam bersosialisasi,4,4,"['membantu', 'kami', 'dalam', 'bersosialisasi']","['membantu', 'bersosialisasi']",4,2,2,bantu sosial,2,2
Apknya mantul,positif,2020-02-16,2020,apknya mantul,2,2,aplikasinya mantap betul,2,3,"['aplikasinya', 'mantap', 'betul']","['aplikasinya', 'mantap']",3,2,1,aplikasi mantap,2,2
Gak jelasssss masuk susah bnr,negatif,2021-09-29,2021,gak jelasssss masuk susah bnr,5,5,tidak jelasssss masuk susah benar,5,5,"['tidak', 'jelasssss', 'masuk', 'susah', 'benar']","['tidak', 'jelasssss', 'masuk', 'susah']",5,4,1,tidak jelasssss masuk susah,4,4
Aplikasi gak jelas,negatif,2021-06-11,2021,aplikasi gak jelas,3,3,aplikasi tidak jelas,3,3,"['aplikasi', 'tidak', 'jelas']","['aplikasi', 'tidak']",3,2,1,aplikasi tidak,2,2
Kurang bermanfaat,negatif,2020-01-11,2020,kurang bermanfaat,2,2,kurang bermanfaat,2,2,"['kurang', 'bermanfaat']",['bermanfaat'],2,1,1,manfaat,1,1
Bermanfaat sekali,positif,2023-04-01,2023,bermanfaat sekali,2,2,bermanfaat sekali,2,2,"['bermanfaat', 'sekali']",['bermanfaat'],2,1,1,manfaat,1,1
oke bermanfaat,positif,2023-03-20,2023,oke bermanfaat,2,2,oke bermanfaat,2,2,"['oke', 'bermanfaat']","['oke', 'bermanfaat']",2,2,0,oke manfaat,2,2
Oke membantu,positif,2020-07-19,2020,oke membantu,2,2,oke membantu,2,2,"['oke', 'membantu']","['oke', 'membantu']",2,2,0,oke bantu,2,2
Bagus Sekali!,positif,2022-03-13,2022,bagus sekali,2,2,bagus sekali,2,2,"['bagus', 'sekali']",['bagus'],2,1,1,bagus,1,1
Membantu info loker,positif,2020-01-07,2020,membantu info loker,3,3,membantu informasi loker,3,3,"['membantu', 'informasi', 'loker']","['membantu', 'informasi', 'loker']",3,3,0,bantu informasi loker,3,3
Lagi cari kerjaan.,positif,2022-01-08,2022,lagi cari kerjaan,3,3,lagi cari kerjaan,3,3,"['lagi', 'cari', 'kerjaan']","['cari', 'kerjaan']",3,2,1,cari kerja,2,2
Jadilah orang yang baik dan merendah hati,positif,2021-11-11,2021,jadilah orang yang baik dan merendah hati,7,7,jadilah orang yang baik dan merendah hati,7,7,"['jadilah', 'orang', 'yang', 'baik', 'dan', 'merendah', 'hati']","['orang', 'merendah', 'hati']",7,3,4,orang rendah hati,3,3
Semoga dapat kerja,positif,2020-12-30,2020,semoga dapat kerja,3,3,semoga dapat kerja,3,3,"['semoga', 'dapat', 'kerja']","['semoga', 'kerja']",3,2,1,moga kerja,2,2
Menambah wawasan,positif,2020-08-28,2020,menambah wawasan,2,2,menambah wawasan,2,2,"['menambah', 'wawasan']","['menambah', 'wawasan']",2,2,0,tambah wawas,2,2
Gk bisa login,negatif,2023-05-05,2023,gk bisa login,3,3,tidak bisa login,3,3,"['tidak', 'bisa', 'login']","['tidak', 'login']",3,2,1,tidak login,2,2
Semoga bisa membantu,positif,2020-07-12,2020,semoga bisa membantu,3,3,semoga bisa membantu,3,3,"['semoga', 'bisa', 'membantu']","['semoga', 'membantu']",3,2,1,moga bantu,2,2
menyenangkan,positif,2020-04-28,2020,menyenangkan,1,1,menyenangkan,1,1,['menyenangkan'],['menyenangkan'],1,1,0,senang,1,1
Keren. Inovatif..Gbu,positif,2023-03-08,2023,keren inovatif gbu,2,3,keren inovatif god bless you,3,5,"['keren', 'inovatif', 'god', 'bless', 'you']","['keren', 'inovatif', 'god', 'bless', 'you']",5,5,0,keren inovatif god bless you,5,5
Gampang di fahami,positif,2020-04-25,2020,gampang di fahami,3,3,gampang di pahami,3,3,"['gampang', 'di', 'pahami']","['gampang', 'pahami']",3,2,1,gampang paham,2,2
Ok sangat membantu,positif,2020-02-14,2020,ok sangat membantu,3,3,oke sangat membantu,3,3,"['oke', 'sangat', 'membantu']","['oke', 'membantu']",3,2,1,oke bantu,2,2
Ok semoga bisa dapet kerja,positif,2022-01-11,2022,ok semoga bisa dapet kerja,5,5,oke semoga bisa dapat kerja,5,5,"['oke', 'semoga', 'bisa', 'dapat', 'kerja']","['oke', 'semoga', 'kerja']",5,3,2,oke moga kerja,3,3
Gk bisa dibuka,negatif,2023-10-26,2023,gk bisa dibuka,3,3,tidak bisa dibuka,3,3,"['tidak', 'bisa', 'dibuka']","['tidak', 'dibuka']",3,2,1,tidak buka,2,2
AKU SELALU SETIA melayani anda.,positif,2021-09-26,2021,aku selalu setia melayani anda,5,5,aku selalu setia melayani anda,5,5,"['aku', 'selalu', 'setia', 'melayani', 'anda']","['setia', 'melayani']",5,2,3,setia layan,2,2
Semoga membantu,positif,2024-03-21,2024,semoga membantu,2,2,semoga membantu,2,2,"['semoga', 'membantu']","['semoga', 'membantu']",2,2,0,moga bantu,2,2
Bagus sekali,positif,2022-03-12,2022,bagus sekali,2,2,bagus sekali,2,2,"['bagus', 'sekali']",['bagus'],2,1,1,bagus,1,1
Insyaallah bs membawa berkah 🤝🏻 Amin 🤲🏻,positif,2024-03-13,2024,insyaallah bs membawa berkah amin,7,5,insyaallah bisa membawa berkah aamiin,5,5,"['insyaallah', 'bisa', 'membawa', 'berkah', 'aamiin']","['insyaallah', 'membawa', 'berkah', 'aamiin']",5,4,1,insyaallah bawa berkah aamiin,4,4
Semoga dapet kerjaan,positif,2020-03-12,2020,semoga dapet kerjaan,3,3,semoga dapat kerjaan,3,3,"['semoga', 'dapat', 'kerjaan']","['semoga', 'kerjaan']",3,2,1,moga kerja,2,2
Teruslah berinovasi..,positif,2022-09-28,2022,teruslah berinovasi,2,2,teruslah berinovasi,2,2,"['teruslah', 'berinovasi']","['teruslah', 'berinovasi']",2,2,0,terus inovasi,2,2
Bagus sekali,positif,2021-06-10,2021,bagus sekali,2,2,bagus sekali,2,2,"['bagus', 'sekali']",['bagus'],2,1,1,bagus,1,1
Ketipu gara-gara aplikasi ini,negatif,2023-08-26,2023,ketipu gara gara aplikasi ini,4,5,ketipu gara gara aplikasi ini,5,5,"['ketipu', 'gara', 'gara', 'aplikasi', 'ini']","['ketipu', 'gara', 'gara', 'aplikasi']",5,4,1,tipu gara gara aplikasi,4,4
Perluas wawasan,positif,2020-06-25,2020,perluas wawasan,2,2,perluas wawasan,2,2,"['perluas', 'wawasan']","['perluas', 'wawasan']",2,2,0,luas wawas,2,2
Semoga bisa membantu,positif,2020-11-22,2020,semoga bisa membantu,3,3,semoga bisa membantu,3,3,"['semoga', 'bisa', 'membantu']","['semoga', 'membantu']",3,2,1,moga bantu,2,2
Bagus bgt ya,positif,2021-03-12,2021,bagus bgt ya,3,3,bagus banget ya,3,3,"['bagus', 'banget', 'ya']","['bagus', 'banget', 'ya']",3,3,0,bagus banget ya,3,3
Menyenangkan,positif,2022-03-29,2022,menyenangkan,1,1,menyenangkan,1,1,['menyenangkan'],['menyenangkan'],1,1,0,senang,1,1
Keren sekali,positif,2021-05-06,2021,keren sekali,2,2,keren sekali,2,2,"['keren', 'sekali']",['keren'],2,1,1,keren,1,1
Bagus sekali,positif,2022-08-17,2022,bagus sekali,2,2,bagus sekali,2,2,"['bagus', 'sekali']",['bagus'],2,1,1,bagus,1,1
Ribet mau masuknya,negatif,2022-10-04,2022,ribet mau masuknya,3,3,rumit mau masuknya,3,3,"['rumit', 'mau', 'masuknya']","['rumit', 'masuknya']",3,2,1,rumit masuk,2,2
Semoga saya dapet jobs😊,positif,2022-11-07,2022,semoga saya dapet jobs,4,4,semoga saya dapat jobs,4,4,"['semoga', 'saya', 'dapat', 'jobs']","['semoga', 'jobs']",4,2,2,moga jobs,2,2
Bagus.. Terimakasih ya,positif,2021-07-27,2021,bagus terimakasih ya,3,3,bagus terima kasih ya,3,4,"['bagus', 'terima', 'kasih', 'ya']","['bagus', 'terima', 'kasih', 'ya']",4,4,0,bagus terima kasih ya,4,4
Sungguh bermanfaat,positif,2021-02-15,2021,sungguh bermanfaat,2,2,sungguh bermanfaat,2,2,"['sungguh', 'bermanfaat']","['sungguh', 'bermanfaat']",2,2,0,sungguh manfaat,2,2
Bagus pisan,positif,2022-01-07,2022,bagus pisan,2,2,bagus pisan,2,2,"['bagus', 'pisan']","['bagus', 'pisan']",2,2,0,bagus pis,2,2
Tingkat di naikkan,positif,2022-03-13,2022,tingkat di naikkan,3,3,tingkat di naikkan,3,3,"['tingkat', 'di', 'naikkan']","['tingkat', 'naikkan']",3,2,1,tingkat naik,2,2
Bagus sekali,positif,2022-03-02,2022,bagus sekali,2,2,bagus sekali,2,2,"['bagus', 'sekali']",['bagus'],2,1,1,bagus,1,1
Semoga dapat membantu,positif,2020-06-16,2020,semoga dapat membantu,3,3,semoga dapat membantu,3,3,"['semoga', 'dapat', 'membantu']","['semoga', 'membantu']",3,2,1,moga bantu,2,2
Menyenangkan,positif,2020-06-22,2020,menyenangkan,1,1,menyenangkan,1,1,['menyenangkan'],['menyenangkan'],1,1,0,senang,1,1
Bagus sekali,positif,2020-12-16,2020,bagus sekali,2,2,bagus sekali,2,2,"['bagus', 'sekali']",['bagus'],2,1,1,bagus,1,1
Menyenangkan,positif,2020-07-28,2020,menyenangkan,1,1,menyenangkan,1,1,['menyenangkan'],['menyenangkan'],1,1,0,senang,1,1
Mendapatkan informasi,positif,2021-01-13,2021,mendapatkan informasi,2,2,mendapatkan informasi,2,2,"['mendapatkan', 'informasi']",['informasi'],2,1,1,informasi,1,1
Semoga bisa membantu,positif,2022-09-19,2022,semoga bisa membantu,3,3,semoga bisa membantu,3,3,"['semoga', 'bisa', 'membantu']","['semoga', 'membantu']",3,2,1,moga bantu,2,2
GK bisa login,negatif,2023-04-11,2023,gk bisa login,3,3,tidak bisa login,3,3,"['tidak', 'bisa', 'login']","['tidak', 'login']",3,2,1,tidak login,2,2
semoga bermanfaat,positif,2021-05-07,2021,semoga bermanfaat,2,2,semoga bermanfaat,2,2,"['semoga', 'bermanfaat']","['semoga', 'bermanfaat']",2,2,0,moga manfaat,2,2
Membingungkan,negatif,2024-03-11,2024,membingungkan,1,1,membingungkan,1,1,['membingungkan'],['membingungkan'],1,1,0,bingung,1,1
TDK membantu sama sekali,negatif,2022-06-15,2022,tdk membantu sama sekali,4,4,tidak membantu sama sekali,4,4,"['tidak', 'membantu', 'sama', 'sekali']","['tidak', 'membantu']",4,2,2,tidak bantu,2,2
Semoga memberikan keberuntungan,positif,2020-05-18,2020,semoga memberikan keberuntungan,3,3,semoga memberikan keberuntungan,3,3,"['semoga', 'memberikan', 'keberuntungan']","['semoga', 'keberuntungan']",3,2,1,moga untung,2,2
Semakin mantap,positif,2020-09-10,2020,semakin mantap,2,2,semakin mantap,2,2,"['semakin', 'mantap']",['mantap'],2,1,1,mantap,1,1
Semoga membantu sebagai mana mestinya.,positif,2023-07-03,2023,semoga membantu sebagai mana mestinya,5,5,semoga membantu sebagai mana mestinya,5,5,"['semoga', 'membantu', 'sebagai', 'mana', 'mestinya']","['semoga', 'membantu', 'mestinya']",5,3,2,moga bantu mesti,3,3
Daftarnya ribet,negatif,2022-02-18,2022,daftarnya ribet,2,2,daftarnya rumit,2,2,"['daftarnya', 'rumit']","['daftarnya', 'rumit']",2,2,0,daftar rumit,2,2
saya sangat senang,positif,2020-09-02,2020,saya sangat senang,3,3,saya sangat senang,3,3,"['saya', 'sangat', 'senang']",['senang'],3,1,2,senang,1,1
Bagus sekali,positif,2021-04-13,2021,bagus sekali,2,2,bagus sekali,2,2,"['bagus', 'sekali']",['bagus'],2,1,1,bagus,1,1
Bagus sekali,positif,2021-05-14,2021,bagus sekali,2,2,bagus sekali,2,2,"['bagus', 'sekali']",['bagus'],2,1,1,bagus,1,1
Recapcha bermasalah,negatif,2024-01-19,2024,recapcha bermasalah,2,2,recapcha bermasalah,2,2,"['recapcha', 'bermasalah']","['recapcha', 'bermasalah']",2,2,0,recapcha masalah,2,2
Baik sekali,positif,2021-10-21,2021,baik sekali,2,2,baik sekali,2,2,"['baik', 'sekali']",[],2,1,1,,1,0
Sangat membantu saya,positif,2020-11-02,2020,sangat membantu saya,3,3,sangat membantu saya,3,3,"['sangat', 'membantu', 'saya']",['membantu'],3,1,2,bantu,1,1
Ribet mau masuk,negatif,2021-04-07,2021,ribet mau masuk,3,3,rumit mau masuk,3,3,"['rumit', 'mau', 'masuk']","['rumit', 'masuk']",3,2,1,rumit masuk,2,2
Sangat membantu,positif,2020-11-04,2020,sangat membantu,2,2,sangat membantu,2,2,"['sangat', 'membantu']",['membantu'],2,1,1,bantu,1,1
Aplikasinya mantull,positif,2023-08-12,2023,aplikasinya mantull,2,2,aplikasi nya mantull,2,3,"['aplikasi', 'nya', 'mantull']","['aplikasi', 'nya', 'mantull']",3,3,0,aplikasi nya mantull,3,3
Bagus sekali ok,positif,2020-02-29,2020,bagus sekali ok,3,3,bagus sekali oke,3,3,"['bagus', 'sekali', 'oke']","['bagus', 'oke']",3,2,1,bagus oke,2,2
Verifikasinya bikin gila,negatif,2023-05-16,2023,verifikasinya bikin gila,3,3,verifikasinya bikin gila,3,3,"['verifikasinya', 'bikin', 'gila']","['verifikasinya', 'bikin', 'gila']",3,3,0,verifikasi bikin gila,3,3
Mantap kali bah....,positif,2020-11-05,2020,mantap kali bah,3,3,mantap kali bah,3,3,"['mantap', 'kali', 'bah']","['mantap', 'kali', 'bah']",3,3,0,mantap kali bah,3,3
Semoga bermanfaat,positif,2020-07-25,2020,semoga bermanfaat,2,2,semoga bermanfaat,2,2,"['semoga', 'bermanfaat']","['semoga', 'bermanfaat']",2,2,0,moga manfaat,2,2
Semakin baik,positif,2022-01-05,2022,semakin baik,2,2,semakin baik,2,2,"['semakin', 'baik']",[],2,1,1,,1,0
Bagus sekali,positif,2020-07-12,2020,bagus sekali,2,2,bagus sekali,2,2,"['bagus', 'sekali']",['bagus'],2,1,1,bagus,1,1
Bagus sekali,positif,2022-08-18,2022,bagus sekali,2,2,bagus sekali,2,2,"['bagus', 'sekali']",['bagus'],2,1,1,bagus,1,1
Aku ingin menjadi orang sukses.,positif,2022-08-01,2022,aku ingin menjadi orang sukses,5,5,aku ingin menjadi orang sukses,5,5,"['aku', 'ingin', 'menjadi', 'orang', 'sukses']","['orang', 'sukses']",5,2,3,orang sukses,2,2
Apk busuk bikin emosi 😡,negatif,2022-06-02,2022,apk busuk bikin emosi,5,4,aplikasi busuk bikin emosi,4,4,"['aplikasi', 'busuk', 'bikin', 'emosi']","['aplikasi', 'busuk', 'bikin', 'emosi']",4,4,0,aplikasi busuk bikin emosi,4,4
nyoba semoga sukses,positif,2020-10-23,2020,nyoba semoga sukses,3,3,mencoba semoga sukses,3,3,"['mencoba', 'semoga', 'sukses']","['mencoba', 'semoga', 'sukses']",3,3,0,coba moga sukses,3,3
Semoga bisa membantu.,positif,2020-05-04,2020,semoga bisa membantu,3,3,semoga bisa membantu,3,3,"['semoga', 'bisa', 'membantu']","['semoga', 'membantu']",3,2,1,moga bantu,2,2
Memang sangat membantu,positif,2021-04-20,2021,memang sangat membantu,3,3,memang sangat membantu,3,3,"['memang', 'sangat', 'membantu']",['membantu'],3,1,2,bantu,1,1
Situs yg bagus.,positif,2020-05-04,2020,situs yg bagus,3,3,situs yang bagus,3,3,"['situs', 'yang', 'bagus']","['situs', 'bagus']",3,2,1,situs bagus,2,2
Aku sangat suka,positif,2020-01-12,2020,aku sangat suka,3,3,aku sangat suka,3,3,"['aku', 'sangat', 'suka']",['suka'],3,1,2,suka,1,1
Semoga bermanfaat,positif,2021-10-29,2021,semoga bermanfaat,2,2,semoga bermanfaat,2,2,"['semoga', 'bermanfaat']","['semoga', 'bermanfaat']",2,2,0,moga manfaat,2,2
Terima apa adanya.,positif,2020-02-11,2020,terima apa adanya,3,3,terima apa adanya,3,3,"['terima', 'apa', 'adanya']",['terima'],3,1,2,terima,1,1
Terima kasih semoga baik2,positif,2020-03-10,2020,terima kasih semoga baik,4,4,terima kasih semoga baik,4,4,"['terima', 'kasih', 'semoga', 'baik']","['terima', 'kasih', 'semoga']",4,3,1,terima kasih moga,3,3
bermanfaat sekali,positif,2022-01-03,2022,bermanfaat sekali,2,2,bermanfaat sekali,2,2,"['bermanfaat', 'sekali']",['bermanfaat'],2,1,1,manfaat,1,1
Menambah relasi,positif,2022-08-02,2022,menambah relasi,2,2,menambah relasi,2,2,"['menambah', 'relasi']","['menambah', 'relasi']",2,2,0,tambah relasi,2,2
Semoga bermanfaat,positif,2020-10-25,2020,semoga bermanfaat,2,2,semoga bermanfaat,2,2,"['semoga', 'bermanfaat']","['semoga', 'bermanfaat']",2,2,0,moga manfaat,2,2
Menakjubkan,positif,2022-03-28,2022,menakjubkan,1,1,menakjubkan,1,1,['menakjubkan'],['menakjubkan'],1,1,0,takjub,1,1
Aplikasi yg baik,positif,2020-03-24,2020,aplikasi yg baik,3,3,aplikasi yang baik,3,3,"['aplikasi', 'yang', 'baik']",['aplikasi'],3,1,2,aplikasi,1,1
Good Lah pokonyaa,positif,2021-04-14,2021,good lah pokonyaa,3,3,bagus lah pokoknya,3,3,"['bagus', 'lah', 'pokoknya']","['bagus', 'pokoknya']",3,2,1,bagus pokok,2,2
Baik skali,positif,2020-10-31,2020,baik skali,2,2,baik sekali,2,2,"['baik', 'sekali']",[],2,1,1,,1,0
Smoga membantu,positif,2020-06-21,2020,smoga membantu,2,2,semoga membantu,2,2,"['semoga', 'membantu']","['semoga', 'membantu']",2,2,0,moga bantu,2,2
Terlalu rumit,negatif,2022-02-04,2022,terlalu rumit,2,2,terlalu rumit,2,2,"['terlalu', 'rumit']",['rumit'],2,1,1,rumit,1,1
Bagus..membantu,positif,2020-04-30,2020,bagus membantu,1,2,bagus membantu,2,2,"['bagus', 'membantu']","['bagus', 'membantu']",2,2,0,bagus bantu,2,2
"Maasyaa Allah, keren",positif,2020-06-04,2020,maasyaa allah keren,3,3,maasyaa allah keren,3,3,"['maasyaa', 'allah', 'keren']","['maasyaa', 'allah', 'keren']",3,3,0,maasyaa allah keren,3,3
Maju dan baik,positif,2023-10-20,2023,maju dan baik,3,3,maju dan baik,3,3,"['maju', 'dan', 'baik']",['maju'],3,1,2,maju,1,1
Sip pokoknya,positif,2023-12-17,2023,sip pokoknya,2,2,sip pokoknya,2,2,"['sip', 'pokoknya']","['sip', 'pokoknya']",2,2,0,sip pokok,2,2
cari kerja ok,positif,2020-11-02,2020,cari kerja ok,3,3,cari kerja oke,3,3,"['cari', 'kerja', 'oke']","['cari', 'kerja', 'oke']",3,3,0,cari kerja oke,3,3
saya suka sekali,positif,2020-04-21,2020,saya suka sekali,3,3,saya suka sekali,3,3,"['saya', 'suka', 'sekali']",['suka'],3,1,2,suka,1,1
Gabisa masuk susah,negatif,2020-01-11,2020,gabisa masuk susah,3,3,tidak bisa masuk susah,3,4,"['tidak', 'bisa', 'masuk', 'susah']","['tidak', 'masuk', 'susah']",4,3,1,tidak masuk susah,3,3
Berikan yang terbaik,positif,2023-05-08,2023,berikan yang terbaik,3,3,berikan yang terbaik,3,3,"['berikan', 'yang', 'terbaik']",['terbaik'],3,1,2,baik,1,1
Semoga dapat kerja aamiin,positif,2022-05-08,2022,semoga dapat kerja aamiin,4,4,semoga dapat kerja aamiin,4,4,"['semoga', 'dapat', 'kerja', 'aamiin']","['semoga', 'kerja', 'aamiin']",4,3,1,moga kerja aamiin,3,3
Semoga bermanfaat,positif,2021-03-05,2021,semoga bermanfaat,2,2,semoga bermanfaat,2,2,"['semoga', 'bermanfaat']","['semoga', 'bermanfaat']",2,2,0,moga manfaat,2,2
Berguna sekali,positif,2022-04-07,2022,berguna sekali,2,2,berguna sekali,2,2,"['berguna', 'sekali']",['berguna'],2,1,1,guna,1,1
Semoga membantu saya,positif,2023-12-22,2023,semoga membantu saya,3,3,semoga membantu saya,3,3,"['semoga', 'membantu', 'saya']","['semoga', 'membantu']",3,2,1,moga bantu,2,2
Di mengerti,positif,2020-02-13,2020,di mengerti,2,2,di mengerti,2,2,"['di', 'mengerti']",['mengerti'],2,1,1,erti,1,1
Ok saya suka,positif,2020-09-26,2020,ok saya suka,3,3,oke saya suka,3,3,"['oke', 'saya', 'suka']","['oke', 'suka']",3,2,1,oke suka,2,2
Bagus sekaliii 😍✨,positif,2023-06-02,2023,bagus sekaliii,3,2,bagus sekaliii,2,2,"['bagus', 'sekaliii']","['bagus', 'sekaliii']",2,2,0,bagus sekaliii,2,2
suka sekali,positif,2020-11-06,2020,suka sekali,2,2,suka sekali,2,2,"['suka', 'sekali']",['suka'],2,1,1,suka,1,1
Semoga ada jalan,positif,2022-08-09,2022,semoga ada jalan,3,3,semoga ada jalan,3,3,"['semoga', 'ada', 'jalan']","['semoga', 'jalan']",3,2,1,moga jalan,2,2
Moga berhasil,positif,2020-12-30,2020,moga berhasil,2,2,semoga berhasil,2,2,"['semoga', 'berhasil']","['semoga', 'berhasil']",2,2,0,moga hasil,2,2
Mudah digunakan,positif,2022-06-23,2022,mudah digunakan,2,2,mudah digunakan,2,2,"['mudah', 'digunakan']",['mudah'],2,1,1,mudah,1,1
Semoga bermanfaat,positif,2021-10-08,2021,semoga bermanfaat,2,2,semoga bermanfaat,2,2,"['semoga', 'bermanfaat']","['semoga', 'bermanfaat']",2,2,0,moga manfaat,2,2
Mantap Apknya,positif,2021-11-05,2021,mantap apknya,2,2,mantap aplikasinya,2,2,"['mantap', 'aplikasinya']","['mantap', 'aplikasinya']",2,2,0,mantap aplikasi,2,2
Semoga Bermanfaat,positif,2020-06-18,2020,semoga bermanfaat,2,2,semoga bermanfaat,2,2,"['semoga', 'bermanfaat']","['semoga', 'bermanfaat']",2,2,0,moga manfaat,2,2
Banyak pengalaman,positif,2021-08-20,2021,banyak pengalaman,2,2,banyak pengalaman,2,2,"['banyak', 'pengalaman']",['pengalaman'],2,1,1,alam,1,1
Tidak bermanfaat,negatif,2024-01-04,2024,tidak bermanfaat,2,2,tidak bermanfaat,2,2,"['tidak', 'bermanfaat']","['tidak', 'bermanfaat']",2,2,0,tidak manfaat,2,2
Baik.bermanfaat,positif,2022-04-10,2022,baik bermanfaat,1,2,baik bermanfaat,2,2,"['baik', 'bermanfaat']",['bermanfaat'],2,1,1,manfaat,1,1
Lemot BABI LAH,negatif,2023-01-11,2023,lemot babi lah,3,3,lambat babi lah,3,3,"['lambat', 'babi', 'lah']","['lambat', 'babi']",3,2,1,lambat babi,2,2
Kebangetan Ribet,negatif,2023-11-20,2023,kebangetan ribet,2,2,kebangetan rumit,2,2,"['kebangetan', 'rumit']","['kebangetan', 'rumit']",2,2,0,banget rumit,2,2
Semoga bermanfaat,positif,2023-05-05,2023,semoga bermanfaat,2,2,semoga bermanfaat,2,2,"['semoga', 'bermanfaat']","['semoga', 'bermanfaat']",2,2,0,moga manfaat,2,2
Banyak.membantu.,positif,2023-01-01,2023,banyak membantu,1,2,banyak membantu,2,2,"['banyak', 'membantu']",['membantu'],2,1,1,bantu,1,1
semoga sukses,positif,2022-09-17,2022,semoga sukses,2,2,semoga sukses,2,2,"['semoga', 'sukses']","['semoga', 'sukses']",2,2,0,moga sukses,2,2
Ga bisa masuk2,negatif,2022-07-14,2022,ga bisa masuk,3,3,tidak bisa masuk,3,3,"['tidak', 'bisa', 'masuk']","['tidak', 'masuk']",3,2,1,tidak masuk,2,2
Semoga bermanfaat,positif,2023-03-25,2023,semoga bermanfaat,2,2,semoga bermanfaat,2,2,"['semoga', 'bermanfaat']","['semoga', 'bermanfaat']",2,2,0,moga manfaat,2,2
Memudahkan,positif,2021-02-26,2021,memudahkan,1,1,memudahkan,1,1,['memudahkan'],['memudahkan'],1,1,0,mudah,1,1
Suka sekali,positif,2021-06-10,2021,suka sekali,2,2,suka sekali,2,2,"['suka', 'sekali']",['suka'],2,1,1,suka,1,1
Suka sekali,positif,2023-12-24,2023,suka sekali,2,2,suka sekali,2,2,"['suka', 'sekali']",['suka'],2,1,1,suka,1,1
Mohon di bantu,positif,2022-01-07,2022,mohon di bantu,3,3,mohon di bantu,3,3,"['mohon', 'di', 'bantu']","['mohon', 'bantu']",3,2,1,mohon bantu,2,2
Semoga bisa d bantu,positif,2020-07-03,2020,semoga bisa d bantu,4,4,semoga bisa di bantu,4,4,"['semoga', 'bisa', 'di', 'bantu']","['semoga', 'bantu']",4,2,2,moga bantu,2,2
gak berguna,negatif,2024-03-03,2024,gak berguna,2,2,tidak berguna,2,2,"['tidak', 'berguna']","['tidak', 'berguna']",2,2,0,tidak guna,2,2
App njancoooook babi,negatif,2022-09-27,2022,app njancoooook babi,3,3,aplikasi njancoooook babi,3,3,"['aplikasi', 'njancoooook', 'babi']","['aplikasi', 'njancoooook', 'babi']",3,3,0,aplikasi njancoooook babi,3,3
Bagus sekali,positif,2022-04-26,2022,bagus sekali,2,2,bagus sekali,2,2,"['bagus', 'sekali']",['bagus'],2,1,1,bagus,1,1
Mengecewakan,negatif,2020-08-21,2020,mengecewakan,1,1,mengecewakan,1,1,['mengecewakan'],['mengecewakan'],1,1,0,kecewa,1,1
Sangat bermanfaat,positif,2023-08-13,2023,sangat bermanfaat,2,2,sangat bermanfaat,2,2,"['sangat', 'bermanfaat']",['bermanfaat'],2,1,1,manfaat,1,1
Suka sekali,positif,2023-08-26,2023,suka sekali,2,2,suka sekali,2,2,"['suka', 'sekali']",['suka'],2,1,1,suka,1,1
Suka sekali,positif,2022-05-02,2022,suka sekali,2,2,suka sekali,2,2,"['suka', 'sekali']",['suka'],2,1,1,suka,1,1
Semoga berhasil Aamiin 🙏😇😊,positif,2020-09-05,2020,semoga berhasil aamiin,4,3,semoga berhasil aamiin,3,3,"['semoga', 'berhasil', 'aamiin']","['semoga', 'berhasil', 'aamiin']",3,3,0,moga hasil aamiin,3,3
Semoga ttp bermanfaat,positif,2021-02-18,2021,semoga ttp bermanfaat,3,3,semoga tetap bermanfaat,3,3,"['semoga', 'tetap', 'bermanfaat']","['semoga', 'bermanfaat']",3,2,1,moga manfaat,2,2
bisnis dan karir,positif,2022-01-18,2022,bisnis dan karir,3,3,bisnis dan karir,3,3,"['bisnis', 'dan', 'karir']","['bisnis', 'karir']",3,2,1,bisnis karir,2,2
Semoga di beri kelacaran,positif,2023-02-06,2023,semoga di beri kelacaran,4,4,semoga di beri kelacaran,4,4,"['semoga', 'di', 'beri', 'kelacaran']","['semoga', 'kelacaran']",4,2,2,moga kelacaran,2,2
Kebersamaan,positif,2020-08-29,2020,kebersamaan,1,1,kebersamaan,1,1,['kebersamaan'],['kebersamaan'],1,1,0,sama,1,1
Mantap sekali,positif,2020-02-24,2020,mantap sekali,2,2,mantap sekali,2,2,"['mantap', 'sekali']",['mantap'],2,1,1,mantap,1,1
Menyenangkan,positif,2020-09-13,2020,menyenangkan,1,1,menyenangkan,1,1,['menyenangkan'],['menyenangkan'],1,1,0,senang,1,1
Semoga aja ....,positif,2022-05-07,2022,semoga aja,3,2,semoga saja,2,2,"['semoga', 'saja']",['semoga'],2,1,1,moga,1,1
Sngat bermanfaat,positif,2022-05-25,2022,sngat bermanfaat,2,2,sangat bermanfaat,2,2,"['sangat', 'bermanfaat']",['bermanfaat'],2,1,1,manfaat,1,1
Smg bermanfaat,positif,2023-12-25,2023,smg bermanfaat,2,2,semoga bermanfaat,2,2,"['semoga', 'bermanfaat']","['semoga', 'bermanfaat']",2,2,0,moga manfaat,2,2
Mencoba yg terbaik,positif,2020-11-24,2020,mencoba yg terbaik,3,3,mencoba yang terbaik,3,3,"['mencoba', 'yang', 'terbaik']","['mencoba', 'terbaik']",3,2,1,coba baik,2,2
Memudahkan,positif,2020-10-20,2020,memudahkan,1,1,memudahkan,1,1,['memudahkan'],['memudahkan'],1,1,0,mudah,1,1
Sngt bermanfaat,positif,2022-04-26,2022,sngt bermanfaat,2,2,sangat bermanfaat,2,2,"['sangat', 'bermanfaat']",['bermanfaat'],2,1,1,manfaat,1,1
Smga bermanfaat..,positif,2020-03-30,2020,smga bermanfaat,2,2,semoga bermanfaat,2,2,"['semoga', 'bermanfaat']","['semoga', 'bermanfaat']",2,2,0,moga manfaat,2,2
Sangat Membantu,positif,2020-01-24,2020,sangat membantu,2,2,sangat membantu,2,2,"['sangat', 'membantu']",['membantu'],2,1,1,bantu,1,1
Bagus sekali,positif,2022-07-25,2022,bagus sekali,2,2,bagus sekali,2,2,"['bagus', 'sekali']",['bagus'],2,1,1,bagus,1,1
Semoga lbh baik lagi,positif,2021-07-27,2021,semoga lbh baik lagi,4,4,semoga lebih baik lagi,4,4,"['semoga', 'lebih', 'baik', 'lagi']",['semoga'],4,1,3,moga,1,1
Berbagi ilmu,positif,2020-06-26,2020,berbagi ilmu,2,2,berbagi ilmu,2,2,"['berbagi', 'ilmu']","['berbagi', 'ilmu']",2,2,0,bagi ilmu,2,2
Terbaik aja ya .,positif,2020-12-27,2020,terbaik aja ya,4,3,terbaik saja ya,3,3,"['terbaik', 'saja', 'ya']","['terbaik', 'ya']",3,2,1,baik ya,2,2
Saya berterimakasih,positif,2022-03-14,2022,saya berterimakasih,2,2,saya berterimakasih,2,2,"['saya', 'berterimakasih']",['berterimakasih'],2,1,1,berterimakasih,1,1
ok dech siip,positif,2022-06-12,2022,ok dech siip,3,3,oke deh siip,3,3,"['oke', 'deh', 'siip']","['oke', 'deh', 'siip']",3,3,0,oke deh siip,3,3
mantap sekali,positif,2021-09-19,2021,mantap sekali,2,2,mantap sekali,2,2,"['mantap', 'sekali']",['mantap'],2,1,1,mantap,1,1
Untuk kebaikan,positif,2021-05-09,2021,untuk kebaikan,2,2,untuk kebaikan,2,2,"['untuk', 'kebaikan']",['kebaikan'],2,1,1,baik,1,1
Baik sekali,positif,2021-04-18,2021,baik sekali,2,2,baik sekali,2,2,"['baik', 'sekali']",[],2,1,1,,1,0
Yuks ok lah,positif,2022-04-02,2022,yuks ok lah,3,3,yuks oke lah,3,3,"['yuks', 'oke', 'lah']","['yuks', 'oke']",3,2,1,yuks oke,2,2
Keren aplikasinya,positif,2020-08-22,2020,keren aplikasinya,2,2,keren aplikasi nya,2,3,"['keren', 'aplikasi', 'nya']","['keren', 'aplikasi', 'nya']",3,3,0,keren aplikasi nya,3,3
Baik sekali,positif,2022-07-29,2022,baik sekali,2,2,baik sekali,2,2,"['baik', 'sekali']",[],2,1,1,,1,0
Bagus sekali.,positif,2020-07-24,2020,bagus sekali,2,2,bagus sekali,2,2,"['bagus', 'sekali']",['bagus'],2,1,1,bagus,1,1
Bagus sekali,positif,2020-07-08,2020,bagus sekali,2,2,bagus sekali,2,2,"['bagus', 'sekali']",['bagus'],2,1,1,bagus,1,1
Bagus sekali,positif,2020-11-11,2020,bagus sekali,2,2,bagus sekali,2,2,"['bagus', 'sekali']",['bagus'],2,1,1,bagus,1,1
Bagus sekali,positif,2020-04-05,2020,bagus sekali,2,2,bagus sekali,2,2,"['bagus', 'sekali']",['bagus'],2,1,1,bagus,1,1
Mudah digunakan,positif,2020-11-19,2020,mudah digunakan,2,2,mudah digunakan,2,2,"['mudah', 'digunakan']",['mudah'],2,1,1,mudah,1,1
Ingin bekerja,positif,2020-06-05,2020,ingin bekerja,2,2,ingin bekerja,2,2,"['ingin', 'bekerja']",[],2,1,1,,1,0
Semoga bagus,positif,2023-12-26,2023,semoga bagus,2,2,semoga bagus,2,2,"['semoga', 'bagus']","['semoga', 'bagus']",2,2,0,moga bagus,2,2
Beguna sekali,positif,2021-06-12,2021,beguna sekali,2,2,beguna sekali,2,2,"['beguna', 'sekali']",['beguna'],2,1,1,beguna,1,1
Pendidikan,positif,2022-06-14,2022,pendidikan,1,1,pendidikan,1,1,['pendidikan'],['pendidikan'],1,1,0,didik,1,1
Di bantu ya,positif,2022-07-16,2022,di bantu ya,3,3,di bantu ya,3,3,"['di', 'bantu', 'ya']","['bantu', 'ya']",3,2,1,bantu ya,2,2
Mudah2an amanah,positif,2021-07-03,2021,mudah an amanah,2,3,mudah an amanah,3,3,"['mudah', 'an', 'amanah']","['mudah', 'an', 'amanah']",3,3,0,mudah an amanah,3,3
Bagus sekali,positif,2021-02-23,2021,bagus sekali,2,2,bagus sekali,2,2,"['bagus', 'sekali']",['bagus'],2,1,1,bagus,1,1
Bagus sekali,positif,2022-07-17,2022,bagus sekali,2,2,bagus sekali,2,2,"['bagus', 'sekali']",['bagus'],2,1,1,bagus,1,1
ingin ketemu teman,positif,2021-08-05,2021,ingin ketemu teman,3,3,ingin ketemu teman,3,3,"['ingin', 'ketemu', 'teman']","['ketemu', 'teman']",3,2,1,ketemu teman,2,2
Baik sekali,positif,2022-01-12,2022,baik sekali,2,2,baik sekali,2,2,"['baik', 'sekali']",[],2,1,1,,1,0
Smoga slalu bermanfaat🙏😇,positif,2020-04-01,2020,smoga slalu bermanfaat,3,3,semoga selalu bermanfaat,3,3,"['semoga', 'selalu', 'bermanfaat']","['semoga', 'bermanfaat']",3,2,1,moga manfaat,2,2
Bagus sekali,positif,2021-06-22,2021,bagus sekali,2,2,bagus sekali,2,2,"['bagus', 'sekali']",['bagus'],2,1,1,bagus,1,1
Semoga bermanfaat,positif,2021-08-29,2021,semoga bermanfaat,2,2,semoga bermanfaat,2,2,"['semoga', 'bermanfaat']","['semoga', 'bermanfaat']",2,2,0,moga manfaat,2,2
Bagus sekali,positif,2023-11-28,2023,bagus sekali,2,2,bagus sekali,2,2,"['bagus', 'sekali']",['bagus'],2,1,1,bagus,1,1
Jos pokoknya,positif,2024-01-23,2024,jos pokoknya,2,2,jos pokoknya,2,2,"['jos', 'pokoknya']","['jos', 'pokoknya']",2,2,0,jos pokok,2,2
Dibutuhkan,positif,2021-06-04,2021,dibutuhkan,1,1,dibutuhkan,1,1,['dibutuhkan'],['dibutuhkan'],1,1,0,butuh,1,1
Mantap n bgs bgt,positif,2020-11-14,2020,mantap n bgs bgt,4,4,mantap dan bagus banget,4,4,"['mantap', 'dan', 'bagus', 'banget']","['mantap', 'bagus', 'banget']",4,3,1,mantap bagus banget,3,3
Bagus sekali,positif,2024-03-05,2024,bagus sekali,2,2,bagus sekali,2,2,"['bagus', 'sekali']",['bagus'],2,1,1,bagus,1,1
Semoga berkah,positif,2022-06-07,2022,semoga berkah,2,2,semoga berkah,2,2,"['semoga', 'berkah']","['semoga', 'berkah']",2,2,0,moga berkah,2,2
Bagus sekali,positif,2022-12-14,2022,bagus sekali,2,2,bagus sekali,2,2,"['bagus', 'sekali']",['bagus'],2,1,1,bagus,1,1
Ok aku suka,positif,2021-08-09,2021,ok aku suka,3,3,oke aku suka,3,3,"['oke', 'aku', 'suka']","['oke', 'suka']",3,2,1,oke suka,2,2
Sangat membantu,positif,2022-07-13,2022,sangat membantu,2,2,sangat membantu,2,2,"['sangat', 'membantu']",['membantu'],2,1,1,bantu,1,1
Semoga membantu,positif,2021-10-17,2021,semoga membantu,2,2,semoga membantu,2,2,"['semoga', 'membantu']","['semoga', 'membantu']",2,2,0,moga bantu,2,2
Semoga bisa membantu,positif,2020-03-09,2020,semoga bisa membantu,3,3,semoga bisa membantu,3,3,"['semoga', 'bisa', 'membantu']","['semoga', 'membantu']",3,2,1,moga bantu,2,2
Mantap lh udah,positif,2020-05-31,2020,mantap lh udah,3,3,mantap lh sudah,3,3,"['mantap', 'lh', 'sudah']","['mantap', 'lh']",3,2,1,mantap lh,2,2
Mantul pisan,positif,2022-10-22,2022,mantul pisan,2,2,mantap betul pisan,2,3,"['mantap', 'betul', 'pisan']","['mantap', 'pisan']",3,2,1,mantap pis,2,2
"Jos, sangat membantu",positif,2020-02-25,2020,jos sangat membantu,3,3,jos sangat membantu,3,3,"['jos', 'sangat', 'membantu']","['jos', 'membantu']",3,2,1,jos bantu,2,2
Memberikan kemudahan,positif,2021-06-09,2021,memberikan kemudahan,2,2,memberikan kemudahan,2,2,"['memberikan', 'kemudahan']",['kemudahan'],2,1,1,mudah,1,1
Bagus sekali,positif,2021-08-01,2021,bagus sekali,2,2,bagus sekali,2,2,"['bagus', 'sekali']",['bagus'],2,1,1,bagus,1,1
Hebat memuaskan,positif,2020-02-16,2020,hebat memuaskan,2,2,hebat memuaskan,2,2,"['hebat', 'memuaskan']","['hebat', 'memuaskan']",2,2,0,hebat muas,2,2
Semoga bermanfaat,positif,2021-10-06,2021,semoga bermanfaat,2,2,semoga bermanfaat,2,2,"['semoga', 'bermanfaat']","['semoga', 'bermanfaat']",2,2,0,moga manfaat,2,2
Sunguh berguna,positif,2022-04-27,2022,sunguh berguna,2,2,sunguh berguna,2,2,"['sunguh', 'berguna']","['sunguh', 'berguna']",2,2,0,sunguh guna,2,2
Saya sangat setuju,positif,2023-06-18,2023,saya sangat setuju,3,3,saya sangat setuju,3,3,"['saya', 'sangat', 'setuju']",['setuju'],3,1,2,tuju,1,1
Bagus sekali,positif,2020-05-08,2020,bagus sekali,2,2,bagus sekali,2,2,"['bagus', 'sekali']",['bagus'],2,1,1,bagus,1,1
Saya suka sekali,positif,2023-11-05,2023,saya suka sekali,3,3,saya suka sekali,3,3,"['saya', 'suka', 'sekali']",['suka'],3,1,2,suka,1,1
Bagus sekali,positif,2022-02-10,2022,bagus sekali,2,2,bagus sekali,2,2,"['bagus', 'sekali']",['bagus'],2,1,1,bagus,1,1
Bagus sekali,positif,2021-03-22,2021,bagus sekali,2,2,bagus sekali,2,2,"['bagus', 'sekali']",['bagus'],2,1,1,bagus,1,1
Semoga berkah,positif,2023-12-15,2023,semoga berkah,2,2,semoga berkah,2,2,"['semoga', 'berkah']","['semoga', 'berkah']",2,2,0,moga berkah,2,2
Baik sekali,positif,2020-12-16,2020,baik sekali,2,2,baik sekali,2,2,"['baik', 'sekali']",[],2,1,1,,1,0
semoga baik,positif,2022-12-29,2022,semoga baik,2,2,semoga baik,2,2,"['semoga', 'baik']",['semoga'],2,1,1,moga,1,1
Gk bisa di buka,negatif,2020-11-25,2020,gk bisa di buka,4,4,tidak bisa di buka,4,4,"['tidak', 'bisa', 'di', 'buka']","['tidak', 'buka']",4,2,2,tidak buka,2,2
Bagus sekali,positif,2020-09-28,2020,bagus sekali,2,2,bagus sekali,2,2,"['bagus', 'sekali']",['bagus'],2,1,1,bagus,1,1
Bagus sekali,positif,2023-02-13,2023,bagus sekali,2,2,bagus sekali,2,2,"['bagus', 'sekali']",['bagus'],2,1,1,bagus,1,1
Pengen lebih baik,positif,2021-03-07,2021,pengen lebih baik,3,3,pengen lebih baik,3,3,"['pengen', 'lebih', 'baik']",['pengen'],3,1,2,ken,1,1
Bagus bermanfaat,positif,2023-12-24,2023,bagus bermanfaat,2,2,bagus bermanfaat,2,2,"['bagus', 'bermanfaat']","['bagus', 'bermanfaat']",2,2,0,bagus manfaat,2,2
Ok punya seru,positif,2020-07-29,2020,ok punya seru,3,3,oke punya seru,3,3,"['oke', 'punya', 'seru']","['oke', 'seru']",3,2,1,oke seru,2,2
Semoga lebih bermanfaat,positif,2022-10-24,2022,semoga lebih bermanfaat,3,3,semoga lebih bermanfaat,3,3,"['semoga', 'lebih', 'bermanfaat']","['semoga', 'bermanfaat']",3,2,1,moga manfaat,2,2
Ya saya sangat sukaa,positif,2023-03-23,2023,ya saya sangat sukaa,4,4,ya saya sangat suka,4,4,"['ya', 'saya', 'sangat', 'suka']","['ya', 'suka']",4,2,2,ya suka,2,2
Baik sekali,positif,2020-02-18,2020,baik sekali,2,2,baik sekali,2,2,"['baik', 'sekali']",[],2,1,1,,1,0
Banyak kenalan baru,positif,2020-07-02,2020,banyak kenalan baru,3,3,banyak kenalan baru,3,3,"['banyak', 'kenalan', 'baru']",['kenalan'],3,1,2,kenal,1,1
Mau Login Aja susah,negatif,2023-07-19,2023,mau login aja susah,4,4,mau login saja susah,4,4,"['mau', 'login', 'saja', 'susah']","['login', 'susah']",4,2,2,login susah,2,2
Semoga bermanfaat,positif,2023-10-15,2023,semoga bermanfaat,2,2,semoga bermanfaat,2,2,"['semoga', 'bermanfaat']","['semoga', 'bermanfaat']",2,2,0,moga manfaat,2,2
Apk gjls ngentod,negatif,2021-08-13,2021,apk gjls ngentod,3,3,aplikasi gjls ngentod,3,3,"['aplikasi', 'gjls', 'ngentod']","['aplikasi', 'gjls', 'ngentod']",3,3,0,aplikasi gjls ngentod,3,3
Bukanya susah,negatif,2023-08-23,2023,bukanya susah,2,2,bukanya susah,2,2,"['bukanya', 'susah']","['bukanya', 'susah']",2,2,0,buka susah,2,2
Terima kasih ya,positif,2020-10-20,2020,terima kasih ya,3,3,terima kasih ya,3,3,"['terima', 'kasih', 'ya']","['terima', 'kasih', 'ya']",3,3,0,terima kasih ya,3,3
Mantap jiwa bosss,positif,2021-07-07,2021,mantap jiwa bosss,3,3,mantap jiwa bosss,3,3,"['mantap', 'jiwa', 'bosss']","['mantap', 'jiwa', 'bosss']",3,3,0,mantap jiwa bosss,3,3
Bagus sekali,positif,2020-04-30,2020,bagus sekali,2,2,bagus sekali,2,2,"['bagus', 'sekali']",['bagus'],2,1,1,bagus,1,1
Bolak balik mulu,negatif,2022-11-15,2022,bolak balik mulu,3,3,bolak balik mulu,3,3,"['bolak', 'balik', 'mulu']","['bolak', 'mulu']",3,2,1,bolak mulu,2,2
Senang sekali,positif,2024-02-09,2024,senang sekali,2,2,senang sekali,2,2,"['senang', 'sekali']",['senang'],2,1,1,senang,1,1
Sangat membantu,positif,2022-06-25,2022,sangat membantu,2,2,sangat membantu,2,2,"['sangat', 'membantu']",['membantu'],2,1,1,bantu,1,1
Oke oke saja,positif,2021-08-16,2021,oke oke saja,3,3,oke oke saja,3,3,"['oke', 'oke', 'saja']","['oke', 'oke']",3,2,1,oke oke,2,2
Semoga berkah,positif,2020-10-02,2020,semoga berkah,2,2,semoga berkah,2,2,"['semoga', 'berkah']","['semoga', 'berkah']",2,2,0,moga berkah,2,2
Mohon bantuan ny,positif,2021-05-24,2021,mohon bantuan ny,3,3,mohon bantuan nya,3,3,"['mohon', 'bantuan', 'nya']","['mohon', 'bantuan', 'nya']",3,3,0,mohon bantu nya,3,3
Menyusahkan login,negatif,2023-12-26,2023,menyusahkan login,2,2,menyusahkan login,2,2,"['menyusahkan', 'login']","['menyusahkan', 'login']",2,2,0,susah login,2,2
Semoga bermanfaat,positif,2023-10-24,2023,semoga bermanfaat,2,2,semoga bermanfaat,2,2,"['semoga', 'bermanfaat']","['semoga', 'bermanfaat']",2,2,0,moga manfaat,2,2
Memudahkan,positif,2023-09-26,2023,memudahkan,1,1,memudahkan,1,1,['memudahkan'],['memudahkan'],1,1,0,mudah,1,1
Berharap membantu saya,positif,2021-08-25,2021,berharap membantu saya,3,3,berharap membantu saya,3,3,"['berharap', 'membantu', 'saya']","['berharap', 'membantu']",3,2,1,harap bantu,2,2
Semoga bermanfaat,positif,2021-10-25,2021,semoga bermanfaat,2,2,semoga bermanfaat,2,2,"['semoga', 'bermanfaat']","['semoga', 'bermanfaat']",2,2,0,moga manfaat,2,2
Bagus sekali,positif,2021-09-17,2021,bagus sekali,2,2,bagus sekali,2,2,"['bagus', 'sekali']",['bagus'],2,1,1,bagus,1,1
Macet melulu,negatif,2021-11-30,2021,macet melulu,2,2,macet melulu,2,2,"['macet', 'melulu']","['macet', 'melulu']",2,2,0,macet melulu,2,2
Bagus sekali,positif,2021-08-27,2021,bagus sekali,2,2,bagus sekali,2,2,"['bagus', 'sekali']",['bagus'],2,1,1,bagus,1,1
Apk gak jelas,negatif,2022-07-12,2022,apk gak jelas,3,3,aplikasi tidak jelas,3,3,"['aplikasi', 'tidak', 'jelas']","['aplikasi', 'tidak']",3,2,1,aplikasi tidak,2,2
Semakin maju,positif,2022-03-16,2022,semakin maju,2,2,semakin maju,2,2,"['semakin', 'maju']",['maju'],2,1,1,maju,1,1
GAK GUNA SAMPAH,negatif,2023-05-10,2023,gak guna sampah,3,3,tidak guna sampah,3,3,"['tidak', 'guna', 'sampah']","['tidak', 'sampah']",3,2,1,tidak sampah,2,2
Semoga berkah...,positif,2023-10-28,2023,semoga berkah,2,2,semoga berkah,2,2,"['semoga', 'berkah']","['semoga', 'berkah']",2,2,0,moga berkah,2,2
Bagus bnget jjjj,positif,2021-10-12,2021,bagus bnget jjjj,3,3,bagus banget jjjj,3,3,"['bagus', 'banget', 'jjjj']","['bagus', 'banget', 'jjjj']",3,3,0,bagus banget jjjj,3,3
Membantu bnaget,positif,2021-06-05,2021,membantu bnaget,2,2,membantu bnaget,2,2,"['membantu', 'bnaget']","['membantu', 'bnaget']",2,2,0,bantu bnaget,2,2
Semoga bermanfaat 🙏,positif,2021-12-19,2021,semoga bermanfaat,3,2,semoga bermanfaat,2,2,"['semoga', 'bermanfaat']","['semoga', 'bermanfaat']",2,2,0,moga manfaat,2,2
Semoga bermanfaat,positif,2020-02-26,2020,semoga bermanfaat,2,2,semoga bermanfaat,2,2,"['semoga', 'bermanfaat']","['semoga', 'bermanfaat']",2,2,0,moga manfaat,2,2
Semoga dapat membantu,positif,2021-10-28,2021,semoga dapat membantu,3,3,semoga dapat membantu,3,3,"['semoga', 'dapat', 'membantu']","['semoga', 'membantu']",3,2,1,moga bantu,2,2
Ok terima kasih,positif,2023-12-22,2023,ok terima kasih,3,3,oke terima kasih,3,3,"['oke', 'terima', 'kasih']","['oke', 'terima', 'kasih']",3,3,0,oke terima kasih,3,3
Buruk gak guna,negatif,2023-11-25,2023,buruk gak guna,3,3,buruk tidak guna,3,3,"['buruk', 'tidak', 'guna']","['buruk', 'tidak']",3,2,1,buruk tidak,2,2
Moga membantu,positif,2021-05-29,2021,moga membantu,2,2,semoga membantu,2,2,"['semoga', 'membantu']","['semoga', 'membantu']",2,2,0,moga bantu,2,2
Baik sekali,positif,2023-11-18,2023,baik sekali,2,2,baik sekali,2,2,"['baik', 'sekali']",[],2,1,1,,1,0
Bagus sekali,positif,2021-01-21,2021,bagus sekali,2,2,bagus sekali,2,2,"['bagus', 'sekali']",['bagus'],2,1,1,bagus,1,1
Baik sekali,positif,2021-02-24,2021,baik sekali,2,2,baik sekali,2,2,"['baik', 'sekali']",[],2,1,1,,1,0
Semoga rejeki aamiin,positif,2023-02-25,2023,semoga rejeki aamiin,3,3,semoga rejeki aamiin,3,3,"['semoga', 'rejeki', 'aamiin']","['semoga', 'rejeki', 'aamiin']",3,3,0,moga rejeki aamiin,3,3
Sngat membantu,positif,2020-03-17,2020,sngat membantu,2,2,sangat membantu,2,2,"['sangat', 'membantu']",['membantu'],2,1,1,bantu,1,1
Menyenangkan,positif,2023-10-28,2023,menyenangkan,1,1,menyenangkan,1,1,['menyenangkan'],['menyenangkan'],1,1,0,senang,1,1
Semoga baik,positif,2020-08-22,2020,semoga baik,2,2,semoga baik,2,2,"['semoga', 'baik']",['semoga'],2,1,1,moga,1,1
Semoga berkah aamiin,positif,2023-04-22,2023,semoga berkah aamiin,3,3,semoga berkah aamiin,3,3,"['semoga', 'berkah', 'aamiin']","['semoga', 'berkah', 'aamiin']",3,3,0,moga berkah aamiin,3,3
Semoga bermanfaat,positif,2021-05-06,2021,semoga bermanfaat,2,2,semoga bermanfaat,2,2,"['semoga', 'bermanfaat']","['semoga', 'bermanfaat']",2,2,0,moga manfaat,2,2
"Ya Begitulah,",positif,2020-05-02,2020,ya begitulah,2,2,ya begitulah,2,2,"['ya', 'begitulah']",['ya'],2,1,1,ya,1,1
Nyusahin lah anying,negatif,2022-09-15,2022,nyusahin lah anying,3,3,nyusahin lah anying,3,3,"['nyusahin', 'lah', 'anying']","['nyusahin', 'anying']",3,2,1,nyusahin anying,2,2
akun saya diretas orang. saya tdk bisa login. ada solusi kah ?,negatif,2024-09-02,2024,akun saya diretas orang saya tdk bisa login ada solusi kah,12,11,akun saya diretas orang saya tidak bisa login ada solusi kah,11,11,"['akun', 'saya', 'diretas', 'orang', 'saya', 'tidak', 'bisa', 'login', 'ada', 'solusi', 'kah']","['akun', 'diretas', 'orang', 'tidak', 'login', 'solusi', 'kah']",11,7,4,akun retas orang tidak login solusi kah,7,7
Bagus sekali,positif,2024-08-31,2024,bagus sekali,2,2,bagus sekali,2,2,"['bagus', 'sekali']",['bagus'],2,1,1,bagus,1,1
Good,positif,2024-09-02,2024,good,1,1,bagus,1,1,['bagus'],['bagus'],1,1,0,bagus,1,1
Good app,positif,2024-08-30,2024,good app,2,2,bagus aplikasi,2,2,"['bagus', 'aplikasi']","['bagus', 'aplikasi']",2,2,0,bagus aplikasi,2,2
Ok,positif,2024-08-28,2024,ok,1,1,oke,1,1,['oke'],['oke'],1,1,0,oke,1,1
Sangat bagus👍,positif,2024-08-29,2024,sangat bagus,2,2,sangat bagus,2,2,"['sangat', 'bagus']",['bagus'],2,1,1,bagus,1,1
Nice,positif,2024-08-29,2024,nice,1,1,baik,1,1,['baik'],[],1,1,0,,1,0
bagus,positif,2024-08-24,2024,bagus,1,1,bagus,1,1,['bagus'],['bagus'],1,1,0,bagus,1,1
Mantapp!!,positif,2024-08-27,2024,mantapp,1,1,mantap,1,1,['mantap'],['mantap'],1,1,0,mantap,1,1
Ok,positif,2024-08-31,2024,ok,1,1,oke,1,1,['oke'],['oke'],1,1,0,oke,1,1
Oke,positif,2024-08-25,2024,oke,1,1,oke,1,1,['oke'],['oke'],1,1,0,oke,1,1
Bagus,positif,2024-08-27,2024,bagus,1,1,bagus,1,1,['bagus'],['bagus'],1,1,0,bagus,1,1
Aman,positif,2024-08-25,2024,aman,1,1,aman,1,1,['aman'],['aman'],1,1,0,aman,1,1
Terpercaya...,positif,2024-08-31,2024,terpercaya,1,1,terpercaya,1,1,['terpercaya'],['terpercaya'],1,1,0,percaya,1,1
Ist good,positif,2024-08-23,2024,ist good,2,2,ist bagus,2,2,"['ist', 'bagus']","['ist', 'bagus']",2,2,0,ist bagus,2,2
Aplikasi yang sangat bagus untuk jenjang karir,positif,2024-08-20,2024,aplikasi yang sangat bagus untuk jenjang karir,7,7,aplikasi yang sangat bagus untuk jenjang karir,7,7,"['aplikasi', 'yang', 'sangat', 'bagus', 'untuk', 'jenjang', 'karir']","['aplikasi', 'bagus', 'jenjang', 'karir']",7,4,3,aplikasi bagus jenjang karir,4,4
sistem lambat,negatif,2024-08-21,2024,sistem lambat,2,2,sistem lambat,2,2,"['sistem', 'lambat']","['sistem', 'lambat']",2,2,0,sistem lambat,2,2
Nice,positif,2024-07-31,2024,nice,1,1,baik,1,1,['baik'],[],1,1,0,,1,0
Ok,positif,2024-06-20,2024,ok,1,1,oke,1,1,['oke'],['oke'],1,1,0,oke,1,1
Ok,positif,2024-06-18,2024,ok,1,1,oke,1,1,['oke'],['oke'],1,1,0,oke,1,1
butut,negatif,2024-06-16,2024,butut,1,1,butut,1,1,['butut'],['butut'],1,1,0,butut,1,1
Baik,positif,2024-06-14,2024,baik,1,1,baik,1,1,['baik'],[],1,1,0,,1,0
Menarik,positif,2024-06-14,2024,menarik,1,1,menarik,1,1,['menarik'],['menarik'],1,1,0,tarik,1,1
Alhamdulillah 🙏,positif,2024-06-18,2024,alhamdulillah,2,1,alhamdulillah,1,1,['alhamdulillah'],['alhamdulillah'],1,1,0,alhamdulillah,1,1
Good👱,positif,2024-06-17,2024,good,1,1,bagus,1,1,['bagus'],['bagus'],1,1,0,bagus,1,1
Beatiful good,positif,2024-06-14,2024,beatiful good,2,2,beatiful bagus,2,2,"['beatiful', 'bagus']","['beatiful', 'bagus']",2,2,0,beatiful bagus,2,2
OK.,positif,2024-06-15,2024,ok,1,1,oke,1,1,['oke'],['oke'],1,1,0,oke,1,1
Susah login via google,negatif,2024-06-13,2024,susah login via google,4,4,susah login melalui google,4,4,"['susah', 'login', 'melalui', 'google']","['susah', 'login', 'google']",4,3,1,susah login google,3,3
Oke,positif,2024-06-13,2024,oke,1,1,oke,1,1,['oke'],['oke'],1,1,0,oke,1,1
Baru,positif,2024-06-13,2024,baru,1,1,baru,1,1,['baru'],[],1,1,0,,1,0
Mantap,positif,2024-06-12,2024,mantap,1,1,mantap,1,1,['mantap'],['mantap'],1,1,0,mantap,1,1
Luarr biasaa,positif,2022-07-30,2022,luarr biasaa,2,2,luarr biasaa,2,2,"['luarr', 'biasaa']","['luarr', 'biasaa']",2,2,0,luarr biasaa,2,2
Sangat bagus,positif,2022-08-05,2022,sangat bagus,2,2,sangat bagus,2,2,"['sangat', 'bagus']",['bagus'],2,1,1,bagus,1,1
Good,positif,2020-06-01,2020,good,1,1,bagus,1,1,['bagus'],['bagus'],1,1,0,bagus,1,1
Mantap,positif,2022-02-17,2022,mantap,1,1,mantap,1,1,['mantap'],['mantap'],1,1,0,mantap,1,1
Mantap,positif,2020-07-01,2020,mantap,1,1,mantap,1,1,['mantap'],['mantap'],1,1,0,mantap,1,1
Bagus,positif,2020-06-04,2020,bagus,1,1,bagus,1,1,['bagus'],['bagus'],1,1,0,bagus,1,1
Mantaap,positif,2020-06-10,2020,mantaap,1,1,mantap,1,1,['mantap'],['mantap'],1,1,0,mantap,1,1
Good,positif,2020-06-03,2020,good,1,1,bagus,1,1,['bagus'],['bagus'],1,1,0,bagus,1,1
Bagus,positif,2020-06-03,2020,bagus,1,1,bagus,1,1,['bagus'],['bagus'],1,1,0,bagus,1,1
Bagus,positif,2020-06-05,2020,bagus,1,1,bagus,1,1,['bagus'],['bagus'],1,1,0,bagus,1,1
Ok,positif,2020-07-11,2020,ok,1,1,oke,1,1,['oke'],['oke'],1,1,0,oke,1,1
Best app,positif,2020-07-17,2020,best app,2,2,terbaik aplikasi,2,2,"['terbaik', 'aplikasi']","['terbaik', 'aplikasi']",2,2,0,baik aplikasi,2,2
Good aplication,positif,2020-06-05,2020,good aplication,2,2,bagus aplication,2,2,"['bagus', 'aplication']","['bagus', 'aplication']",2,2,0,bagus aplication,2,2
Very good,positif,2020-06-13,2020,very good,2,2,sangat bagus,2,2,"['sangat', 'bagus']",['bagus'],2,1,1,bagus,1,1
Very good,positif,2020-11-17,2020,very good,2,2,sangat bagus,2,2,"['sangat', 'bagus']",['bagus'],2,1,1,bagus,1,1
Ok.,positif,2020-06-04,2020,ok,1,1,oke,1,1,['oke'],['oke'],1,1,0,oke,1,1
great,positif,2020-05-29,2020,great,1,1,great,1,1,['great'],['great'],1,1,0,great,1,1
Good aplication,positif,2020-09-25,2020,good aplication,2,2,bagus aplication,2,2,"['bagus', 'aplication']","['bagus', 'aplication']",2,2,0,bagus aplication,2,2
Okok ok,positif,2020-05-26,2020,okok ok,2,2,okok oke,2,2,"['okok', 'oke']","['okok', 'oke']",2,2,0,okok oke,2,2
Mantap,positif,2020-05-23,2020,mantap,1,1,mantap,1,1,['mantap'],['mantap'],1,1,0,mantap,1,1
Good,positif,2020-05-28,2020,good,1,1,bagus,1,1,['bagus'],['bagus'],1,1,0,bagus,1,1
Mantap,positif,2020-06-12,2020,mantap,1,1,mantap,1,1,['mantap'],['mantap'],1,1,0,mantap,1,1
Bagus,positif,2021-05-11,2021,bagus,1,1,bagus,1,1,['bagus'],['bagus'],1,1,0,bagus,1,1
Baik,positif,2020-05-27,2020,baik,1,1,baik,1,1,['baik'],[],1,1,0,,1,0
Mantul,positif,2021-08-13,2021,mantul,1,1,mantap betul,1,2,"['mantap', 'betul']",['mantap'],2,1,1,mantap,1,1
Good,positif,2020-05-27,2020,good,1,1,bagus,1,1,['bagus'],['bagus'],1,1,0,bagus,1,1
Good,positif,2020-10-16,2020,good,1,1,bagus,1,1,['bagus'],['bagus'],1,1,0,bagus,1,1
Puas,positif,2020-05-25,2020,puas,1,1,puas,1,1,['puas'],['puas'],1,1,0,puas,1,1
Mntap,positif,2020-06-26,2020,mntap,1,1,mantap,1,1,['mantap'],['mantap'],1,1,0,mantap,1,1
mantap,positif,2020-08-31,2020,mantap,1,1,mantap,1,1,['mantap'],['mantap'],1,1,0,mantap,1,1
ok,positif,2020-05-28,2020,ok,1,1,oke,1,1,['oke'],['oke'],1,1,0,oke,1,1
Good,positif,2020-05-25,2020,good,1,1,bagus,1,1,['bagus'],['bagus'],1,1,0,bagus,1,1
Awsome,positif,2020-05-28,2020,awsome,1,1,awsome,1,1,['awsome'],['awsome'],1,1,0,awsome,1,1
Good,positif,2020-06-06,2020,good,1,1,bagus,1,1,['bagus'],['bagus'],1,1,0,bagus,1,1
Sangat bagus,positif,2020-05-26,2020,sangat bagus,2,2,sangat bagus,2,2,"['sangat', 'bagus']",['bagus'],2,1,1,bagus,1,1
Best app,positif,2020-05-29,2020,best app,2,2,terbaik aplikasi,2,2,"['terbaik', 'aplikasi']","['terbaik', 'aplikasi']",2,2,0,baik aplikasi,2,2
Useful app,positif,2020-06-03,2020,useful app,2,2,useful aplikasi,2,2,"['useful', 'aplikasi']","['useful', 'aplikasi']",2,2,0,useful aplikasi,2,2
Good aplication,positif,2022-01-23,2022,good aplication,2,2,bagus aplication,2,2,"['bagus', 'aplication']","['bagus', 'aplication']",2,2,0,bagus aplication,2,2
Lumayan,positif,2020-05-21,2020,lumayan,1,1,lumayan,1,1,['lumayan'],['lumayan'],1,1,0,lumayan,1,1
salam sukses👍,positif,2020-05-23,2020,salam sukses,2,2,salam sukses,2,2,"['salam', 'sukses']","['salam', 'sukses']",2,2,0,salam sukses,2,2
Membangun,positif,2020-05-24,2020,membangun,1,1,membangun,1,1,['membangun'],['membangun'],1,1,0,bangun,1,1
Petualang,positif,2020-05-27,2020,petualang,1,1,petualang,1,1,['petualang'],['petualang'],1,1,0,tualang,1,1
Bermanfaat,positif,2020-06-13,2020,bermanfaat,1,1,bermanfaat,1,1,['bermanfaat'],['bermanfaat'],1,1,0,manfaat,1,1
Keren,positif,2022-06-23,2022,keren,1,1,keren,1,1,['keren'],['keren'],1,1,0,keren,1,1
Nice,positif,2020-05-22,2020,nice,1,1,baik,1,1,['baik'],[],1,1,0,,1,0
Bagus,positif,2020-05-18,2020,bagus,1,1,bagus,1,1,['bagus'],['bagus'],1,1,0,bagus,1,1
Good,positif,2020-07-09,2020,good,1,1,bagus,1,1,['bagus'],['bagus'],1,1,0,bagus,1,1
Keren,positif,2020-05-22,2020,keren,1,1,keren,1,1,['keren'],['keren'],1,1,0,keren,1,1
Keren.,positif,2020-05-19,2020,keren,1,1,keren,1,1,['keren'],['keren'],1,1,0,keren,1,1
Good,positif,2020-05-14,2020,good,1,1,bagus,1,1,['bagus'],['bagus'],1,1,0,bagus,1,1
Like it,positif,2020-08-03,2020,like it,2,2,like it,2,2,"['like', 'it']","['like', 'it']",2,2,0,like it,2,2
Very good,positif,2020-08-23,2020,very good,2,2,sangat bagus,2,2,"['sangat', 'bagus']",['bagus'],2,1,1,bagus,1,1
Cukup baik,positif,2020-05-19,2020,cukup baik,2,2,cukup baik,2,2,"['cukup', 'baik']",[],2,1,1,,1,0
Good 👍👍👍👍🙏🙏🙏🙏🙏,positif,2020-05-21,2020,good,2,1,bagus,1,1,['bagus'],['bagus'],1,1,0,bagus,1,1
Medsos dg basic profesi..keren,positif,2020-05-08,2020,medsos dg basic profesi keren,4,5,media sosial dengan basic profesi keren,5,6,"['media', 'sosial', 'dengan', 'basic', 'profesi', 'keren']","['media', 'sosial', 'basic', 'profesi', 'keren']",6,5,1,media sosial basic profesi keren,5,5
"Very nice, Good job!!!!",positif,2020-05-31,2020,very nice good job,4,4,sangat baik bagus kerja,4,4,"['sangat', 'baik', 'bagus', 'kerja']","['bagus', 'kerja']",4,2,2,bagus kerja,2,2
I can get more relation. Good job.,positif,2020-05-14,2020,i can get more relation good job,7,7,i can get more relation bagus kerja,7,7,"['i', 'can', 'get', 'more', 'relation', 'bagus', 'kerja']","['i', 'can', 'get', 'more', 'relation', 'bagus', 'kerja']",7,7,0,i can get more relation bagus kerja,7,7
Lumayan bagus...,positif,2020-05-18,2020,lumayan bagus,2,2,lumayan bagus,2,2,"['lumayan', 'bagus']","['lumayan', 'bagus']",2,2,0,lumayan bagus,2,2
Oke,positif,2020-05-05,2020,oke,1,1,oke,1,1,['oke'],['oke'],1,1,0,oke,1,1
Ok,positif,2020-05-17,2020,ok,1,1,oke,1,1,['oke'],['oke'],1,1,0,oke,1,1
Mantap,positif,2021-02-17,2021,mantap,1,1,mantap,1,1,['mantap'],['mantap'],1,1,0,mantap,1,1
Baik,positif,2020-05-10,2020,baik,1,1,baik,1,1,['baik'],[],1,1,0,,1,0
Very good,positif,2020-05-19,2020,very good,2,2,sangat bagus,2,2,"['sangat', 'bagus']",['bagus'],2,1,1,bagus,1,1
Bagus,positif,2020-05-05,2020,bagus,1,1,bagus,1,1,['bagus'],['bagus'],1,1,0,bagus,1,1
Oke,positif,2020-05-17,2020,oke,1,1,oke,1,1,['oke'],['oke'],1,1,0,oke,1,1
good job.,positif,2020-05-22,2020,good job,2,2,bagus kerja,2,2,"['bagus', 'kerja']","['bagus', 'kerja']",2,2,0,bagus kerja,2,2
Gak jelas,positif,2020-09-14,2020,gak jelas,2,2,tidak jelas,2,2,"['tidak', 'jelas']",['tidak'],2,1,1,tidak,1,1
Mantap jiwa 😎😎😎,positif,2020-05-01,2020,mantap jiwa,3,2,mantap jiwa,2,2,"['mantap', 'jiwa']","['mantap', 'jiwa']",2,2,0,mantap jiwa,2,2
bagus,positif,2020-05-18,2020,bagus,1,1,bagus,1,1,['bagus'],['bagus'],1,1,0,bagus,1,1
Maknyos,positif,2020-10-29,2020,maknyos,1,1,maknyos,1,1,['maknyos'],['maknyos'],1,1,0,maknyos,1,1
ok,positif,2020-06-09,2020,ok,1,1,oke,1,1,['oke'],['oke'],1,1,0,oke,1,1
Ok,positif,2020-08-27,2020,ok,1,1,oke,1,1,['oke'],['oke'],1,1,0,oke,1,1
Mantap,positif,2020-05-13,2020,mantap,1,1,mantap,1,1,['mantap'],['mantap'],1,1,0,mantap,1,1
Nice,positif,2020-06-02,2020,nice,1,1,baik,1,1,['baik'],[],1,1,0,,1,0
Good,positif,2020-09-22,2020,good,1,1,bagus,1,1,['bagus'],['bagus'],1,1,0,bagus,1,1
Oke,positif,2020-05-04,2020,oke,1,1,oke,1,1,['oke'],['oke'],1,1,0,oke,1,1
Terimakasih,positif,2020-05-03,2020,terimakasih,1,1,terima kasih,1,2,"['terima', 'kasih']","['terima', 'kasih']",2,2,0,terima kasih,2,2
Bagus,positif,2020-04-30,2020,bagus,1,1,bagus,1,1,['bagus'],['bagus'],1,1,0,bagus,1,1
good,positif,2023-12-11,2023,good,1,1,bagus,1,1,['bagus'],['bagus'],1,1,0,bagus,1,1
Bagus,positif,2020-05-02,2020,bagus,1,1,bagus,1,1,['bagus'],['bagus'],1,1,0,bagus,1,1
Ok,positif,2021-02-08,2021,ok,1,1,oke,1,1,['oke'],['oke'],1,1,0,oke,1,1
GooD,positif,2020-05-04,2020,good,1,1,bagus,1,1,['bagus'],['bagus'],1,1,0,bagus,1,1
Good,positif,2020-06-19,2020,good,1,1,bagus,1,1,['bagus'],['bagus'],1,1,0,bagus,1,1
Great,positif,2020-05-19,2020,great,1,1,great,1,1,['great'],['great'],1,1,0,great,1,1
Good,positif,2020-12-13,2020,good,1,1,bagus,1,1,['bagus'],['bagus'],1,1,0,bagus,1,1
Like,positif,2020-06-29,2020,like,1,1,like,1,1,['like'],['like'],1,1,0,like,1,1
Good,positif,2020-07-26,2020,good,1,1,bagus,1,1,['bagus'],['bagus'],1,1,0,bagus,1,1
Terimakasih,positif,2020-05-09,2020,terimakasih,1,1,terima kasih,1,2,"['terima', 'kasih']","['terima', 'kasih']",2,2,0,terima kasih,2,2
The best,positif,2020-06-03,2020,the best,2,2,the terbaik,2,2,"['the', 'terbaik']","['the', 'terbaik']",2,2,0,the baik,2,2
Ok,positif,2020-06-18,2020,ok,1,1,oke,1,1,['oke'],['oke'],1,1,0,oke,1,1
Ok,positif,2020-06-02,2020,ok,1,1,oke,1,1,['oke'],['oke'],1,1,0,oke,1,1
Ok,positif,2020-05-23,2020,ok,1,1,oke,1,1,['oke'],['oke'],1,1,0,oke,1,1
Mantap👍,positif,2020-04-30,2020,mantap,1,1,mantap,1,1,['mantap'],['mantap'],1,1,0,mantap,1,1
💼💼💼💵,positif,2020-05-10,2020,,1,0,,0,0,[],[],1,1,0,,1,0
Good aplication,positif,2020-05-25,2020,good aplication,2,2,bagus aplication,2,2,"['bagus', 'aplication']","['bagus', 'aplication']",2,2,0,bagus aplication,2,2
Nice application,positif,2020-06-19,2020,nice application,2,2,baik application,2,2,"['baik', 'application']",['application'],2,1,1,application,1,1
Mantap jaya,positif,2021-03-24,2021,mantap jaya,2,2,mantap jaya,2,2,"['mantap', 'jaya']","['mantap', 'jaya']",2,2,0,mantap jaya,2,2
Very good,positif,2020-05-11,2020,very good,2,2,sangat bagus,2,2,"['sangat', 'bagus']",['bagus'],2,1,1,bagus,1,1
Bisnis tradding,positif,2020-04-29,2020,bisnis tradding,2,2,bisnis tradding,2,2,"['bisnis', 'tradding']","['bisnis', 'tradding']",2,2,0,bisnis tradding,2,2
Thanks LinkedIn,positif,2020-06-25,2020,thanks linkedin,2,2,terima kasih linkedin,2,3,"['terima', 'kasih', 'linkedin']","['terima', 'kasih', 'linkedin']",3,3,0,terima kasih linkedin,3,3
yh bgus,positif,2020-05-02,2020,yh bgus,2,2,ya bagus,2,2,"['ya', 'bagus']","['ya', 'bagus']",2,2,0,ya bagus,2,2
👍🏽👍🏽👍🏽,positif,2021-02-11,2021,,1,0,,0,0,[],[],1,1,0,,1,0
👍👍👍,positif,2020-05-04,2020,,1,0,,0,0,[],[],1,1,0,,1,0
👍👍👍👍👍,positif,2021-03-31,2021,,1,0,,0,0,[],[],1,1,0,,1,0
👍,positif,2021-04-29,2021,,1,0,,0,0,[],[],1,1,0,,1,0
"Site Engineer and Administration, Logistic Engineer Administration, Project Archive Administration, Administration System",positif,2020-04-28,2020,site engineer and administration logistic engineer administration project archive administration administration system,12,12,site engineer and administration logistic engineer administration project archive administration administration system,12,12,"['site', 'engineer', 'and', 'administration', 'logistic', 'engineer', 'administration', 'project', 'archive', 'administration', 'administration', 'system']","['site', 'engineer', 'and', 'administration', 'logistic', 'engineer', 'administration', 'project', 'archive', 'administration', 'administration', 'system']",12,12,0,site engineer and administration logistic engineer administration project archive administration administration system,12,12
Ok,positif,2020-07-15,2020,ok,1,1,oke,1,1,['oke'],['oke'],1,1,0,oke,1,1
Interesting,positif,2022-12-23,2022,interesting,1,1,interesting,1,1,['interesting'],['interesting'],1,1,0,interesting,1,1
Good,positif,2022-01-06,2022,good,1,1,bagus,1,1,['bagus'],['bagus'],1,1,0,bagus,1,1
bagus,positif,2020-07-16,2020,bagus,1,1,bagus,1,1,['bagus'],['bagus'],1,1,0,bagus,1,1
Bagus,positif,2021-07-24,2021,bagus,1,1,bagus,1,1,['bagus'],['bagus'],1,1,0,bagus,1,1
Mantap,positif,2020-04-24,2020,mantap,1,1,mantap,1,1,['mantap'],['mantap'],1,1,0,mantap,1,1
Yoi,positif,2020-05-03,2020,yoi,1,1,yoi,1,1,['yoi'],['yoi'],1,1,0,yoi,1,1
Good,positif,2020-08-27,2020,good,1,1,bagus,1,1,['bagus'],['bagus'],1,1,0,bagus,1,1
Bagus,positif,2021-03-03,2021,bagus,1,1,bagus,1,1,['bagus'],['bagus'],1,1,0,bagus,1,1
Ok,positif,2020-05-05,2020,ok,1,1,oke,1,1,['oke'],['oke'],1,1,0,oke,1,1
Ok,positif,2020-07-19,2020,ok,1,1,oke,1,1,['oke'],['oke'],1,1,0,oke,1,1
Ok,positif,2020-04-29,2020,ok,1,1,oke,1,1,['oke'],['oke'],1,1,0,oke,1,1
Helpfull,positif,2020-05-01,2020,helpfull,1,1,membantu,1,1,['membantu'],['membantu'],1,1,0,bantu,1,1
Bagus,positif,2020-04-28,2020,bagus,1,1,bagus,1,1,['bagus'],['bagus'],1,1,0,bagus,1,1
Mantab,positif,2021-02-09,2021,mantab,1,1,mantap,1,1,['mantap'],['mantap'],1,1,0,mantap,1,1
Yaa,positif,2020-04-25,2020,yaa,1,1,ya,1,1,['ya'],['ya'],1,1,0,ya,1,1
Ok,positif,2020-04-30,2020,ok,1,1,oke,1,1,['oke'],['oke'],1,1,0,oke,1,1
Mantap,positif,2021-04-15,2021,mantap,1,1,mantap,1,1,['mantap'],['mantap'],1,1,0,mantap,1,1
Mantull...,positif,2021-07-28,2021,mantull,1,1,mantull,1,1,['mantull'],['mantull'],1,1,0,mantull,1,1
Mitra logam,positif,2022-01-13,2022,mitra logam,2,2,mitra logam,2,2,"['mitra', 'logam']","['mitra', 'logam']",2,2,0,mitra logam,2,2
Bantu yah,positif,2020-04-29,2020,bantu yah,2,2,bantu ya,2,2,"['bantu', 'ya']","['bantu', 'ya']",2,2,0,bantu ya,2,2
Good job,positif,2020-05-01,2020,good job,2,2,bagus kerja,2,2,"['bagus', 'kerja']","['bagus', 'kerja']",2,2,0,bagus kerja,2,2
Alhamdulillah Wasyukurillah,positif,2020-05-01,2020,alhamdulillah wasyukurillah,2,2,alhamdulillah wasyukurillah,2,2,"['alhamdulillah', 'wasyukurillah']","['alhamdulillah', 'wasyukurillah']",2,2,0,alhamdulillah wasyukurillah,2,2
Bagus...,positif,2020-04-24,2020,bagus,1,1,bagus,1,1,['bagus'],['bagus'],1,1,0,bagus,1,1
Siip..cepat,positif,2020-08-27,2020,siip cepat,1,2,siip cepat,2,2,"['siip', 'cepat']","['siip', 'cepat']",2,2,0,siip cepat,2,2
Good,positif,2020-06-12,2020,good,1,1,bagus,1,1,['bagus'],['bagus'],1,1,0,bagus,1,1
Good,positif,2020-04-19,2020,good,1,1,bagus,1,1,['bagus'],['bagus'],1,1,0,bagus,1,1
I like it....,positif,2020-09-28,2020,i like it,3,3,i like it,3,3,"['i', 'like', 'it']","['i', 'like', 'it']",3,3,0,i like it,3,3
Gk guna,positif,2020-04-18,2020,gk guna,2,2,tidak guna,2,2,"['tidak', 'guna']",['tidak'],2,1,1,tidak,1,1
Mantap,positif,2020-04-17,2020,mantap,1,1,mantap,1,1,['mantap'],['mantap'],1,1,0,mantap,1,1
Oke,positif,2020-04-28,2020,oke,1,1,oke,1,1,['oke'],['oke'],1,1,0,oke,1,1
Good,positif,2020-04-22,2020,good,1,1,bagus,1,1,['bagus'],['bagus'],1,1,0,bagus,1,1
Ok,positif,2020-06-10,2020,ok,1,1,oke,1,1,['oke'],['oke'],1,1,0,oke,1,1
Top,positif,2020-04-26,2020,top,1,1,top,1,1,['top'],['top'],1,1,0,top,1,1
Ok,positif,2020-04-19,2020,ok,1,1,oke,1,1,['oke'],['oke'],1,1,0,oke,1,1
Bagus,positif,2020-07-10,2020,bagus,1,1,bagus,1,1,['bagus'],['bagus'],1,1,0,bagus,1,1
Mantap,positif,2020-04-20,2020,mantap,1,1,mantap,1,1,['mantap'],['mantap'],1,1,0,mantap,1,1
good,positif,2021-02-16,2021,good,1,1,bagus,1,1,['bagus'],['bagus'],1,1,0,bagus,1,1
Bgus,positif,2022-01-07,2022,bgus,1,1,bagus,1,1,['bagus'],['bagus'],1,1,0,bagus,1,1
Mantap,positif,2020-04-26,2020,mantap,1,1,mantap,1,1,['mantap'],['mantap'],1,1,0,mantap,1,1
Terimakasih,positif,2020-07-21,2020,terimakasih,1,1,terima kasih,1,2,"['terima', 'kasih']","['terima', 'kasih']",2,2,0,terima kasih,2,2
Bagus,positif,2021-10-26,2021,bagus,1,1,bagus,1,1,['bagus'],['bagus'],1,1,0,bagus,1,1
Good,positif,2021-08-13,2021,good,1,1,bagus,1,1,['bagus'],['bagus'],1,1,0,bagus,1,1
Good,positif,2021-03-01,2021,good,1,1,bagus,1,1,['bagus'],['bagus'],1,1,0,bagus,1,1
Ok,positif,2020-04-17,2020,ok,1,1,oke,1,1,['oke'],['oke'],1,1,0,oke,1,1
Good,positif,2020-04-17,2020,good,1,1,bagus,1,1,['bagus'],['bagus'],1,1,0,bagus,1,1
Good,positif,2020-04-15,2020,good,1,1,bagus,1,1,['bagus'],['bagus'],1,1,0,bagus,1,1
Good,positif,2020-04-13,2020,good,1,1,bagus,1,1,['bagus'],['bagus'],1,1,0,bagus,1,1
Mantap,positif,2021-05-07,2021,mantap,1,1,mantap,1,1,['mantap'],['mantap'],1,1,0,mantap,1,1
Good,positif,2020-07-05,2020,good,1,1,bagus,1,1,['bagus'],['bagus'],1,1,0,bagus,1,1
Ok,positif,2020-04-12,2020,ok,1,1,oke,1,1,['oke'],['oke'],1,1,0,oke,1,1
Alhamdulillah,positif,2020-04-17,2020,alhamdulillah,1,1,alhamdulillah,1,1,['alhamdulillah'],['alhamdulillah'],1,1,0,alhamdulillah,1,1
Bagus,positif,2020-04-15,2020,bagus,1,1,bagus,1,1,['bagus'],['bagus'],1,1,0,bagus,1,1
Puas,positif,2020-09-23,2020,puas,1,1,puas,1,1,['puas'],['puas'],1,1,0,puas,1,1
Good,positif,2021-02-14,2021,good,1,1,bagus,1,1,['bagus'],['bagus'],1,1,0,bagus,1,1
Terimakasih,positif,2020-04-18,2020,terimakasih,1,1,terima kasih,1,2,"['terima', 'kasih']","['terima', 'kasih']",2,2,0,terima kasih,2,2
Bagus,positif,2020-04-10,2020,bagus,1,1,bagus,1,1,['bagus'],['bagus'],1,1,0,bagus,1,1
Baik,positif,2021-03-21,2021,baik,1,1,baik,1,1,['baik'],[],1,1,0,,1,0
Ok,positif,2020-04-15,2020,ok,1,1,oke,1,1,['oke'],['oke'],1,1,0,oke,1,1
Yes good,positif,2020-06-07,2020,yes good,2,2,yes bagus,2,2,"['yes', 'bagus']","['yes', 'bagus']",2,2,0,yes bagus,2,2
Sangat bagus,positif,2020-04-19,2020,sangat bagus,2,2,sangat bagus,2,2,"['sangat', 'bagus']",['bagus'],2,1,1,bagus,1,1
Linkedin Mantap,positif,2021-02-16,2021,linkedin mantap,2,2,linkedin mantap,2,2,"['linkedin', 'mantap']","['linkedin', 'mantap']",2,2,0,linkedin mantap,2,2
Good apps,positif,2020-04-16,2020,good apps,2,2,bagus aplikasi,2,2,"['bagus', 'aplikasi']","['bagus', 'aplikasi']",2,2,0,bagus aplikasi,2,2
Good apl,positif,2020-09-09,2020,good apl,2,2,bagus aplikasi,2,2,"['bagus', 'aplikasi']","['bagus', 'aplikasi']",2,2,0,bagus aplikasi,2,2
Good job,positif,2020-04-17,2020,good job,2,2,bagus kerja,2,2,"['bagus', 'kerja']","['bagus', 'kerja']",2,2,0,bagus kerja,2,2
Nice apk,positif,2020-04-10,2020,nice apk,2,2,baik aplikasi,2,2,"['baik', 'aplikasi']",['aplikasi'],2,1,1,aplikasi,1,1
sangat bagus,positif,2020-04-11,2020,sangat bagus,2,2,sangat bagus,2,2,"['sangat', 'bagus']",['bagus'],2,1,1,bagus,1,1
Good information,positif,2020-07-18,2020,good information,2,2,bagus information,2,2,"['bagus', 'information']","['bagus', 'information']",2,2,0,bagus information,2,2
Puas,positif,2020-04-15,2020,puas,1,1,puas,1,1,['puas'],['puas'],1,1,0,puas,1,1
Mantul.bro,positif,2020-04-21,2020,mantul bro,1,2,mantap betul bro,2,3,"['mantap', 'betul', 'bro']","['mantap', 'bro']",3,2,1,mantap bro,2,2
Mantapppp,positif,2020-06-05,2020,mantapppp,1,1,mantapppp,1,1,['mantapppp'],['mantapppp'],1,1,0,mantapppp,1,1
Ok,positif,2020-09-07,2020,ok,1,1,oke,1,1,['oke'],['oke'],1,1,0,oke,1,1
Ok,positif,2020-04-09,2020,ok,1,1,oke,1,1,['oke'],['oke'],1,1,0,oke,1,1
Good,positif,2020-04-04,2020,good,1,1,bagus,1,1,['bagus'],['bagus'],1,1,0,bagus,1,1
sangat perlu.,positif,2022-02-06,2022,sangat perlu,2,2,sangat perlu,2,2,"['sangat', 'perlu']",[],2,1,1,,1,0
Ga guna,negatif,2022-03-23,2022,ga guna,2,2,tidak guna,2,2,"['tidak', 'guna']",['tidak'],2,1,1,tidak,1,1
susah login,negatif,2023-09-04,2023,susah login,2,2,susah login,2,2,"['susah', 'login']","['susah', 'login']",2,2,0,susah login,2,2
Aplikasinx bagus,positif,2020-05-30,2020,aplikasinx bagus,2,2,aplikasinx bagus,2,2,"['aplikasinx', 'bagus']","['aplikasinx', 'bagus']",2,2,0,aplikasinx bagus,2,2
Jelek bngett,negatif,2021-09-02,2021,jelek bngett,2,2,jelek bngett,2,2,"['jelek', 'bngett']","['jelek', 'bngett']",2,2,0,jelek bngett,2,2
Gak penting,negatif,2020-04-21,2020,gak penting,2,2,tidak penting,2,2,"['tidak', 'penting']",['tidak'],2,1,1,tidak,1,1
baru make verifikasi sulit plus loading lemot. Ga worth pake ni apk,negatif,2022-11-02,2022,baru make verifikasi sulit plus loading lemot ga worth pake ni apk,12,12,baru make verifikasi sulit ditambah loading lambat tidak worth pakai ini aplikasi,12,12,"['baru', 'make', 'verifikasi', 'sulit', 'ditambah', 'loading', 'lambat', 'tidak', 'worth', 'pakai', 'ini', 'aplikasi']","['make', 'verifikasi', 'sulit', 'ditambah', 'loading', 'lambat', 'tidak', 'worth', 'pakai', 'aplikasi']",12,10,2,make verifikasi sulit tambah loading lambat tidak worth pakai aplikasi,10,10
"LinkedIn yang sekarang buruk , mau masuk aja susah bener , harus verivikasi, mana verifikasinya gak jelas gak masuk akal.",negatif,2024-09-02,2024,linkedin yang sekarang buruk mau masuk aja susah bener harus verivikasi mana verifikasinya gak jelas gak masuk akal,20,18,linkedin yang sekarang buruk mau masuk saja susah benar harus verivikasi mana verifikasinya tidak jelas tidak masuk akal,18,18,"['linkedin', 'yang', 'sekarang', 'buruk', 'mau', 'masuk', 'saja', 'susah', 'benar', 'harus', 'verivikasi', 'mana', 'verifikasinya', 'tidak', 'jelas', 'tidak', 'masuk', 'akal']","['linkedin', 'buruk', 'masuk', 'susah', 'verivikasi', 'verifikasinya', 'tidak', 'tidak', 'masuk', 'akal']",18,10,8,linkedin buruk masuk susah verivikasi verifikasi tidak tidak masuk akal,10,10
"application error', I have repeatedly changed the profile. but no effect whatsoever👎",negatif,2023-09-06,2023,application error i have repeatedly changed the profile but no effect whatsoever,12,12,application error i have repeatedly changed the profile but nomor effect whatsoever,12,12,"['application', 'error', 'i', 'have', 'repeatedly', 'changed', 'the', 'profile', 'but', 'nomor', 'effect', 'whatsoever']","['application', 'error', 'i', 'have', 'repeatedly', 'changed', 'the', 'profile', 'but', 'nomor', 'effect', 'whatsoever']",12,12,0,application error i have repeatedly changed the profile but nomor effect whatsoever,12,12
ribeetttt...you know ribet... iTs confusing me to Log iN iTs to much verifikasi ... :(,negatif,2022-07-06,2022,ribeetttt you know ribet its confusing me to log in its to much verifikasi,15,14,ribeetttt you know rumit its confusing me to log in its to much verifikasi,14,14,"['ribeetttt', 'you', 'know', 'rumit', 'its', 'confusing', 'me', 'to', 'log', 'in', 'its', 'to', 'much', 'verifikasi']","['ribeetttt', 'you', 'know', 'rumit', 'its', 'confusing', 'me', 'to', 'log', 'in', 'its', 'to', 'much', 'verifikasi']",14,14,0,ribeetttt you know rumit its confusing me to log in its to much verifikasi,14,14
"Saya mendapatkan pengalaman yang luar biasa di Linkedln. Linkedln sangat profesional, Ia memastikan saya merasa nyaman dan terus memberi informasi selama proses berlangsung. Aplikasi canggih dan informasi modern di Linkedln semakin menyempurnakan pengalaman secara keseluruhan. Saya sangat merekomendasikan LinkedIn atas laplikasi yang luar biasa dan berbagai informasi yang dipersonalisasi.”",positif,2024-08-17,2024,saya mendapatkan pengalaman yang luar biasa di linkedln linkedln sangat profesional ia memastikan saya merasa nyaman dan terus memberi informasi selama proses berlangsung aplikasi canggih dan informasi modern di linkedln semakin menyempurnakan pengalaman secara keseluruhan saya sangat merekomendasikan linkedin atas laplikasi yang luar biasa dan berbagai informasi yang dipersonalisasi ”,49,50,saya mendapatkan pengalaman yang luar biasa di linkedln linkedln sangat profesional iya memastikan saya merasa nyaman dan terus memberi informasi selama proses berlangsung aplikasi canggih dan informasi modern di linkedln semakin menyempurnakan pengalaman secara keseluruhan saya sangat merekomendasikan linkedin atas laplikasi yang luar biasa dan berbagai informasi yang dipersonalisasi ”,50,50,"['saya', 'mendapatkan', 'pengalaman', 'yang', 'luar', 'biasa', 'di', 'linkedln', 'linkedln', 'sangat', 'profesional', 'iya', 'memastikan', 'saya', 'merasa', 'nyaman', 'dan', 'terus', 'memberi', 'informasi', 'selama', 'proses', 'berlangsung', 'aplikasi', 'canggih', 'dan', 'informasi', 'modern', 'di', 'linkedln', 'semakin', 'menyempurnakan', 'pengalaman', 'secara', 'keseluruhan', 'saya', 'sangat', 'merekomendasikan', 'linkedin', 'atas', 'laplikasi', 'yang', 'luar', 'biasa', 'dan', 'berbagai', 'informasi', 'yang', 'dipersonalisasi', '”']","['pengalaman', 'linkedln', 'linkedln', 'profesional', 'iya', 'nyaman', 'informasi', 'proses', 'aplikasi', 'canggih', 'informasi', 'modern', 'linkedln', 'menyempurnakan', 'pengalaman', 'merekomendasikan', 'linkedin', 'laplikasi', 'informasi', 'dipersonalisasi', '”']",50,21,29,alam linkedln linkedln profesional iya nyaman informasi proses aplikasi canggih informasi modern linkedln sempurna alam rekomendasi linkedin laplikasi informasi personal,21,20
Apk gajelas malah tebah2 an goblok,negatif,2024-06-26,2024,apk gajelas malah tebah an goblok,6,6,aplikasi tidak jelas bahkan tebah an goblok,6,7,"['aplikasi', 'tidak', 'jelas', 'bahkan', 'tebah', 'an', 'goblok']","['aplikasi', 'tidak', 'tebah', 'an', 'goblok']",7,5,2,aplikasi tidak tebah an goblok,5,5
APLIKASI BOSOK GA JUELAS VERIFIKASINE,negatif,2023-06-07,2023,aplikasi bosok ga juelas verifikasine,5,5,aplikasi bosok tidak juelas verifikasine,5,5,"['aplikasi', 'bosok', 'tidak', 'juelas', 'verifikasine']","['aplikasi', 'bosok', 'tidak', 'juelas', 'verifikasine']",5,5,0,aplikasi bosok tidak juelas verifikasine,5,5
linkedin error tolong diperbaiki,negatif,2023-12-14,2023,linkedin error tolong diperbaiki,4,4,linkedin error tolong di perbaiki,4,5,"['linkedin', 'error', 'tolong', 'di', 'perbaiki']","['linkedin', 'error', 'tolong', 'perbaiki']",5,4,1,linkedin error tolong baik,4,4
Captcha Error,negatif,2023-04-26,2023,captcha error,2,2,captcha error,2,2,"['captcha', 'error']","['captcha', 'error']",2,2,0,captcha error,2,2
"Wth, gak bisa login",negatif,2023-12-11,2023,wth gak bisa login,4,4,wth tidak bisa login,4,4,"['wth', 'tidak', 'bisa', 'login']","['wth', 'tidak', 'login']",4,3,1,wth tidak login,3,3
apk gak guna ygy,negatif,2022-05-14,2022,apk gak guna ygy,4,4,aplikasi tidak guna ygy,4,4,"['aplikasi', 'tidak', 'guna', 'ygy']","['aplikasi', 'tidak', 'ygy']",4,3,1,aplikasi tidak ygy,3,3
Mantap bisa membantu membangun personal branding di ranah internasional,positif,2024-05-26,2024,mantap bisa membantu membangun personal branding di ranah internasional,9,9,mantap bisa membantu membangun personal branding di ranah internasional,9,9,"['mantap', 'bisa', 'membantu', 'membangun', 'personal', 'branding', 'di', 'ranah', 'internasional']","['mantap', 'membantu', 'membangun', 'personal', 'branding', 'ranah', 'internasional']",9,7,2,mantap bantu bangun personal branding ranah internasional,7,7
Mantap bisa bekerja Di perusahaan besar di Singapura,positif,2024-05-20,2024,mantap bisa bekerja di perusahaan besar di singapura,8,8,mantap bisa bekerja di perusahaan besar di singapura,8,8,"['mantap', 'bisa', 'bekerja', 'di', 'perusahaan', 'besar', 'di', 'singapura']","['mantap', 'perusahaan', 'singapura']",8,3,5,mantap usaha singapura,3,3
Aplikasi sampah!,negatif,2023-12-26,2023,aplikasi sampah,2,2,aplikasi sampah,2,2,"['aplikasi', 'sampah']","['aplikasi', 'sampah']",2,2,0,aplikasi sampah,2,2
Ok banget.!!!,positif,2023-04-09,2023,ok banget,2,2,oke banget,2,2,"['oke', 'banget']","['oke', 'banget']",2,2,0,oke banget,2,2
Ok banget.!!!,positif,2023-04-04,2023,ok banget,2,2,oke banget,2,2,"['oke', 'banget']","['oke', 'banget']",2,2,0,oke banget,2,2
"LinkedIn, ok dahh!",positif,2022-05-04,2022,linkedin ok dahh,3,3,linkedin oke deh,3,3,"['linkedin', 'oke', 'deh']","['linkedin', 'oke', 'deh']",3,3,0,linkedin oke deh,3,3
"Good app, sangat membantu",positif,2022-08-05,2022,good app sangat membantu,4,4,bagus aplikasi sangat membantu,4,4,"['bagus', 'aplikasi', 'sangat', 'membantu']","['bagus', 'aplikasi', 'membantu']",4,3,1,bagus aplikasi bantu,3,3
GAK guna !,negatif,2022-07-05,2022,gak guna,3,2,tidak guna,2,2,"['tidak', 'guna']",['tidak'],2,1,1,tidak,1,1
Iklan mulu gateli bangsat,negatif,2024-05-30,2024,iklan mulu gateli bangsat,4,4,iklan mulu gateli bangsat,4,4,"['iklan', 'mulu', 'gateli', 'bangsat']","['iklan', 'mulu', 'gateli', 'bangsat']",4,4,0,iklan mulu gateli bangsat,4,4
bug recaptcha gajelas,negatif,2023-08-14,2023,bug recaptcha gajelas,3,3,bug recaptcha tidak jelas,3,4,"['bug', 'recaptcha', 'tidak', 'jelas']","['bug', 'recaptcha', 'tidak']",4,3,1,bug recaptcha tidak,3,3
Buruk gabisa log in,negatif,2024-02-12,2024,buruk gabisa log in,4,4,buruk tidak bisa log in,4,5,"['buruk', 'tidak', 'bisa', 'log', 'in']","['buruk', 'tidak', 'log', 'in']",5,4,1,buruk tidak log in,4,4
Amazing... good luck 👍👍,positif,2022-03-28,2022,amazing good luck,4,3,amazing bagus luck,3,3,"['amazing', 'bagus', 'luck']","['amazing', 'bagus', 'luck']",3,3,0,amazing bagus luck,3,3
"keren abis, thanks linkedIn",positif,2020-05-13,2020,keren abis thanks linkedin,4,4,keren habis terima kasih linkedin,4,5,"['keren', 'habis', 'terima', 'kasih', 'linkedin']","['keren', 'habis', 'terima', 'kasih', 'linkedin']",5,5,0,keren habis terima kasih linkedin,5,5
Ngelooping data verifikasi,negatif,2023-05-04,2023,ngelooping data verifikasi,3,3,ngelooping data verifikasi,3,3,"['ngelooping', 'data', 'verifikasi']","['ngelooping', 'data', 'verifikasi']",3,3,0,ngelooping data verifikasi,3,3
